CoinPoker Hand #291148238: Hold'em No Limit (0.01/0.02 ) 2025/09/02 17:56:39 GMT
Table 'NL ₮2 VI' 7-max Seat #5 is the button
Seat 1: AbsoluteuNIT (2.03 in chips)
Seat 2: mishanskii (2.00 in chips) out of hand
Seat 3: DragonPok3r (2.00 in chips) out of hand
Seat 4: Holy1 (0.80 in chips) out of hand
Seat 5: Shamil05 (0.83 in chips)
Seat 6: kanococo (1.94 in chips)
Seat 7: Lorens95 (2.00 in chips)
kanococo: posts small blind 0.01
Lorens95: posts big blind 0.02
*** HOLE CARDS ***
Dealt to kanococo [3s As]
AbsoluteuNIT: folds
Shamil05: folds
kanococo: raises 0.02 to 0.04
Lorens95: folds
kanococo collected 0.06 from pot
kanococo: doesn't show hand
*** SUMMARY ***
Total pot 0.06 | Rake 0.00
Board [ ]
Game ended: 2025/09/02 17:56:50 GMT
Seat 1: AbsoluteuNIT folded before Flop (didn't bet)
Seat 2: mishanskii folded before Flop (didn't bet)
Seat 3: DragonPok3r folded before Flop (didn't bet)
Seat 4: Holy1 folded before Flop (didn't bet)
Seat 5: Shamil05 (button) folded before Flop (didn't bet)
Seat 6: kanococo (small blind) collected (0.06)
Seat 7: Lorens95 (big blind) folded before Flop

CoinPoker Hand #291148357: Hold'em No Limit (0.01/0.02 ) 2025/09/02 17:56:52 GMT
Table 'NL ₮2 VI' 7-max Seat #6 is the button
Seat 1: AbsoluteuNIT (2.03 in chips)
Seat 2: mishanskii (2.00 in chips) out of hand
Seat 3: DragonPok3r (2.00 in chips) out of hand
Seat 4: Holy1 (0.80 in chips) out of hand
Seat 5: Shamil05 (0.83 in chips)
Seat 6: kanococo (1.96 in chips)
Seat 7: Lorens95 (2.00 in chips)
Lorens95: posts small blind 0.01
AbsoluteuNIT: posts big blind 0.02
*** HOLE CARDS ***
Dealt to kanococo [7s 3h]
Shamil05: raises 0.03 to 0.05
kanococo: folds
Lorens95: folds
AbsoluteuNIT: folds
Shamil05 collected 0.08 from pot
Shamil05: doesn't show hand
*** SUMMARY ***
Total pot 0.08 | Rake 0.00
Board [ ]
Game ended: 2025/09/02 17:57:12 GMT
Seat 1: AbsoluteuNIT (big blind) folded before Flop
Seat 2: mishanskii folded before Flop (didn't bet)
Seat 3: DragonPok3r folded before Flop (didn't bet)
Seat 4: Holy1 folded before Flop (didn't bet)
Seat 5: Shamil05 collected (0.08)
Seat 6: kanococo (button) folded before Flop (didn't bet)
Seat 7: Lorens95 (small blind) folded before Flop

CoinPoker Hand #291148428: Hold'em No Limit (0.01/0.02 ) 2025/09/02 17:57:14 GMT
Table 'NL ₮2 VI' 7-max Seat #7 is the button
Seat 1: AbsoluteuNIT (2.01 in chips)
Seat 2: mishanskii (2.00 in chips)
Seat 3: DragonPok3r (2.00 in chips) out of hand
Seat 4: Holy1 (0.80 in chips) out of hand
Seat 5: Shamil05 (0.86 in chips)
Seat 6: kanococo (1.96 in chips)
Seat 7: Lorens95 (1.99 in chips)
AbsoluteuNIT: posts small blind 0.01
mishanskii: posts big blind 0.02
*** HOLE CARDS ***
Dealt to kanococo [2h 6c]
Shamil05: raises 0.02 to 0.04
kanococo: folds
Lorens95: folds
AbsoluteuNIT: folds
mishanskii: raises 0.09 to 0.13
Shamil05: calls 0.09
*** FLOP *** [Th 3s Jd]
mishanskii: bets 0.18
Shamil05: calls 0.18
*** TURN *** [Th 3s Jd] [Js]
mishanskii: bets 0.30
Shamil05: folds
Uncalled bet (0.30) returned to mishanskii
mishanskii collected 0.60 from pot
mishanskii: doesn't show hand
*** SUMMARY ***
Total pot 0.63 | Rake 0.03
Board [ Th 3s Jd Js ]
Game ended: 2025/09/02 17:58:09 GMT
Seat 1: AbsoluteuNIT (small blind) folded before Flop
Seat 2: mishanskii (big blind) collected (0.60)
Seat 3: DragonPok3r folded before Flop (didn't bet)
Seat 4: Holy1 folded before Flop (didn't bet)
Seat 5: Shamil05 folded on the Turn
Seat 6: kanococo folded before Flop (didn't bet)
Seat 7: Lorens95 (button) folded before Flop (didn't bet)

CoinPoker Hand #291148620: Hold'em No Limit (0.01/0.02 ) 2025/09/02 17:58:11 GMT
Table 'NL ₮2 VI' 7-max Seat #1 is the button
Seat 1: AbsoluteuNIT (2.00 in chips)
Seat 2: mishanskii (2.29 in chips)
Seat 3: DragonPok3r (2.00 in chips)
Seat 4: Holy1 (0.80 in chips) out of hand
Seat 5: Shamil05 (0.55 in chips)
Seat 6: kanococo (1.96 in chips)
Seat 7: Lorens95 (2.00 in chips)
mishanskii: posts small blind 0.01
DragonPok3r: posts big blind 0.02
*** HOLE CARDS ***
Dealt to kanococo [4s Ah]
Shamil05: folds
kanococo: folds
Lorens95: folds
AbsoluteuNIT: folds
mishanskii: folds
DragonPok3r collected 0.03 from pot
DragonPok3r: doesn't show hand
*** SUMMARY ***
Total pot 0.03 | Rake 0.00
Board [ ]
Game ended: 2025/09/02 17:58:23 GMT
Seat 1: AbsoluteuNIT (button) folded before Flop (didn't bet)
Seat 2: mishanskii (small blind) folded before Flop
Seat 3: DragonPok3r (big blind) collected (0.03)
Seat 4: Holy1 folded before Flop (didn't bet)
Seat 5: Shamil05 folded before Flop (didn't bet)
Seat 6: kanococo folded before Flop (didn't bet)
Seat 7: Lorens95 folded before Flop (didn't bet)

CoinPoker Hand #291148695: Hold'em No Limit (0.01/0.02 ) 2025/09/02 17:58:25 GMT
Table 'NL ₮2 VI' 7-max Seat #2 is the button
Seat 1: AbsoluteuNIT (2.00 in chips)
Seat 2: mishanskii (2.28 in chips)
Seat 3: DragonPok3r (2.01 in chips)
Seat 4: Holy1 (0.80 in chips)
Seat 5: Shamil05 (0.80 in chips)
Seat 6: kanococo (1.96 in chips)
Seat 7: Lorens95 (2.00 in chips)
DragonPok3r: posts small blind 0.01
Holy1: posts big blind 0.02
*** HOLE CARDS ***
Dealt to kanococo [6s 6d]
Shamil05: folds
kanococo: raises 0.02 to 0.04
Lorens95: folds
AbsoluteuNIT: folds
mishanskii: calls 0.04
DragonPok3r: calls 0.03
Holy1: folds
*** FLOP *** [8s Qs 2d]
DragonPok3r: checks
kanococo: bets 0.04
mishanskii: folds
DragonPok3r: calls 0.04
*** TURN *** [8s Qs 2d] [Jh]
DragonPok3r: checks
kanococo: bets 0.10
DragonPok3r: folds
Uncalled bet (0.10) returned to kanococo
kanococo collected 0.21 from pot
kanococo: doesn't show hand
*** SUMMARY ***
Total pot 0.22 | Rake 0.01
Board [ 8s Qs 2d Jh ]
Game ended: 2025/09/02 17:59:29 GMT
Seat 1: AbsoluteuNIT folded before Flop (didn't bet)
Seat 2: mishanskii (button) folded on the Flop
Seat 3: DragonPok3r (small blind) folded on the Turn
Seat 4: Holy1 (big blind) folded before Flop
Seat 5: Shamil05 folded before Flop (didn't bet)
Seat 6: kanococo collected (0.21)
Seat 7: Lorens95 folded before Flop (didn't bet)

CoinPoker Hand #291148890: Hold'em No Limit (0.01/0.02 ) 2025/09/02 17:59:31 GMT
Table 'NL ₮2 VI' 7-max Seat #3 is the button
Seat 1: AbsoluteuNIT (2.00 in chips)
Seat 2: mishanskii (2.24 in chips)
Seat 3: DragonPok3r (1.93 in chips)
Seat 4: Holy1 (0.78 in chips)
Seat 5: Shamil05 (0.80 in chips)
Seat 6: kanococo (2.09 in chips)
Seat 7: Lorens95 (2.00 in chips)
Holy1: posts small blind 0.01
Shamil05: posts big blind 0.02
*** HOLE CARDS ***
Dealt to kanococo [4d Ks]
kanococo: folds
Lorens95: folds
AbsoluteuNIT: folds
mishanskii: folds
DragonPok3r: folds
Holy1: raises 0.03 to 0.05
Shamil05: folds
Holy1 collected 0.07 from pot
Holy1: doesn't show hand
*** SUMMARY ***
Total pot 0.07 | Rake 0.00
Board [ ]
Game ended: 2025/09/02 17:59:57 GMT
Seat 1: AbsoluteuNIT folded before Flop (didn't bet)
Seat 2: mishanskii folded before Flop (didn't bet)
Seat 3: DragonPok3r (button) folded before Flop (didn't bet)
Seat 4: Holy1 (small blind) collected (0.07)
Seat 5: Shamil05 (big blind) folded before Flop
Seat 6: kanococo folded before Flop (didn't bet)
Seat 7: Lorens95 folded before Flop (didn't bet)

CoinPoker Hand #291148961: Hold'em No Limit (0.01/0.02 ) 2025/09/02 17:59:58 GMT
Table 'NL ₮2 VI' 7-max Seat #4 is the button
Seat 1: AbsoluteuNIT (2.00 in chips)
Seat 2: mishanskii (2.24 in chips)
Seat 3: DragonPok3r (1.93 in chips)
Seat 4: Holy1 (0.80 in chips)
Seat 5: Shamil05 (0.78 in chips)
Seat 6: kanococo (2.09 in chips)
Seat 7: Lorens95 (2.00 in chips)
Shamil05: posts small blind 0.01
kanococo: posts big blind 0.02
*** HOLE CARDS ***
Dealt to kanococo [Td 5c]
Lorens95: folds
AbsoluteuNIT: folds
mishanskii: raises 0.05 to 0.07
DragonPok3r: folds
Holy1: folds
Shamil05: folds
kanococo: folds
mishanskii collected 0.10 from pot
mishanskii: doesn't show hand
*** SUMMARY ***
Total pot 0.10 | Rake 0.00
Board [ ]
Game ended: 2025/09/02 18:00:28 GMT
Seat 1: AbsoluteuNIT folded before Flop (didn't bet)
Seat 2: mishanskii collected (0.10)
Seat 3: DragonPok3r folded before Flop (didn't bet)
Seat 4: Holy1 (button) folded before Flop (didn't bet)
Seat 5: Shamil05 (small blind) folded before Flop
Seat 6: kanococo (big blind) folded before Flop
Seat 7: Lorens95 folded before Flop (didn't bet)

CoinPoker Hand #291149065: Hold'em No Limit (0.01/0.02 ) 2025/09/02 18:00:30 GMT
Table 'NL ₮2 VI' 7-max Seat #5 is the button
Seat 1: AbsoluteuNIT (2.00 in chips)
Seat 2: mishanskii (2.27 in chips)
Seat 3: DragonPok3r (1.93 in chips)
Seat 4: Holy1 (0.80 in chips)
Seat 5: Shamil05 (0.77 in chips)
Seat 6: kanococo (2.07 in chips)
Seat 7: Lorens95 (2.00 in chips)
kanococo: posts small blind 0.01
Lorens95: posts big blind 0.02
*** HOLE CARDS ***
Dealt to kanococo [9c Js]
AbsoluteuNIT: folds
mishanskii: folds
DragonPok3r: folds
Holy1: folds
Shamil05: raises 0.03 to 0.05
kanococo: folds
Lorens95: folds
Shamil05 collected 0.08 from pot
Shamil05: doesn't show hand
*** SUMMARY ***
Total pot 0.08 | Rake 0.00
Board [ ]
Game ended: 2025/09/02 18:00:51 GMT
Seat 1: AbsoluteuNIT folded before Flop (didn't bet)
Seat 2: mishanskii folded before Flop (didn't bet)
Seat 3: DragonPok3r folded before Flop (didn't bet)
Seat 4: Holy1 folded before Flop (didn't bet)
Seat 5: Shamil05 (button) collected (0.08)
Seat 6: kanococo (small blind) folded before Flop
Seat 7: Lorens95 (big blind) folded before Flop

CoinPoker Hand #291149148: Hold'em No Limit (0.01/0.02 ) 2025/09/02 18:00:53 GMT
Table 'NL ₮2 VI' 7-max Seat #6 is the button
Seat 1: AbsoluteuNIT (2.00 in chips)
Seat 2: mishanskii (2.27 in chips)
Seat 3: DragonPok3r (1.93 in chips)
Seat 4: Holy1 (0.80 in chips)
Seat 5: Shamil05 (0.80 in chips)
Seat 6: kanococo (2.06 in chips)
Seat 7: Lorens95 (2.00 in chips)
Lorens95: posts small blind 0.01
AbsoluteuNIT: posts big blind 0.02
*** HOLE CARDS ***
Dealt to kanococo [Ac 5c]
mishanskii: folds
DragonPok3r: raises 0.02 to 0.04
Holy1: folds
Shamil05: folds
kanococo: calls 0.04
Lorens95: folds
AbsoluteuNIT: calls 0.02
*** FLOP *** [8h Jc Ts]
AbsoluteuNIT: checks
DragonPok3r: checks
kanococo: checks
*** TURN *** [8h Jc Ts] [Th]
AbsoluteuNIT: checks
DragonPok3r: checks
kanococo: bets 0.02
AbsoluteuNIT: folds
DragonPok3r: calls 0.02
*** RIVER *** [8h Jc Ts Th] [2d]
DragonPok3r: checks
kanococo: checks
*** SHOW DOWN ***
DragonPok3r: shows [2s 3s] (two pairs, Tens and Twos)
kanococo: mucks hand
DragonPok3r collected 0.16 from pot
*** SUMMARY ***
Total pot 0.17 | Rake 0.01
Board [ 8h Jc Ts Th 2d ]
Game ended: 2025/09/02 18:02:01 GMT
Seat 1: AbsoluteuNIT (big blind) folded on the Turn
Seat 2: mishanskii folded before Flop (didn't bet)
Seat 3: DragonPok3r showed [2s 3s] and won (0.16) with two pairs, Tens and Twos
Seat 4: Holy1 folded before Flop (didn't bet)
Seat 5: Shamil05 folded before Flop (didn't bet)
Seat 6: kanococo (button) mucked
Seat 7: Lorens95 (small blind) folded before Flop

CoinPoker Hand #291149468: Hold'em No Limit (0.01/0.02 ) 2025/09/02 18:02:02 GMT
Table 'NL ₮2 VI' 7-max Seat #7 is the button
Seat 1: AbsoluteuNIT (1.96 in chips)
Seat 2: mishanskii (2.27 in chips)
Seat 3: DragonPok3r (2.03 in chips)
Seat 4: Holy1 (0.80 in chips)
Seat 5: Shamil05 (0.80 in chips)
Seat 6: kanococo (2.00 in chips)
Seat 7: Lorens95 (1.99 in chips)
AbsoluteuNIT: posts small blind 0.01
mishanskii: posts big blind 0.02
*** HOLE CARDS ***
Dealt to kanococo [Qs 6h]
DragonPok3r: folds
Holy1: folds
Shamil05: raises 0.02 to 0.04
kanococo: folds
Lorens95: folds
AbsoluteuNIT: folds
mishanskii: raises 0.09 to 0.13
Shamil05: calls 0.09
*** FLOP *** [8s Jc Kc]
mishanskii: bets 0.18
Shamil05: calls 0.18
*** TURN *** [8s Jc Kc] [7c]
mishanskii: bets 0.30
Shamil05: folds
Uncalled bet (0.30) returned to mishanskii
mishanskii collected 0.60 from pot
mishanskii: doesn't show hand
*** SUMMARY ***
Total pot 0.63 | Rake 0.03
Board [ 8s Jc Kc 7c ]
Game ended: 2025/09/02 18:02:56 GMT
Seat 1: AbsoluteuNIT (small blind) folded before Flop
Seat 2: mishanskii (big blind) collected (0.60)
Seat 3: DragonPok3r folded before Flop (didn't bet)
Seat 4: Holy1 folded before Flop (didn't bet)
Seat 5: Shamil05 folded on the Turn
Seat 6: kanococo folded before Flop (didn't bet)
Seat 7: Lorens95 (button) folded before Flop (didn't bet)

CoinPoker Hand #291157807: Hold'em No Limit (0.01/0.02 ) 2025/09/02 18:16:45 GMT
Table 'NL ₮2 V' 7-max Seat #4 is the button
Seat 1: AbsoluteuNIT (1.81 in chips)
Seat 2: Pinzer94 (2.27 in chips)
Seat 3: betformony (2.46 in chips)
Seat 4: Lorens95 (2.03 in chips)
Seat 5: kleepeh (2.15 in chips)
Seat 6: kanococo (2.00 in chips)
Seat 7: HoldBabyHold (2.06 in chips)
kleepeh: posts small blind 0.01
kanococo: posts big blind 0.02
*** HOLE CARDS ***
Dealt to kanococo [Ah 5h]
HoldBabyHold: folds
AbsoluteuNIT: folds
Pinzer94: folds
betformony: folds
Lorens95: raises 0.03 to 0.05
kleepeh: folds
kanococo: calls 0.03
*** FLOP *** [6d 2d Qs]
kanococo: checks
Lorens95: bets 0.04
kanococo: folds
Uncalled bet (0.04) returned to Lorens95
Lorens95 collected 0.10 from pot
Lorens95: doesn't show hand
*** SUMMARY ***
Total pot 0.11 | Rake 0.01
Board [ 6d 2d Qs ]
Game ended: 2025/09/02 18:17:34 GMT
Seat 1: AbsoluteuNIT folded before Flop (didn't bet)
Seat 2: Pinzer94 folded before Flop (didn't bet)
Seat 3: betformony folded before Flop (didn't bet)
Seat 4: Lorens95 (button) collected (0.10)
Seat 5: kleepeh (small blind) folded before Flop
Seat 6: kanococo (big blind) folded on the Flop
Seat 7: HoldBabyHold folded before Flop (didn't bet)

CoinPoker Hand #291158117: Hold'em No Limit (0.01/0.02 ) 2025/09/02 18:17:38 GMT
Table 'NL ₮2 V' 7-max Seat #5 is the button
Seat 2: Pinzer94 (2.27 in chips)
Seat 3: betformony (2.46 in chips)
Seat 4: Lorens95 (2.08 in chips)
Seat 5: kleepeh (2.14 in chips)
Seat 6: kanococo (1.95 in chips)
Seat 7: HoldBabyHold (2.06 in chips)
kanococo: posts small blind 0.01
HoldBabyHold: posts big blind 0.02
*** HOLE CARDS ***
Dealt to kanococo [Qc 6d]
Pinzer94: folds
betformony: folds
Lorens95: folds
kleepeh: raises 0.04 to 0.06
kanococo: calls 0.05
HoldBabyHold: calls 0.04
*** FLOP *** [3h 6s 8d]
kanococo: checks
HoldBabyHold: checks
kleepeh: checks
*** TURN *** [3h 6s 8d] [9h]
kanococo: bets 0.08
HoldBabyHold: folds
kleepeh: calls 0.08
*** RIVER *** [3h 6s 8d 9h] [9s]
kanococo: bets 0.16
kleepeh: folds
Uncalled bet (0.16) returned to kanococo
kanococo collected 0.32 from pot
kanococo: doesn't show hand
*** SUMMARY ***
Total pot 0.34 | Rake 0.02
Board [ 3h 6s 8d 9h 9s ]
Game ended: 2025/09/02 18:18:51 GMT
Seat 2: Pinzer94 folded before Flop (didn't bet)
Seat 3: betformony folded before Flop (didn't bet)
Seat 4: Lorens95 folded before Flop (didn't bet)
Seat 5: kleepeh (button) folded on the River
Seat 6: kanococo (small blind) collected (0.32)
Seat 7: HoldBabyHold (big blind) folded on the Turn

CoinPoker Hand #291158934: Hold'em No Limit (0.01/0.02 ) 2025/09/02 18:18:54 GMT
Table 'NL ₮2 V' 7-max Seat #6 is the button
Seat 1: Joshaf (2.00 in chips)
Seat 2: Pinzer94 (2.27 in chips)
Seat 3: betformony (2.46 in chips)
Seat 4: Lorens95 (2.08 in chips)
Seat 5: kleepeh (2.00 in chips)
Seat 6: kanococo (2.13 in chips)
Seat 7: HoldBabyHold (2.00 in chips)
HoldBabyHold: posts small blind 0.01
Joshaf: posts big blind 0.02
*** HOLE CARDS ***
Dealt to kanococo [Qc 2c]
Pinzer94: folds
betformony: folds
Lorens95: folds
kleepeh: folds
kanococo: folds
HoldBabyHold: raises 0.06 to 0.08
Joshaf: calls 0.06
*** FLOP *** [Kd Tc 5s]
HoldBabyHold: checks
Joshaf: bets 0.07
HoldBabyHold: folds
Uncalled bet (0.07) returned to Joshaf
Joshaf collected 0.15 from pot
Joshaf: doesn't show hand
*** SUMMARY ***
Total pot 0.16 | Rake 0.01
Board [ Kd Tc 5s ]
Game ended: 2025/09/02 18:19:59 GMT
Seat 1: Joshaf (big blind) collected (0.15)
Seat 2: Pinzer94 folded before Flop (didn't bet)
Seat 3: betformony folded before Flop (didn't bet)
Seat 4: Lorens95 folded before Flop (didn't bet)
Seat 5: kleepeh folded before Flop (didn't bet)
Seat 6: kanococo (button) folded before Flop (didn't bet)
Seat 7: HoldBabyHold (small blind) folded on the Flop

CoinPoker Hand #291159491: Hold'em No Limit (0.01/0.02 ) 2025/09/02 18:20:02 GMT
Table 'NL ₮2 V' 7-max Seat #7 is the button
Seat 1: Joshaf (2.07 in chips)
Seat 2: Pinzer94 (2.27 in chips)
Seat 3: betformony (2.46 in chips)
Seat 4: Lorens95 (2.08 in chips)
Seat 5: kleepeh (2.00 in chips)
Seat 6: kanococo (2.13 in chips)
Seat 7: HoldBabyHold (2.00 in chips)
Joshaf: posts small blind 0.01
Pinzer94: posts big blind 0.02
*** HOLE CARDS ***
Dealt to kanococo [8s 5h]
betformony: raises 0.03 to 0.05
Lorens95: folds
kleepeh has timed out
kleepeh activated time-bank (60 seconds)
kleepeh: folds
kanococo: folds
HoldBabyHold: folds
Joshaf: calls 0.04
Pinzer94: calls 0.03
*** FLOP *** [Qh Qs Th]
Joshaf: checks
Pinzer94: checks
betformony: bets 0.07
Joshaf: calls 0.07
Pinzer94: folds
*** TURN *** [Qh Qs Th] [5d]
Joshaf: checks
betformony: bets 0.18
Joshaf: folds
Uncalled bet (0.18) returned to betformony
betformony collected 0.28 from pot
betformony: doesn't show hand
*** SUMMARY ***
Total pot 0.29 | Rake 0.01
Board [ Qh Qs Th 5d ]
Game ended: 2025/09/02 18:21:42 GMT
Seat 1: Joshaf (small blind) folded on the Turn
Seat 2: Pinzer94 (big blind) folded on the Flop
Seat 3: betformony collected (0.28)
Seat 4: Lorens95 folded before Flop (didn't bet)
Seat 5: kleepeh folded before Flop (didn't bet)
Seat 6: kanococo folded before Flop (didn't bet)
Seat 7: HoldBabyHold (button) folded before Flop (didn't bet)

CoinPoker Hand #291160234: Hold'em No Limit (0.01/0.02 ) 2025/09/02 18:21:45 GMT
Table 'NL ₮2 V' 7-max Seat #1 is the button
Seat 1: Joshaf (1.95 in chips)
Seat 2: Pinzer94 (2.22 in chips)
Seat 3: betformony (2.62 in chips)
Seat 4: Lorens95 (2.08 in chips)
Seat 5: kleepeh (2.00 in chips)
Seat 6: kanococo (2.13 in chips)
Seat 7: HoldBabyHold (2.00 in chips)
Pinzer94: posts small blind 0.01
betformony: posts big blind 0.02
*** HOLE CARDS ***
Dealt to kanococo [Qs 7d]
Lorens95: folds
kleepeh: raises 0.02 to 0.04
kanococo: folds
HoldBabyHold: folds
Joshaf: folds
Pinzer94: folds
betformony: folds
kleepeh collected 0.07 from pot
kleepeh: doesn't show hand
*** SUMMARY ***
Total pot 0.07 | Rake 0.00
Board [ ]
Game ended: 2025/09/02 18:22:20 GMT
Seat 1: Joshaf (button) folded before Flop (didn't bet)
Seat 2: Pinzer94 (small blind) folded before Flop
Seat 3: betformony (big blind) folded before Flop
Seat 4: Lorens95 folded before Flop (didn't bet)
Seat 5: kleepeh collected (0.07)
Seat 6: kanococo folded before Flop (didn't bet)
Seat 7: HoldBabyHold folded before Flop (didn't bet)

CoinPoker Hand #291160611: Hold'em No Limit (0.01/0.02 ) 2025/09/02 18:22:23 GMT
Table 'NL ₮2 V' 7-max Seat #2 is the button
Seat 1: Joshaf (1.95 in chips)
Seat 2: Pinzer94 (2.21 in chips)
Seat 3: betformony (2.60 in chips)
Seat 4: Lorens95 (2.08 in chips)
Seat 5: kleepeh (2.03 in chips)
Seat 6: kanococo (2.13 in chips)
Seat 7: HoldBabyHold (2.00 in chips)
betformony: posts small blind 0.01
Lorens95: posts big blind 0.02
*** HOLE CARDS ***
Dealt to kanococo [6h As]
kleepeh: folds
kanococo: raises 0.02 to 0.04
HoldBabyHold: folds
Joshaf: folds
Pinzer94: folds
betformony: folds
Lorens95: folds
kanococo collected 0.07 from pot
kanococo: doesn't show hand
*** SUMMARY ***
Total pot 0.07 | Rake 0.00
Board [ ]
Game ended: 2025/09/02 18:22:54 GMT
Seat 1: Joshaf folded before Flop (didn't bet)
Seat 2: Pinzer94 (button) folded before Flop (didn't bet)
Seat 3: betformony (small blind) folded before Flop
Seat 4: Lorens95 (big blind) folded before Flop
Seat 5: kleepeh folded before Flop (didn't bet)
Seat 6: kanococo collected (0.07)
Seat 7: HoldBabyHold folded before Flop (didn't bet)

CoinPoker Hand #291161013: Hold'em No Limit (0.01/0.02 ) 2025/09/02 18:22:59 GMT
Table 'NL ₮2 V' 7-max Seat #3 is the button
Seat 1: Joshaf (1.95 in chips)
Seat 2: Pinzer94 (2.21 in chips)
Seat 3: betformony (2.59 in chips)
Seat 4: Lorens95 (2.06 in chips)
Seat 5: kleepeh (2.03 in chips)
Seat 6: kanococo (2.16 in chips)
Seat 7: HoldBabyHold (2.00 in chips)
Lorens95: posts small blind 0.01
kleepeh: posts big blind 0.02
*** HOLE CARDS ***
Dealt to kanococo [Jc 7h]
kanococo: raises 0.02 to 0.04
HoldBabyHold: folds
Joshaf: calls 0.04
Pinzer94: folds
betformony: raises 0.15 to 0.19
Lorens95: calls 0.18
kleepeh: folds
kanococo: folds
Joshaf: calls 0.15
*** FLOP *** [Td 5s Jd]
Lorens95: checks
Joshaf: bets 0.30
betformony: calls 0.30
Lorens95: calls 0.30
*** TURN *** [Td 5s Jd] [2s]
Lorens95: checks
Joshaf has timed out
Joshaf activated time-bank (60 seconds)
Joshaf: bets 0.12
betformony: raises 0.84 to 0.96
Lorens95: folds
Joshaf: raises 1.34 and is all-in
betformony: calls 0.50
*** RIVER *** [Td 5s Jd 2s] [Tc]
*** SHOW DOWN ***
Joshaf: shows [Js Ad] (two pairs, Jacks and Tens)
betformony: shows [Qs Qd] (two pairs, Queens and Tens)
betformony collected 4.25 from pot
*** SUMMARY ***
Total pot 4.45 | Rake 0.20
Board [ Td 5s Jd 2s Tc ]
Game ended: 2025/09/02 18:24:48 GMT
Seat 1: Joshaf showed [Js Ad]
Seat 2: Pinzer94 folded before Flop (didn't bet)
Seat 3: betformony (button) showed [Qs Qd] and won (4.25) with two pairs, Queens and Tens
Seat 4: Lorens95 (small blind) folded on the Turn
Seat 5: kleepeh (big blind) folded before Flop
Seat 6: kanococo folded before Flop
Seat 7: HoldBabyHold folded before Flop (didn't bet)

CoinPoker Hand #291161956: Hold'em No Limit (0.01/0.02 ) 2025/09/02 18:24:52 GMT
Table 'NL ₮2 V' 7-max Seat #4 is the button
Seat 2: Pinzer94 (2.21 in chips)
Seat 3: betformony (4.89 in chips)
Seat 4: Lorens95 (2.00 in chips)
Seat 5: kleepeh (2.01 in chips)
Seat 6: kanococo (2.12 in chips)
Seat 7: HoldBabyHold (2.00 in chips)
kleepeh: posts small blind 0.01
kanococo: posts big blind 0.02
*** HOLE CARDS ***
Dealt to kanococo [As Kh]
HoldBabyHold: folds
Pinzer94: folds
betformony: folds
Lorens95: folds
kleepeh: raises 0.04 to 0.06
kanococo: raises 0.06 to 0.12
kleepeh: calls 0.06
*** FLOP *** [6d Qd 9h]
kleepeh: checks
kanococo: checks
*** TURN *** [6d Qd 9h] [Qc]
kleepeh: bets 0.11
kanococo: calls 0.11
*** RIVER *** [6d Qd 9h Qc] [5d]
kleepeh: bets 0.60
kanococo: folds
Uncalled bet (0.60) returned to kleepeh
kleepeh collected 0.44 from pot
kleepeh: doesn't show hand
*** SUMMARY ***
Total pot 0.46 | Rake 0.02
Board [ 6d Qd 9h Qc 5d ]
Game ended: 2025/09/02 18:25:56 GMT
Seat 2: Pinzer94 folded before Flop (didn't bet)
Seat 3: betformony folded before Flop (didn't bet)
Seat 4: Lorens95 (button) folded before Flop (didn't bet)
Seat 5: kleepeh (small blind) collected (0.44)
Seat 6: kanococo (big blind) folded on the River
Seat 7: HoldBabyHold folded before Flop (didn't bet)

CoinPoker Hand #291162543: Hold'em No Limit (0.01/0.02 ) 2025/09/02 18:26:00 GMT
Table 'NL ₮2 V' 7-max Seat #5 is the button
Seat 2: Pinzer94 (2.21 in chips)
Seat 3: betformony (4.89 in chips)
Seat 4: Lorens95 (2.00 in chips)
Seat 5: kleepeh (2.22 in chips)
Seat 6: kanococo (1.89 in chips)
Seat 7: HoldBabyHold (2.00 in chips)
kanococo: posts small blind 0.01
HoldBabyHold: posts big blind 0.02
*** HOLE CARDS ***
Dealt to kanococo [8s 5c]
Pinzer94: folds
betformony: folds
Lorens95: folds
kleepeh: folds
kanococo: raises 0.02 to 0.04
HoldBabyHold: raises 0.10 to 0.14
kanococo: folds
HoldBabyHold collected 0.18 from pot
HoldBabyHold: doesn't show hand
*** SUMMARY ***
Total pot 0.18 | Rake 0.00
Board [ ]
Game ended: 2025/09/02 18:26:32 GMT
Seat 2: Pinzer94 folded before Flop (didn't bet)
Seat 3: betformony folded before Flop (didn't bet)
Seat 4: Lorens95 folded before Flop (didn't bet)
Seat 5: kleepeh (button) folded before Flop (didn't bet)
Seat 6: kanococo (small blind) folded before Flop
Seat 7: HoldBabyHold (big blind) collected (0.18)

CoinPoker Hand #291162801: Hold'em No Limit (0.01/0.02 ) 2025/09/02 18:26:35 GMT
Table 'NL ₮2 V' 7-max Seat #6 is the button
Seat 2: Pinzer94 (2.21 in chips)
Seat 3: betformony (4.89 in chips)
Seat 4: Lorens95 (2.00 in chips)
Seat 5: kleepeh (2.22 in chips)
Seat 6: kanococo (1.85 in chips)
Seat 7: HoldBabyHold (2.04 in chips)
HoldBabyHold: posts small blind 0.01
Pinzer94: posts big blind 0.02
*** HOLE CARDS ***
Dealt to kanococo [Qc 6h]
betformony: folds
Lorens95: folds
kleepeh: folds
kanococo: raises 0.04 to 0.06
HoldBabyHold: raises 0.16 to 0.22
Pinzer94: folds
kanococo: calls 0.16
*** FLOP *** [Ah Jd Qh]
HoldBabyHold: bets 0.14
kanococo: raises 1.63 and is all-in
HoldBabyHold: calls 1.49
*** TURN *** [Ah Jd Qh] [Jc]
*** RIVER *** [Ah Jd Qh Jc] [Tc]
*** SHOW DOWN ***
kanococo: shows [Qc 6h] (two pairs, Queens and Jacks)
HoldBabyHold: shows [As 5s] (two pairs, Aces and Jacks)
HoldBabyHold collected 3.53 from pot
*** SUMMARY ***
Total pot 3.72 | Rake 0.19
Board [ Ah Jd Qh Jc Tc ]
Game ended: 2025/09/02 18:27:41 GMT
Seat 2: Pinzer94 (big blind) folded before Flop
Seat 3: betformony folded before Flop (didn't bet)
Seat 4: Lorens95 folded before Flop (didn't bet)
Seat 5: kleepeh folded before Flop (didn't bet)
Seat 6: kanococo (button) showed [Qc 6h]
Seat 7: HoldBabyHold (small blind) showed [As 5s] and won (3.53) with two pairs, Aces and Jacks

CoinPoker Hand #291164346: Hold'em No Limit (0.01/0.02 ) 2025/09/02 18:29:28 GMT
Table 'NL ₮2 VI' 7-max Seat #4 is the button
Seat 1: SQuest (3.51 in chips)
Seat 2: naifa (7.32 in chips)
Seat 3: MokiMoki (0.72 in chips)
Seat 4: crispzilla (2.00 in chips)
Seat 5: kanococo (2.00 in chips)
Seat 6: LuckyDragon (3.08 in chips)
Seat 7: GrendelGreat (2.00 in chips)
LuckyDragon: posts small blind 0.01
GrendelGreat: posts big blind 0.02
kanococo: posts big blind 0.02
*** HOLE CARDS ***
Dealt to kanococo [5s Jh]
SQuest: raises 0.04 to 0.06
naifa: folds
MokiMoki: folds
crispzilla: folds
kanococo: folds
LuckyDragon: folds
GrendelGreat: folds
SQuest collected 0.11 from pot
SQuest: doesn't show hand
*** SUMMARY ***
Total pot 0.11 | Rake 0.00
Board [ ]
Game ended: 2025/09/02 18:30:03 GMT
Seat 1: SQuest collected (0.11)
Seat 2: naifa folded before Flop (didn't bet)
Seat 3: MokiMoki folded before Flop (didn't bet)
Seat 4: crispzilla (button) folded before Flop (didn't bet)
Seat 5: kanococo folded before Flop
Seat 6: LuckyDragon (small blind) folded before Flop
Seat 7: GrendelGreat (big blind) folded before Flop

CoinPoker Hand #291164681: Hold'em No Limit (0.01/0.02 ) 2025/09/02 18:30:05 GMT
Table 'NL ₮2 VI' 7-max Seat #6 is the button
Seat 1: SQuest (3.56 in chips)
Seat 2: naifa (7.32 in chips)
Seat 3: MokiMoki (0.72 in chips)
Seat 4: crispzilla (2.00 in chips)
Seat 5: kanococo (1.98 in chips)
Seat 6: LuckyDragon (3.07 in chips)
Seat 7: GrendelGreat (2.00 in chips)
GrendelGreat: posts small blind 0.01
SQuest: posts big blind 0.02
*** HOLE CARDS ***
Dealt to kanococo [4h 9d]
naifa: folds
MokiMoki: raises 0.03 to 0.05
crispzilla: folds
kanococo: folds
LuckyDragon: folds
GrendelGreat: calls 0.04
SQuest: folds
*** FLOP *** [6h 7h Ah]
GrendelGreat: bets 0.11
MokiMoki: folds
Uncalled bet (0.11) returned to GrendelGreat
GrendelGreat collected 0.11 from pot
GrendelGreat: doesn't show hand
*** SUMMARY ***
Total pot 0.12 | Rake 0.01
Board [ 6h 7h Ah ]
Game ended: 2025/09/02 18:31:01 GMT
Seat 1: SQuest (big blind) folded before Flop
Seat 2: naifa folded before Flop (didn't bet)
Seat 3: MokiMoki folded on the Flop
Seat 4: crispzilla folded before Flop (didn't bet)
Seat 5: kanococo folded before Flop (didn't bet)
Seat 6: LuckyDragon (button) folded before Flop (didn't bet)
Seat 7: GrendelGreat (small blind) collected (0.11)

CoinPoker Hand #291165169: Hold'em No Limit (0.01/0.02 ) 2025/09/02 18:31:04 GMT
Table 'NL ₮2 VI' 7-max Seat #7 is the button
Seat 1: SQuest (3.54 in chips)
Seat 2: naifa (7.32 in chips)
Seat 3: MokiMoki (0.67 in chips)
Seat 4: crispzilla (2.00 in chips)
Seat 5: kanococo (1.98 in chips)
Seat 6: LuckyDragon (3.07 in chips)
Seat 7: GrendelGreat (2.06 in chips)
SQuest: posts small blind 0.01
naifa: posts big blind 0.02
*** HOLE CARDS ***
Dealt to kanococo [As Qc]
MokiMoki: folds
crispzilla: folds
kanococo: raises 0.02 to 0.04
LuckyDragon: folds
GrendelGreat: folds
SQuest: calls 0.03
naifa: folds
*** FLOP *** [Jh Kh 7h]
SQuest: checks
kanococo: checks
*** TURN *** [Jh Kh 7h] [9h]
SQuest: checks
kanococo: bets 0.04
SQuest has timed out
SQuest activated time-bank (59 seconds)
SQuest: folds
Uncalled bet (0.04) returned to kanococo
kanococo collected 0.09 from pot
kanococo: doesn't show hand
*** SUMMARY ***
Total pot 0.10 | Rake 0.01
Board [ Jh Kh 7h 9h ]
Game ended: 2025/09/02 18:32:05 GMT
Seat 1: SQuest (small blind) folded on the Turn
Seat 2: naifa (big blind) folded before Flop
Seat 3: MokiMoki folded before Flop (didn't bet)
Seat 4: crispzilla folded before Flop (didn't bet)
Seat 5: kanococo collected (0.09)
Seat 6: LuckyDragon folded before Flop (didn't bet)
Seat 7: GrendelGreat (button) folded before Flop (didn't bet)

CoinPoker Hand #291165861: Hold'em No Limit (0.01/0.02 ) 2025/09/02 18:32:07 GMT
Table 'NL ₮2 VI' 7-max Seat #1 is the button
Seat 1: SQuest (3.50 in chips)
Seat 2: naifa (7.30 in chips)
Seat 3: MokiMoki (0.80 in chips)
Seat 4: crispzilla (2.00 in chips)
Seat 5: kanococo (2.03 in chips)
Seat 6: LuckyDragon (3.07 in chips)
Seat 7: GrendelGreat (2.06 in chips)
naifa: posts small blind 0.01
MokiMoki: posts big blind 0.02
*** HOLE CARDS ***
Dealt to kanococo [8c 2d]
crispzilla: folds
kanococo: folds
LuckyDragon: calls 0.02
GrendelGreat: raises 0.04 to 0.06
SQuest: folds
naifa: folds
MokiMoki: folds
LuckyDragon: folds
GrendelGreat collected 0.11 from pot
GrendelGreat: doesn't show hand
*** SUMMARY ***
Total pot 0.11 | Rake 0.00
Board [ ]
Game ended: 2025/09/02 18:32:39 GMT
Seat 1: SQuest (button) folded before Flop (didn't bet)
Seat 2: naifa (small blind) folded before Flop
Seat 3: MokiMoki (big blind) folded before Flop
Seat 4: crispzilla folded before Flop (didn't bet)
Seat 5: kanococo folded before Flop (didn't bet)
Seat 6: LuckyDragon folded before Flop
Seat 7: GrendelGreat collected (0.11)

CoinPoker Hand #291166176: Hold'em No Limit (0.01/0.02 ) 2025/09/02 18:32:41 GMT
Table 'NL ₮2 VI' 7-max Seat #2 is the button
Seat 1: SQuest (3.50 in chips)
Seat 2: naifa (7.29 in chips)
Seat 3: MokiMoki (0.78 in chips)
Seat 4: crispzilla (2.00 in chips)
Seat 5: kanococo (2.03 in chips)
Seat 6: LuckyDragon (3.05 in chips)
Seat 7: GrendelGreat (2.11 in chips)
MokiMoki: posts small blind 0.01
crispzilla: posts big blind 0.02
*** HOLE CARDS ***
Dealt to kanococo [3c 6d]
kanococo: folds
LuckyDragon: calls 0.02
GrendelGreat: folds
SQuest: raises 0.06 to 0.08
naifa: folds
MokiMoki: folds
crispzilla: folds
LuckyDragon: calls 0.06
*** FLOP *** [Kd Qc 9d]
LuckyDragon: checks
SQuest: checks
*** TURN *** [Kd Qc 9d] [Jd]
LuckyDragon: bets 0.10
SQuest: folds
Uncalled bet (0.10) returned to LuckyDragon
LuckyDragon collected 0.18 from pot
LuckyDragon: doesn't show hand
*** SUMMARY ***
Total pot 0.19 | Rake 0.01
Board [ Kd Qc 9d Jd ]
Game ended: 2025/09/02 18:33:49 GMT
Seat 1: SQuest folded on the Turn
Seat 2: naifa (button) folded before Flop (didn't bet)
Seat 3: MokiMoki (small blind) folded before Flop
Seat 4: crispzilla (big blind) folded before Flop
Seat 5: kanococo folded before Flop (didn't bet)
Seat 6: LuckyDragon collected (0.18)
Seat 7: GrendelGreat folded before Flop (didn't bet)

CoinPoker Hand #291166996: Hold'em No Limit (0.01/0.02 ) 2025/09/02 18:33:51 GMT
Table 'NL ₮2 VI' 7-max Seat #3 is the button
Seat 1: SQuest (3.42 in chips)
Seat 2: naifa (7.29 in chips)
Seat 3: MokiMoki (0.77 in chips) is sitting out
Seat 4: crispzilla (1.98 in chips)
Seat 5: kanococo (2.03 in chips)
Seat 6: LuckyDragon (3.15 in chips)
Seat 7: GrendelGreat (2.11 in chips)
crispzilla: posts small blind 0.01
kanococo: posts big blind 0.02
*** HOLE CARDS ***
Dealt to kanococo [5c Th]
LuckyDragon: calls 0.02
GrendelGreat: raises 0.02 to 0.04
SQuest: folds
naifa: folds
crispzilla: folds
kanococo: folds
LuckyDragon: calls 0.02
*** FLOP *** [8s Ad 8h]
LuckyDragon: checks
GrendelGreat has timed out
GrendelGreat activated time-bank (39 seconds)
GrendelGreat: bets 0.03
LuckyDragon: calls 0.03
*** TURN *** [8s Ad 8h] [3h]
LuckyDragon: folds
GrendelGreat collected 0.16 from pot
GrendelGreat: doesn't show hand
*** SUMMARY ***
Total pot 0.17 | Rake 0.01
Board [ 8s Ad 8h 3h ]
Game ended: 2025/09/02 18:35:05 GMT
Seat 1: SQuest folded before Flop (didn't bet)
Seat 2: naifa folded before Flop (didn't bet)
Seat 3: MokiMoki (button) folded before Flop (didn't bet)
Seat 4: crispzilla (small blind) folded before Flop
Seat 5: kanococo (big blind) folded before Flop
Seat 6: LuckyDragon folded on the Turn
Seat 7: GrendelGreat collected (0.16)

CoinPoker Hand #291167774: Hold'em No Limit (0.01/0.02 ) 2025/09/02 18:35:07 GMT
Table 'NL ₮2 VI' 7-max Seat #4 is the button
Seat 1: SQuest (3.42 in chips)
Seat 2: naifa (7.29 in chips)
Seat 3: tiokosrs (2.00 in chips)
Seat 4: crispzilla (2.00 in chips)
Seat 5: kanococo (2.01 in chips)
Seat 6: LuckyDragon (3.08 in chips)
Seat 7: GrendelGreat (2.20 in chips)
kanococo: posts small blind 0.01
LuckyDragon: posts big blind 0.02
tiokosrs: posts big blind 0.02
*** HOLE CARDS ***
Dealt to kanococo [4s 8c]
GrendelGreat: folds
SQuest: raises 0.06 to 0.08
naifa: folds
tiokosrs: folds
crispzilla: folds
kanococo: folds
LuckyDragon: calls 0.06
*** FLOP *** [8d 3s 6d]
LuckyDragon: checks
SQuest: bets 0.12
LuckyDragon: calls 0.12
*** TURN *** [8d 3s 6d] [Ad]
LuckyDragon: bets 0.16
SQuest: calls 0.16
*** RIVER *** [8d 3s 6d Ad] [Jd]
LuckyDragon: bets 0.24
SQuest: calls 0.24
*** SHOW DOWN ***
LuckyDragon: shows [Ks 2h] (Ace high)
SQuest: shows [Js Jh] (three of kind, Jacks)
SQuest collected 1.17 from pot
*** SUMMARY ***
Total pot 1.23 | Rake 0.06
Board [ 8d 3s 6d Ad Jd ]
Game ended: 2025/09/02 18:36:32 GMT
Seat 1: SQuest showed [Js Jh] and won (1.17) with three of kind, Jacks
Seat 2: naifa folded before Flop (didn't bet)
Seat 3: tiokosrs folded before Flop
Seat 4: crispzilla (button) folded before Flop (didn't bet)
Seat 5: kanococo (small blind) folded before Flop
Seat 6: LuckyDragon (big blind) showed [Ks 2h]
Seat 7: GrendelGreat folded before Flop (didn't bet)

CoinPoker Hand #291168584: Hold'em No Limit (0.01/0.02 ) 2025/09/02 18:36:35 GMT
Table 'NL ₮2 VI' 7-max Seat #5 is the button
Seat 1: SQuest (3.99 in chips)
Seat 2: naifa (7.29 in chips)
Seat 3: tiokosrs (1.98 in chips)
Seat 4: crispzilla (2.00 in chips)
Seat 5: kanococo (2.00 in chips)
Seat 6: LuckyDragon (2.48 in chips)
Seat 7: LegendK (2.00 in chips)
LuckyDragon: posts small blind 0.01
LegendK: posts big blind 0.02
*** HOLE CARDS ***
Dealt to kanococo [Kh 9d]
SQuest: folds
naifa: folds
tiokosrs: folds
crispzilla: folds
kanococo: raises 0.04 to 0.06
LuckyDragon: calls 0.05
LegendK: calls 0.04
*** FLOP *** [6h 5c Ts]
LuckyDragon: checks
LegendK: checks
kanococo: checks
*** TURN *** [6h 5c Ts] [7h]
LuckyDragon: checks
LegendK: checks
kanococo: bets 0.04
LuckyDragon: calls 0.04
LegendK: folds
*** RIVER *** [6h 5c Ts 7h] [3d]
LuckyDragon: checks
kanococo: checks
*** SHOW DOWN ***
LuckyDragon: shows [9c Kd] (King high)
kanococo: shows [Kh 9d] (King high)
LuckyDragon collected 0.13 from pot
kanococo collected 0.12 from pot
*** SUMMARY ***
Total pot 0.26 | Rake 0.01
Board [ 6h 5c Ts 7h 3d ]
Game ended: 2025/09/02 18:37:51 GMT
Seat 1: SQuest folded before Flop (didn't bet)
Seat 2: naifa folded before Flop (didn't bet)
Seat 3: tiokosrs folded before Flop (didn't bet)
Seat 4: crispzilla folded before Flop (didn't bet)
Seat 5: kanococo (button) showed [Kh 9d] and won (0.12) with King high
Seat 6: LuckyDragon (small blind) showed [9c Kd] and won (0.13) with King high
Seat 7: LegendK (big blind) folded on the Turn

CoinPoker Hand #291169713: Hold'em No Limit (0.01/0.02 ) 2025/09/02 18:37:53 GMT
Table 'NL ₮2 VI' 7-max Seat #6 is the button
Seat 1: SQuest (3.99 in chips)
Seat 2: naifa (7.29 in chips)
Seat 3: tiokosrs (1.98 in chips)
Seat 4: crispzilla (2.00 in chips)
Seat 5: kanococo (2.02 in chips)
Seat 6: LuckyDragon (2.51 in chips)
Seat 7: LegendK (1.94 in chips)
LegendK: posts small blind 0.01
SQuest: posts big blind 0.02
*** HOLE CARDS ***
Dealt to kanococo [Jh 8c]
naifa: folds
tiokosrs has timed out
tiokosrs activated time-bank (60 seconds)
tiokosrs: folds
crispzilla: folds
kanococo: folds
LuckyDragon: calls 0.02
LegendK: calls 0.01
SQuest: checks
*** FLOP *** [2h 7c 3d]
LegendK: checks
SQuest: checks
LuckyDragon: checks
*** TURN *** [2h 7c 3d] [4s]
LegendK: checks
SQuest: bets 0.04
LuckyDragon: folds
LegendK: calls 0.04
*** RIVER *** [2h 7c 3d 4s] [9s]
LegendK: checks
SQuest: bets 0.10
LegendK: folds
Uncalled bet (0.10) returned to SQuest
SQuest collected 0.13 from pot
SQuest: doesn't show hand
*** SUMMARY ***
Total pot 0.14 | Rake 0.01
Board [ 2h 7c 3d 4s 9s ]
Game ended: 2025/09/02 18:41:03 GMT
Seat 1: SQuest (big blind) collected (0.13)
Seat 2: naifa folded before Flop (didn't bet)
Seat 3: tiokosrs folded before Flop (didn't bet)
Seat 4: crispzilla folded before Flop (didn't bet)
Seat 5: kanococo folded before Flop (didn't bet)
Seat 6: LuckyDragon (button) folded on the Turn
Seat 7: LegendK (small blind) folded on the River

CoinPoker Hand #291171925: Hold'em No Limit (0.01/0.02 ) 2025/09/02 18:41:04 GMT
Table 'NL ₮2 VI' 7-max Seat #7 is the button
Seat 1: SQuest (4.06 in chips)
Seat 2: naifa (7.29 in chips)
Seat 3: tiokosrs (1.98 in chips)
Seat 4: crispzilla (2.00 in chips)
Seat 5: kanococo (2.02 in chips)
Seat 6: LuckyDragon (2.49 in chips)
Seat 7: LegendK (1.88 in chips)
SQuest: posts small blind 0.01
naifa: posts big blind 0.02
*** HOLE CARDS ***
Dealt to kanococo [7h Jh]
tiokosrs: folds
crispzilla: folds
kanococo: folds
LuckyDragon has timed out
LuckyDragon activated time-bank (58 seconds)
LuckyDragon: calls 0.02
LegendK: folds
SQuest: folds
naifa: checks
*** FLOP *** [Ad Kc 2h]
naifa: checks
LuckyDragon: bets 0.10
naifa: folds
Uncalled bet (0.10) returned to LuckyDragon
LuckyDragon collected 0.05 from pot
LuckyDragon: doesn't show hand
*** SUMMARY ***
Total pot 0.05 | Rake 0.00
Board [ Ad Kc 2h ]
Game ended: 2025/09/02 18:41:55 GMT
Seat 1: SQuest (small blind) folded before Flop
Seat 2: naifa (big blind) folded on the Flop
Seat 3: tiokosrs folded before Flop (didn't bet)
Seat 4: crispzilla folded before Flop (didn't bet)
Seat 5: kanococo folded before Flop (didn't bet)
Seat 6: LuckyDragon collected (0.05)
Seat 7: LegendK (button) folded before Flop (didn't bet)

CoinPoker Hand #291227176: Hold'em No Limit (0.01/0.02 ) 2025/09/02 20:29:50 GMT
Table 'NL ₮2 III' 7-max Seat #1 is the button
Seat 1: Elblop (2.18 in chips)
Seat 2: kanococo (2.00 in chips)
Seat 3: HoldBabyHold (2.01 in chips)
Seat 4: SarkastikBS (1.70 in chips)
Seat 5: GG18vivek (3.37 in chips)
Seat 6: LarryBerry217 (1.71 in chips)
Seat 7: crispzilla (2.16 in chips)
HoldBabyHold: posts small blind 0.01
SarkastikBS: posts big blind 0.02
kanococo: posts big blind 0.02
*** HOLE CARDS ***
Dealt to kanococo [7s 4c]
GG18vivek: folds
LarryBerry217: raises 0.03 to 0.05
crispzilla: raises 0.10 to 0.15
Elblop: folds
kanococo: folds
HoldBabyHold: folds
SarkastikBS: folds
LarryBerry217: folds
crispzilla collected 0.25 from pot
crispzilla: doesn't show hand
*** SUMMARY ***
Total pot 0.25 | Rake 0.00
Board [ ]
Game ended: 2025/09/02 20:30:16 GMT
Seat 1: Elblop (button) folded before Flop (didn't bet)
Seat 2: kanococo folded before Flop
Seat 3: HoldBabyHold (small blind) folded before Flop
Seat 4: SarkastikBS (big blind) folded before Flop
Seat 5: GG18vivek folded before Flop (didn't bet)
Seat 6: LarryBerry217 folded before Flop
Seat 7: crispzilla collected (0.25)

CoinPoker Hand #291227419: Hold'em No Limit (0.01/0.02 ) 2025/09/02 20:30:18 GMT
Table 'NL ₮2 III' 7-max Seat #3 is the button
Seat 1: Elblop (2.18 in chips)
Seat 2: kanococo (1.98 in chips)
Seat 3: HoldBabyHold (2.00 in chips)
Seat 4: SarkastikBS (1.68 in chips)
Seat 5: GG18vivek (3.37 in chips)
Seat 6: LarryBerry217 (1.66 in chips)
Seat 7: crispzilla (2.26 in chips)
SarkastikBS: posts small blind 0.01
GG18vivek: posts big blind 0.02
*** HOLE CARDS ***
Dealt to kanococo [Qc 2c]
LarryBerry217: folds
crispzilla: folds
Elblop: folds
kanococo: raises 0.02 to 0.04
HoldBabyHold: folds
SarkastikBS: folds
GG18vivek is disconnected
GG18vivek has timed out wile being disconnected
GG18vivek activated time-bank (59 seconds)
kanococo said, "Lol"
GG18vivek has timed out wile being disconnected
GG18vivek: folds
kanococo collected 0.07 from pot
kanococo: doesn't show hand
*** SUMMARY ***
Total pot 0.07 | Rake 0.00
Board [ ]
Game ended: 2025/09/02 20:32:59 GMT
Seat 1: Elblop folded before Flop (didn't bet)
Seat 2: kanococo collected (0.07)
Seat 3: HoldBabyHold (button) folded before Flop (didn't bet)
Seat 4: SarkastikBS (small blind) folded before Flop
Seat 5: GG18vivek (big blind) folded before Flop
Seat 6: LarryBerry217 folded before Flop (didn't bet)
Seat 7: crispzilla folded before Flop (didn't bet)

CoinPoker Hand #291228651: Hold'em No Limit (0.01/0.02 ) 2025/09/02 20:33:01 GMT
Table 'NL ₮2 III' 7-max Seat #4 is the button
Seat 1: Elblop (2.18 in chips)
Seat 2: kanococo (2.01 in chips)
Seat 3: HoldBabyHold (2.00 in chips)
Seat 4: SarkastikBS (1.67 in chips)
Seat 5: GG18vivek (3.35 in chips) is sitting out
Seat 6: LarryBerry217 (1.66 in chips)
Seat 7: crispzilla (2.26 in chips)
LarryBerry217: posts small blind 0.01
crispzilla: posts big blind 0.02
*** HOLE CARDS ***
Dealt to kanococo [Qs 6s]
Elblop: folds
kanococo: folds
HoldBabyHold: folds
SarkastikBS: folds
LarryBerry217: calls 0.01
crispzilla: raises 0.04 to 0.06
LarryBerry217: folds
crispzilla collected 0.08 from pot
crispzilla: doesn't show hand
*** SUMMARY ***
Total pot 0.08 | Rake 0.00
Board [ ]
Game ended: 2025/09/02 20:33:22 GMT
Seat 1: Elblop folded before Flop (didn't bet)
Seat 2: kanococo folded before Flop (didn't bet)
Seat 3: HoldBabyHold folded before Flop (didn't bet)
Seat 4: SarkastikBS (button) folded before Flop (didn't bet)
Seat 5: GG18vivek folded before Flop (didn't bet)
Seat 6: LarryBerry217 (small blind) folded before Flop
Seat 7: crispzilla (big blind) collected (0.08)

CoinPoker Hand #291228859: Hold'em No Limit (0.01/0.02 ) 2025/09/02 20:33:25 GMT
Table 'NL ₮2 III' 7-max Seat #6 is the button
Seat 1: Elblop (2.18 in chips)
Seat 2: kanococo (2.01 in chips)
Seat 3: HoldBabyHold (2.00 in chips)
Seat 4: SarkastikBS (1.67 in chips)
Seat 5: GG18vivek (3.35 in chips) is sitting out
Seat 6: LarryBerry217 (1.64 in chips)
Seat 7: crispzilla (2.28 in chips)
crispzilla: posts small blind 0.01
Elblop: posts big blind 0.02
*** HOLE CARDS ***
Dealt to kanococo [Kh Js]
kanococo: raises 0.02 to 0.04
HoldBabyHold: calls 0.04
SarkastikBS: raises 0.20 to 0.24
LarryBerry217: folds
crispzilla: folds
Elblop: calls 0.22
kanococo: calls 0.20
HoldBabyHold: calls 0.20
*** FLOP *** [2s 8s Kd]
Elblop: checks
kanococo: bets 0.46
HoldBabyHold: folds
SarkastikBS: raises 1.43 and is all-in
Elblop: folds
kanococo: calls 0.97
*** TURN *** [2s 8s Kd] [Ad]
*** RIVER *** [2s 8s Kd Ad] [7d]
*** SHOW DOWN ***
SarkastikBS: shows [As Qs] (a pair of Aces)
kanococo: shows [Kh Js] (a pair of Kings)
SarkastikBS collected 3.64 from pot
*** SUMMARY ***
Total pot 3.83 | Rake 0.19
Board [ 2s 8s Kd Ad 7d ]
Game ended: 2025/09/02 20:34:19 GMT
Seat 1: Elblop (big blind) folded on the Flop
Seat 2: kanococo showed [Kh Js]
Seat 3: HoldBabyHold folded on the Flop
Seat 4: SarkastikBS showed [As Qs] and won (3.64) with a pair of Aces
Seat 5: GG18vivek folded before Flop (didn't bet)
Seat 6: LarryBerry217 (button) folded before Flop (didn't bet)
Seat 7: crispzilla (small blind) folded before Flop

CoinPoker Hand #291229353: Hold'em No Limit (0.01/0.02 ) 2025/09/02 20:34:21 GMT
Table 'NL ₮2 III' 7-max Seat #7 is the button
Seat 1: Elblop (2.00 in chips)
Seat 2: kanococo (0.34 in chips)
Seat 3: HoldBabyHold (2.00 in chips)
Seat 4: SarkastikBS (3.64 in chips)
Seat 5: GG18vivek (3.35 in chips) is sitting out
Seat 6: LarryBerry217 (1.64 in chips)
Seat 7: crispzilla (2.27 in chips)
Elblop: posts small blind 0.01
kanococo: posts big blind 0.02
*** HOLE CARDS ***
Dealt to kanococo [9h 9c]
HoldBabyHold: folds
SarkastikBS: raises 0.03 to 0.05
LarryBerry217: calls 0.05
crispzilla: folds
Elblop: calls 0.04
kanococo: raises 0.32 and is all-in
SarkastikBS: folds
LarryBerry217: calls 0.29
Elblop: folds
*** FLOP *** [2c 4d 2h]
*** TURN *** [2c 4d 2h] [Ac]
*** RIVER *** [2c 4d 2h Ac] [5c]
*** SHOW DOWN ***
kanococo: shows [9h 9c] (two pairs, Nines and Twos)
LarryBerry217: shows [8s Kh] (a pair of Twos)
kanococo collected 0.74 from pot
*** SUMMARY ***
Total pot 0.78 | Rake 0.04
Board [ 2c 4d 2h Ac 5c ]
Game ended: 2025/09/02 20:35:15 GMT
Seat 1: Elblop (small blind) folded before Flop
Seat 2: kanococo (big blind) showed [9h 9c] and won (0.74) with two pairs, Nines and Twos
Seat 3: HoldBabyHold folded before Flop (didn't bet)
Seat 4: SarkastikBS folded before Flop
Seat 5: GG18vivek folded before Flop (didn't bet)
Seat 6: LarryBerry217 showed [8s Kh]
Seat 7: crispzilla (button) folded before Flop (didn't bet)

CoinPoker Hand #291229744: Hold'em No Limit (0.01/0.02 ) 2025/09/02 20:35:17 GMT
Table 'NL ₮2 III' 7-max Seat #1 is the button
Seat 1: Elblop (1.95 in chips)
Seat 2: kanococo (0.74 in chips)
Seat 3: HoldBabyHold (2.00 in chips)
Seat 4: SarkastikBS (3.59 in chips)
Seat 5: GG18vivek (3.35 in chips) is sitting out
Seat 6: LarryBerry217 (1.30 in chips)
Seat 7: crispzilla (2.27 in chips)
kanococo: posts small blind 0.01
HoldBabyHold: posts big blind 0.02
*** HOLE CARDS ***
Dealt to kanococo [Jd 4c]
SarkastikBS: folds
LarryBerry217: folds
crispzilla: raises 0.04 to 0.06
Elblop: calls 0.06
kanococo: calls 0.05
HoldBabyHold: folds
*** FLOP *** [7d 2c Td]
kanococo: checks
crispzilla: checks
Elblop: checks
*** TURN *** [7d 2c Td] [7c]
kanococo: bets 0.09
crispzilla: folds
Elblop: raises 0.37 to 0.46
kanococo: folds
Uncalled bet (0.37) returned to Elblop
Elblop collected 0.37 from pot
Elblop: doesn't show hand
*** SUMMARY ***
Total pot 0.38 | Rake 0.01
Board [ 7d 2c Td 7c ]
Game ended: 2025/09/02 20:36:52 GMT
Seat 1: Elblop (button) collected (0.37)
Seat 2: kanococo (small blind) folded on the Turn
Seat 3: HoldBabyHold (big blind) folded before Flop
Seat 4: SarkastikBS folded before Flop (didn't bet)
Seat 5: GG18vivek folded before Flop (didn't bet)
Seat 6: LarryBerry217 folded before Flop (didn't bet)
Seat 7: crispzilla folded on the Turn

CoinPoker Hand #291230527: Hold'em No Limit (0.01/0.02 ) 2025/09/02 20:36:54 GMT
Table 'NL ₮2 III' 7-max Seat #2 is the button
Seat 1: Elblop (2.17 in chips)
Seat 2: kanococo (0.59 in chips)
Seat 3: HoldBabyHold (2.00 in chips)
Seat 4: SarkastikBS (3.59 in chips)
Seat 5: GG18vivek (3.35 in chips) is sitting out
Seat 6: LarryBerry217 (1.30 in chips)
Seat 7: crispzilla (2.21 in chips)
HoldBabyHold: posts small blind 0.01
SarkastikBS: posts big blind 0.02
*** HOLE CARDS ***
Dealt to kanococo [Jh 4s]
LarryBerry217: folds
crispzilla: folds
Elblop: folds
kanococo: folds
HoldBabyHold: folds
SarkastikBS collected 0.03 from pot
SarkastikBS: doesn't show hand
*** SUMMARY ***
Total pot 0.03 | Rake 0.00
Board [ ]
Game ended: 2025/09/02 20:37:14 GMT
Seat 1: Elblop folded before Flop (didn't bet)
Seat 2: kanococo (button) folded before Flop (didn't bet)
Seat 3: HoldBabyHold (small blind) folded before Flop
Seat 4: SarkastikBS (big blind) collected (0.03)
Seat 5: GG18vivek folded before Flop (didn't bet)
Seat 6: LarryBerry217 folded before Flop (didn't bet)
Seat 7: crispzilla folded before Flop (didn't bet)

CoinPoker Hand #291230685: Hold'em No Limit (0.01/0.02 ) 2025/09/02 20:37:16 GMT
Table 'NL ₮2 III' 7-max Seat #3 is the button
Seat 1: Elblop (2.17 in chips)
Seat 2: kanococo (0.59 in chips)
Seat 3: HoldBabyHold (2.00 in chips)
Seat 4: SarkastikBS (3.60 in chips)
Seat 5: GG18vivek (3.35 in chips) is sitting out
Seat 6: LarryBerry217 (1.30 in chips)
Seat 7: crispzilla (2.21 in chips)
SarkastikBS: posts small blind 0.01
LarryBerry217: posts big blind 0.02
*** HOLE CARDS ***
Dealt to kanococo [2c 9s]
crispzilla: folds
Elblop: folds
kanococo: folds
HoldBabyHold: folds
SarkastikBS: folds
LarryBerry217 collected 0.03 from pot
LarryBerry217: doesn't show hand
*** SUMMARY ***
Total pot 0.03 | Rake 0.00
Board [ ]
Game ended: 2025/09/02 20:37:38 GMT
Seat 1: Elblop folded before Flop (didn't bet)
Seat 2: kanococo folded before Flop (didn't bet)
Seat 3: HoldBabyHold (button) folded before Flop (didn't bet)
Seat 4: SarkastikBS (small blind) folded before Flop
Seat 5: GG18vivek folded before Flop (didn't bet)
Seat 6: LarryBerry217 (big blind) collected (0.03)
Seat 7: crispzilla folded before Flop (didn't bet)

CoinPoker Hand #291230864: Hold'em No Limit (0.01/0.02 ) 2025/09/02 20:37:40 GMT
Table 'NL ₮2 III' 7-max Seat #4 is the button
Seat 1: Elblop (2.17 in chips)
Seat 2: kanococo (0.59 in chips)
Seat 3: HoldBabyHold (2.00 in chips)
Seat 4: SarkastikBS (3.59 in chips)
Seat 5: GG18vivek (3.35 in chips) is sitting out
Seat 6: LarryBerry217 (1.31 in chips)
Seat 7: crispzilla (2.21 in chips)
LarryBerry217: posts small blind 0.01
crispzilla: posts big blind 0.02
*** HOLE CARDS ***
Dealt to kanococo [6d 3s]
Elblop: folds
kanococo: folds
HoldBabyHold: folds
SarkastikBS: folds
LarryBerry217: calls 0.01
crispzilla: checks
*** FLOP *** [Qs Jh Ks]
LarryBerry217: checks
crispzilla: bets 0.04
LarryBerry217: folds
Uncalled bet (0.04) returned to crispzilla
crispzilla collected 0.04 from pot
crispzilla: doesn't show hand
*** SUMMARY ***
Total pot 0.04 | Rake 0.00
Board [ Qs Jh Ks ]
Game ended: 2025/09/02 20:38:18 GMT
Seat 1: Elblop folded before Flop (didn't bet)
Seat 2: kanococo folded before Flop (didn't bet)
Seat 3: HoldBabyHold folded before Flop (didn't bet)
Seat 4: SarkastikBS (button) folded before Flop (didn't bet)
Seat 5: GG18vivek folded before Flop (didn't bet)
Seat 6: LarryBerry217 (small blind) folded on the Flop
Seat 7: crispzilla (big blind) collected (0.04)

CoinPoker Hand #291231203: Hold'em No Limit (0.01/0.02 ) 2025/09/02 20:38:20 GMT
Table 'NL ₮2 III' 7-max Seat #6 is the button
Seat 1: Elblop (2.17 in chips)
Seat 2: kanococo (0.59 in chips)
Seat 3: HoldBabyHold (2.00 in chips)
Seat 4: SarkastikBS (3.59 in chips)
Seat 5: GG18vivek (3.35 in chips) is sitting out
Seat 6: LarryBerry217 (1.29 in chips)
Seat 7: crispzilla (2.23 in chips)
crispzilla: posts small blind 0.01
Elblop: posts big blind 0.02
*** HOLE CARDS ***
Dealt to kanococo [2s Th]
kanococo: folds
HoldBabyHold: folds
SarkastikBS: folds
LarryBerry217: folds
crispzilla: raises 0.04 to 0.06
Elblop: raises 2.15 and is all-in
crispzilla has timed out
crispzilla activated time-bank (36 seconds)
crispzilla: folds
Elblop collected 2.23 from pot
Elblop: doesn't show hand
*** SUMMARY ***
Total pot 2.23 | Rake 0.00
Board [ ]
Game ended: 2025/09/02 20:39:04 GMT
Seat 1: Elblop (big blind) collected (2.23)
Seat 2: kanococo folded before Flop (didn't bet)
Seat 3: HoldBabyHold folded before Flop (didn't bet)
Seat 4: SarkastikBS folded before Flop (didn't bet)
Seat 5: GG18vivek folded before Flop (didn't bet)
Seat 6: LarryBerry217 (button) folded before Flop (didn't bet)
Seat 7: crispzilla (small blind) folded before Flop

CoinPoker Hand #291231630: Hold'em No Limit (0.01/0.02 ) 2025/09/02 20:39:06 GMT
Table 'NL ₮2 III' 7-max Seat #7 is the button
Seat 1: Elblop (2.23 in chips)
Seat 2: kanococo (0.59 in chips)
Seat 3: HoldBabyHold (2.00 in chips)
Seat 4: SarkastikBS (3.59 in chips)
Seat 5: GG18vivek (3.35 in chips) is sitting out
Seat 6: LarryBerry217 (1.29 in chips)
Seat 7: crispzilla (2.17 in chips)
Elblop: posts small blind 0.01
kanococo: posts big blind 0.02
*** HOLE CARDS ***
Dealt to kanococo [Ks 5d]
HoldBabyHold: folds
Elblop said, "take that!"
SarkastikBS: folds
LarryBerry217: folds
crispzilla: folds
Elblop: folds
kanococo collected 0.03 from pot
kanococo: doesn't show hand
*** SUMMARY ***
Total pot 0.03 | Rake 0.00
Board [ ]
Game ended: 2025/09/02 20:39:23 GMT
Seat 1: Elblop (small blind) folded before Flop
Seat 2: kanococo (big blind) collected (0.03)
Seat 3: HoldBabyHold folded before Flop (didn't bet)
Seat 4: SarkastikBS folded before Flop (didn't bet)
Seat 5: GG18vivek folded before Flop (didn't bet)
Seat 6: LarryBerry217 folded before Flop (didn't bet)
Seat 7: crispzilla (button) folded before Flop (didn't bet)

CoinPoker Hand #291231768: Hold'em No Limit (0.01/0.02 ) 2025/09/02 20:39:25 GMT
Table 'NL ₮2 III' 7-max Seat #1 is the button
Seat 1: Elblop (2.22 in chips)
Seat 2: kanococo (0.60 in chips)
Seat 3: HoldBabyHold (2.00 in chips)
Seat 4: SarkastikBS (3.59 in chips)
Seat 5: GG18vivek (3.35 in chips) is sitting out
Seat 6: LarryBerry217 (1.29 in chips)
Seat 7: crispzilla (2.17 in chips)
kanococo: posts small blind 0.01
HoldBabyHold: posts big blind 0.02
*** HOLE CARDS ***
Dealt to kanococo [5h 6s]
SarkastikBS: folds
LarryBerry217: calls 0.02
crispzilla: folds
Elblop: calls 0.02
kanococo: folds
HoldBabyHold: checks
*** FLOP *** [5d 7d Qd]
HoldBabyHold: checks
LarryBerry217: bets 0.03
Elblop: folds
HoldBabyHold: folds
Uncalled bet (0.03) returned to LarryBerry217
LarryBerry217 collected 0.07 from pot
LarryBerry217: doesn't show hand
*** SUMMARY ***
Total pot 0.07 | Rake 0.00
Board [ 5d 7d Qd ]
Game ended: 2025/09/02 20:40:05 GMT
Seat 1: Elblop (button) folded on the Flop
Seat 2: kanococo (small blind) folded before Flop
Seat 3: HoldBabyHold (big blind) folded on the Flop
Seat 4: SarkastikBS folded before Flop (didn't bet)
Seat 5: GG18vivek folded before Flop (didn't bet)
Seat 6: LarryBerry217 collected (0.07)
Seat 7: crispzilla folded before Flop (didn't bet)

CoinPoker Hand #291232171: Hold'em No Limit (0.01/0.02 ) 2025/09/02 20:40:08 GMT
Table 'NL ₮2 III' 7-max Seat #2 is the button
Seat 1: Elblop (2.20 in chips)
Seat 2: kanococo (0.59 in chips)
Seat 3: HoldBabyHold (2.00 in chips)
Seat 4: SarkastikBS (3.59 in chips)
Seat 5: GG18vivek (3.35 in chips) is sitting out
Seat 6: LarryBerry217 (1.34 in chips)
Seat 7: crispzilla (2.17 in chips)
HoldBabyHold: posts small blind 0.01
SarkastikBS: posts big blind 0.02
*** HOLE CARDS ***
Dealt to kanococo [7s 7c]
LarryBerry217: folds
crispzilla: raises 0.04 to 0.06
Elblop: folds
kanococo: calls 0.06
HoldBabyHold: folds
SarkastikBS: folds
*** FLOP *** [6s 9h Jh]
crispzilla: checks
kanococo: bets 0.07
crispzilla: folds
Uncalled bet (0.07) returned to kanococo
kanococo collected 0.14 from pot
kanococo: doesn't show hand
*** SUMMARY ***
Total pot 0.15 | Rake 0.01
Board [ 6s 9h Jh ]
Game ended: 2025/09/02 20:40:55 GMT
Seat 1: Elblop folded before Flop (didn't bet)
Seat 2: kanococo (button) collected (0.14)
Seat 3: HoldBabyHold (small blind) folded before Flop
Seat 4: SarkastikBS (big blind) folded before Flop
Seat 5: GG18vivek folded before Flop (didn't bet)
Seat 6: LarryBerry217 folded before Flop (didn't bet)
Seat 7: crispzilla folded on the Flop

CoinPoker Hand #291232544: Hold'em No Limit (0.01/0.02 ) 2025/09/02 20:40:57 GMT
Table 'NL ₮2 III' 7-max Seat #3 is the button
Seat 1: Elblop (2.20 in chips)
Seat 2: kanococo (0.67 in chips)
Seat 3: HoldBabyHold (1.99 in chips)
Seat 4: SarkastikBS (3.57 in chips)
Seat 5: GG18vivek (3.35 in chips) is sitting out
Seat 6: LarryBerry217 (1.34 in chips)
Seat 7: crispzilla (2.11 in chips)
SarkastikBS: posts small blind 0.01
LarryBerry217: posts big blind 0.02
*** HOLE CARDS ***
Dealt to kanococo [Qs Kh]
crispzilla: folds
Elblop: folds
kanococo: raises 0.02 to 0.04
HoldBabyHold: folds
SarkastikBS: calls 0.03
LarryBerry217: calls 0.02
*** FLOP *** [2s 7c 3s]
SarkastikBS: checks
LarryBerry217: bets 0.04
kanococo: calls 0.04
SarkastikBS: folds
*** TURN *** [2s 7c 3s] [Jh]
LarryBerry217: checks
kanococo: bets 0.09
LarryBerry217: calls 0.09
*** RIVER *** [2s 7c 3s Jh] [4h]
LarryBerry217: checks
kanococo: checks
*** SHOW DOWN ***
LarryBerry217: shows [4s 9s] (a pair of Fours)
kanococo: mucks hand
LarryBerry217 collected 0.36 from pot
*** SUMMARY ***
Total pot 0.38 | Rake 0.02
Board [ 2s 7c 3s Jh 4h ]
Game ended: 2025/09/02 20:41:45 GMT
Seat 1: Elblop folded before Flop (didn't bet)
Seat 2: kanococo mucked
Seat 3: HoldBabyHold (button) folded before Flop (didn't bet)
Seat 4: SarkastikBS (small blind) folded on the Flop
Seat 5: GG18vivek folded before Flop (didn't bet)
Seat 6: LarryBerry217 (big blind) showed [4s 9s] and won (0.36) with a pair of Fours
Seat 7: crispzilla folded before Flop (didn't bet)

CoinPoker Hand #291232921: Hold'em No Limit (0.01/0.02 ) 2025/09/02 20:41:47 GMT
Table 'NL ₮2 III' 7-max Seat #4 is the button
Seat 1: Elblop (2.20 in chips)
Seat 2: kanococo (0.50 in chips)
Seat 3: HoldBabyHold (2.00 in chips)
Seat 4: SarkastikBS (3.53 in chips)
Seat 5: GG18vivek (3.35 in chips) is sitting out
Seat 6: LarryBerry217 (1.53 in chips)
Seat 7: crispzilla (2.11 in chips)
LarryBerry217: posts small blind 0.01
crispzilla: posts big blind 0.02
*** HOLE CARDS ***
Dealt to kanococo [7c Ac]
Elblop: folds
kanococo: folds
HoldBabyHold: folds
SarkastikBS: folds
LarryBerry217: raises 0.02 to 0.04
crispzilla: calls 0.02
*** FLOP *** [Kc 9h 7h]
LarryBerry217: bets 0.02
crispzilla: raises 0.06 to 0.08
LarryBerry217: folds
Uncalled bet (0.06) returned to crispzilla
crispzilla collected 0.12 from pot
crispzilla: doesn't show hand
GG18vivek has reconnected
*** SUMMARY ***
Total pot 0.12 | Rake 0.00
Board [ Kc 9h 7h ]
Game ended: 2025/09/02 20:42:26 GMT
Seat 1: Elblop folded before Flop (didn't bet)
Seat 2: kanococo folded before Flop (didn't bet)
Seat 3: HoldBabyHold folded before Flop (didn't bet)
Seat 4: SarkastikBS (button) folded before Flop (didn't bet)
Seat 5: GG18vivek folded before Flop (didn't bet)
Seat 6: LarryBerry217 (small blind) folded on the Flop
Seat 7: crispzilla (big blind) collected (0.12)

CoinPoker Hand #291233362: Hold'em No Limit (0.01/0.02 ) 2025/09/02 20:42:28 GMT
Table 'NL ₮2 III' 7-max Seat #6 is the button
Seat 1: Elblop (2.20 in chips)
Seat 2: kanococo (0.50 in chips)
Seat 3: HoldBabyHold (2.00 in chips)
Seat 4: SarkastikBS (3.53 in chips)
Seat 5: GG18vivek (3.35 in chips)
Seat 6: LarryBerry217 (1.47 in chips)
Seat 7: crispzilla (2.17 in chips)
crispzilla: posts small blind 0.01
Elblop: posts big blind 0.02
GG18vivek: posts big blind 0.02
*** HOLE CARDS ***
Dealt to kanococo [7d Td]
kanococo: folds
HoldBabyHold: folds
SarkastikBS: folds
GG18vivek: checks
LarryBerry217: folds
crispzilla: calls 0.01
Elblop: checks
*** FLOP *** [5d Jd Qh]
crispzilla: checks
Elblop: checks
GG18vivek: checks
*** TURN *** [5d Jd Qh] [7s]
crispzilla has timed out
crispzilla activated time-bank (23 seconds)
crispzilla: checks
Elblop: checks
GG18vivek: checks
*** RIVER *** [5d Jd Qh 7s] [2c]
crispzilla: checks
Elblop: checks
GG18vivek: checks
*** SHOW DOWN ***
crispzilla: shows [Tc 6c] (Queen high)
Elblop: shows [Kc 9c] (King high)
GG18vivek: mucks hand
Elblop collected 0.06 from pot
*** SUMMARY ***
Total pot 0.06 | Rake 0.00
Board [ 5d Jd Qh 7s 2c ]
Game ended: 2025/09/02 20:43:57 GMT
Seat 1: Elblop (big blind) showed [Kc 9c] and won (0.06) with King high
Seat 2: kanococo folded before Flop (didn't bet)
Seat 3: HoldBabyHold folded before Flop (didn't bet)
Seat 4: SarkastikBS folded before Flop (didn't bet)
Seat 5: GG18vivek mucked
Seat 6: LarryBerry217 (button) folded before Flop (didn't bet)
Seat 7: crispzilla (small blind) showed [Tc 6c]

CoinPoker Hand #291233992: Hold'em No Limit (0.01/0.02 ) 2025/09/02 20:43:59 GMT
Table 'NL ₮2 III' 7-max Seat #7 is the button
Seat 1: Elblop (2.24 in chips)
Seat 2: kanococo (0.50 in chips)
Seat 3: HoldBabyHold (2.00 in chips)
Seat 4: SarkastikBS (3.53 in chips)
Seat 5: GG18vivek (3.33 in chips) is sitting out
Seat 6: LarryBerry217 (1.47 in chips)
Seat 7: crispzilla (2.15 in chips)
Elblop: posts small blind 0.01
kanococo: posts big blind 0.02
*** HOLE CARDS ***
Dealt to kanococo [Kh 6h]
HoldBabyHold: folds
SarkastikBS: folds
LarryBerry217: raises 0.04 to 0.06
crispzilla: folds
Elblop: calls 0.05
kanococo: raises 0.48 and is all-in
LarryBerry217: calls 0.44
Elblop: folds
*** FLOP *** [8h 3h 9h]
*** TURN *** [8h 3h 9h] [Tc]
*** RIVER *** [8h 3h 9h Tc] [5c]
*** SHOW DOWN ***
kanococo: shows [Kh 6h] (a flush, King high)
LarryBerry217: shows [Ks Kc] (a pair of Kings)
kanococo collected 1.01 from pot
*** SUMMARY ***
Total pot 1.06 | Rake 0.05
Board [ 8h 3h 9h Tc 5c ]
Game ended: 2025/09/02 20:44:40 GMT
Seat 1: Elblop (small blind) folded before Flop
Seat 2: kanococo (big blind) showed [Kh 6h] and won (1.01) with a flush, King high
Seat 3: HoldBabyHold folded before Flop (didn't bet)
Seat 4: SarkastikBS folded before Flop (didn't bet)
Seat 5: GG18vivek folded before Flop (didn't bet)
Seat 6: LarryBerry217 showed [Ks Kc]
Seat 7: crispzilla (button) folded before Flop (didn't bet)

CoinPoker Hand #291234259: Hold'em No Limit (0.01/0.02 ) 2025/09/02 20:44:42 GMT
Table 'NL ₮2 III' 7-max Seat #1 is the button
Seat 1: Elblop (2.18 in chips)
Seat 2: kanococo (1.01 in chips)
Seat 3: HoldBabyHold (2.00 in chips)
Seat 4: SarkastikBS (3.53 in chips)
Seat 5: otaldojamal (2.00 in chips)
Seat 6: LarryBerry217 (0.97 in chips)
Seat 7: crispzilla (2.15 in chips)
kanococo: posts small blind 0.01
HoldBabyHold: posts big blind 0.02
otaldojamal: posts big blind 0.02
*** HOLE CARDS ***
Dealt to kanococo [7d 7h]
SarkastikBS: folds
Elblop said, "course"
kanococo said, "hahaha sorry"
otaldojamal: raises 0.04 to 0.06
LarryBerry217: calls 0.06
crispzilla: folds
Elblop said, "lol its poker"
Elblop: calls 0.06
kanococo: calls 0.05
HoldBabyHold: folds
*** FLOP *** [Jh 6h Kh]
kanococo: bets 0.12
otaldojamal: calls 0.12
LarryBerry217: folds
Elblop: folds
*** TURN *** [Jh 6h Kh] [Ah]
kanococo: bets 0.83 and is all-in
otaldojamal: folds
Uncalled bet (0.83) returned to kanococo
kanococo collected 0.47 from pot
kanococo: doesn't show hand
*** SUMMARY ***
Total pot 0.50 | Rake 0.03
Board [ Jh 6h Kh Ah ]
Game ended: 2025/09/02 20:45:45 GMT
Seat 1: Elblop (button) folded on the Flop
Seat 2: kanococo (small blind) collected (0.47)
Seat 3: HoldBabyHold (big blind) folded before Flop
Seat 4: SarkastikBS folded before Flop (didn't bet)
Seat 5: otaldojamal folded on the Turn
Seat 6: LarryBerry217 folded on the Flop
Seat 7: crispzilla folded before Flop (didn't bet)

CoinPoker Hand #291234845: Hold'em No Limit (0.01/0.02 ) 2025/09/02 20:45:47 GMT
Table 'NL ₮2 III' 7-max Seat #2 is the button
Seat 1: Elblop (2.12 in chips)
Seat 2: kanococo (1.30 in chips)
Seat 3: HoldBabyHold (2.00 in chips)
Seat 4: SarkastikBS (3.53 in chips)
Seat 5: otaldojamal (2.00 in chips)
Seat 6: LarryBerry217 (0.91 in chips)
Seat 7: crispzilla (2.15 in chips)
HoldBabyHold: posts small blind 0.01
SarkastikBS: posts big blind 0.02
*** HOLE CARDS ***
Dealt to kanococo [2s 9c]
otaldojamal: folds
LarryBerry217: folds
crispzilla: raises 0.04 to 0.06
Elblop: folds
kanococo: folds
HoldBabyHold: folds
SarkastikBS: folds
crispzilla collected 0.09 from pot
crispzilla: doesn't show hand
*** SUMMARY ***
Total pot 0.09 | Rake 0.00
Board [ ]
Game ended: 2025/09/02 20:46:06 GMT
Seat 1: Elblop folded before Flop (didn't bet)
Seat 2: kanococo (button) folded before Flop (didn't bet)
Seat 3: HoldBabyHold (small blind) folded before Flop
Seat 4: SarkastikBS (big blind) folded before Flop
Seat 5: otaldojamal folded before Flop (didn't bet)
Seat 6: LarryBerry217 folded before Flop (didn't bet)
Seat 7: crispzilla collected (0.09)

CoinPoker Hand #291234987: Hold'em No Limit (0.01/0.02 ) 2025/09/02 20:46:08 GMT
Table 'NL ₮2 III' 7-max Seat #3 is the button
Seat 1: Elblop (2.12 in chips)
Seat 2: kanococo (1.30 in chips)
Seat 3: HoldBabyHold (2.00 in chips)
Seat 4: SarkastikBS (3.51 in chips)
Seat 5: otaldojamal (2.00 in chips)
Seat 6: LarryBerry217 (0.91 in chips)
Seat 7: crispzilla (2.18 in chips)
SarkastikBS: posts small blind 0.01
otaldojamal: posts big blind 0.02
*** HOLE CARDS ***
Dealt to kanococo [4h Td]
LarryBerry217: folds
crispzilla: folds
Elblop: raises 0.02 to 0.04
kanococo: folds
HoldBabyHold: raises 0.10 to 0.14
SarkastikBS: folds
otaldojamal: folds
Elblop: calls 0.10
*** FLOP *** [5s 3h 2d]
Elblop: checks
HoldBabyHold: checks
*** TURN *** [5s 3h 2d] [3s]
Elblop: bets 0.14
HoldBabyHold: calls 0.14
*** RIVER *** [5s 3h 2d 3s] [6d]
Elblop: checks
HoldBabyHold: checks
*** SHOW DOWN ***
Elblop: shows [Kc Jc] (a pair of Threes)
HoldBabyHold: shows [Kd Ad] (a pair of Threes)
HoldBabyHold collected 0.56 from pot
*** SUMMARY ***
Total pot 0.59 | Rake 0.03
Board [ 5s 3h 2d 3s 6d ]
Game ended: 2025/09/02 20:47:15 GMT
Seat 1: Elblop showed [Kc Jc]
Seat 2: kanococo folded before Flop (didn't bet)
Seat 3: HoldBabyHold (button) showed [Kd Ad] and won (0.56) with a pair of Threes
Seat 4: SarkastikBS (small blind) folded before Flop
Seat 5: otaldojamal (big blind) folded before Flop
Seat 6: LarryBerry217 folded before Flop (didn't bet)
Seat 7: crispzilla folded before Flop (didn't bet)

CoinPoker Hand #291235574: Hold'em No Limit (0.01/0.02 ) 2025/09/02 20:47:17 GMT
Table 'NL ₮2 III' 7-max Seat #4 is the button
Seat 1: Elblop (2.00 in chips)
Seat 2: kanococo (1.30 in chips)
Seat 3: HoldBabyHold (2.28 in chips)
Seat 4: SarkastikBS (3.50 in chips)
Seat 5: otaldojamal (1.98 in chips)
Seat 6: LarryBerry217 (0.91 in chips)
Seat 7: crispzilla (2.18 in chips)
otaldojamal: posts small blind 0.01
LarryBerry217: posts big blind 0.02
*** HOLE CARDS ***
Dealt to kanococo [Qc 8h]
crispzilla: folds
Elblop: folds
kanococo: folds
HoldBabyHold: folds
SarkastikBS: folds
otaldojamal: raises 0.04 to 0.06
LarryBerry217: folds
otaldojamal collected 0.08 from pot
otaldojamal: doesn't show hand
*** SUMMARY ***
Total pot 0.08 | Rake 0.00
Board [ ]
Game ended: 2025/09/02 20:47:51 GMT
Seat 1: Elblop folded before Flop (didn't bet)
Seat 2: kanococo folded before Flop (didn't bet)
Seat 3: HoldBabyHold folded before Flop (didn't bet)
Seat 4: SarkastikBS (button) folded before Flop (didn't bet)
Seat 5: otaldojamal (small blind) collected (0.08)
Seat 6: LarryBerry217 (big blind) folded before Flop
Seat 7: crispzilla folded before Flop (didn't bet)

CoinPoker Hand #291235841: Hold'em No Limit (0.01/0.02 ) 2025/09/02 20:47:53 GMT
Table 'NL ₮2 III' 7-max Seat #5 is the button
Seat 1: Elblop (2.00 in chips)
Seat 2: kanococo (1.30 in chips)
Seat 3: HoldBabyHold (2.28 in chips)
Seat 4: SarkastikBS (3.50 in chips)
Seat 5: otaldojamal (2.00 in chips)
Seat 6: LarryBerry217 (0.89 in chips)
Seat 7: crispzilla (2.18 in chips)
LarryBerry217: posts small blind 0.01
crispzilla: posts big blind 0.02
*** HOLE CARDS ***
Dealt to kanococo [9d 4d]
Elblop: folds
kanococo: folds
HoldBabyHold: folds
SarkastikBS: folds
otaldojamal: folds
LarryBerry217: folds
crispzilla collected 0.03 from pot
crispzilla: doesn't show hand
*** SUMMARY ***
Total pot 0.03 | Rake 0.00
Board [ ]
Game ended: 2025/09/02 20:48:14 GMT
Seat 1: Elblop folded before Flop (didn't bet)
Seat 2: kanococo folded before Flop (didn't bet)
Seat 3: HoldBabyHold folded before Flop (didn't bet)
Seat 4: SarkastikBS folded before Flop (didn't bet)
Seat 5: otaldojamal (button) folded before Flop (didn't bet)
Seat 6: LarryBerry217 (small blind) folded before Flop
Seat 7: crispzilla (big blind) collected (0.03)

CoinPoker Hand #291236049: Hold'em No Limit (0.01/0.02 ) 2025/09/02 20:48:16 GMT
Table 'NL ₮2 III' 7-max Seat #6 is the button
Seat 1: Elblop (2.00 in chips)
Seat 2: kanococo (1.30 in chips)
Seat 3: HoldBabyHold (2.28 in chips)
Seat 4: SarkastikBS (3.50 in chips)
Seat 5: otaldojamal (2.00 in chips)
Seat 6: LarryBerry217 (0.88 in chips)
Seat 7: crispzilla (2.19 in chips)
crispzilla: posts small blind 0.01
Elblop: posts big blind 0.02
*** HOLE CARDS ***
Dealt to kanococo [Th 9h]
kanococo: folds
HoldBabyHold: folds
SarkastikBS: folds
otaldojamal: raises 0.03 to 0.05
LarryBerry217: raises 0.10 to 0.15
crispzilla: folds
Elblop: folds
otaldojamal: folds
LarryBerry217 collected 0.23 from pot
LarryBerry217: doesn't show hand
*** SUMMARY ***
Total pot 0.23 | Rake 0.00
Board [ ]
Game ended: 2025/09/02 20:49:01 GMT
Seat 1: Elblop (big blind) folded before Flop
Seat 2: kanococo folded before Flop (didn't bet)
Seat 3: HoldBabyHold folded before Flop (didn't bet)
Seat 4: SarkastikBS folded before Flop (didn't bet)
Seat 5: otaldojamal folded before Flop
Seat 6: LarryBerry217 (button) collected (0.23)
Seat 7: crispzilla (small blind) folded before Flop

CoinPoker Hand #291236324: Hold'em No Limit (0.01/0.02 ) 2025/09/02 20:49:03 GMT
Table 'NL ₮2 III' 7-max Seat #7 is the button
Seat 1: Elblop (2.00 in chips)
Seat 2: kanococo (1.30 in chips)
Seat 3: HoldBabyHold (2.28 in chips)
Seat 4: SarkastikBS (3.50 in chips)
Seat 5: otaldojamal (2.00 in chips)
Seat 6: LarryBerry217 (0.96 in chips)
Seat 7: crispzilla (2.18 in chips)
Elblop: posts small blind 0.01
kanococo: posts big blind 0.02
*** HOLE CARDS ***
Dealt to kanococo [9c Th]
HoldBabyHold: folds
SarkastikBS: folds
otaldojamal: raises 0.03 to 0.05
LarryBerry217: folds
crispzilla: calls 0.05
Elblop: folds
kanococo: calls 0.03
*** FLOP *** [5c Ac Kd]
kanococo: bets 0.04
otaldojamal: raises 0.11 to 0.15
crispzilla: folds
kanococo: folds
Uncalled bet (0.11) returned to otaldojamal
otaldojamal collected 0.23 from pot
otaldojamal: doesn't show hand
*** SUMMARY ***
Total pot 0.24 | Rake 0.01
Board [ 5c Ac Kd ]
Game ended: 2025/09/02 20:50:05 GMT
Seat 1: Elblop (small blind) folded before Flop
Seat 2: kanococo (big blind) folded on the Flop
Seat 3: HoldBabyHold folded before Flop (didn't bet)
Seat 4: SarkastikBS folded before Flop (didn't bet)
Seat 5: otaldojamal collected (0.23)
Seat 6: LarryBerry217 folded before Flop (didn't bet)
Seat 7: crispzilla (button) folded on the Flop

CoinPoker Hand #291236774: Hold'em No Limit (0.01/0.02 ) 2025/09/02 20:50:07 GMT
Table 'NL ₮2 III' 7-max Seat #1 is the button
Seat 1: Elblop (1.99 in chips)
Seat 2: kanococo (1.21 in chips)
Seat 3: HoldBabyHold (2.28 in chips)
Seat 4: SarkastikBS (3.50 in chips)
Seat 5: otaldojamal (2.14 in chips)
Seat 6: LarryBerry217 (0.96 in chips)
Seat 7: crispzilla (2.13 in chips)
kanococo: posts small blind 0.01
HoldBabyHold: posts big blind 0.02
*** HOLE CARDS ***
Dealt to kanococo [Kh Th]
SarkastikBS: raises 0.02 to 0.04
otaldojamal: folds
LarryBerry217: folds
crispzilla: folds
Elblop: folds
kanococo: raises 0.06 to 0.10
HoldBabyHold: folds
SarkastikBS: calls 0.06
*** FLOP *** [8d Qs 5h]
kanococo: checks
SarkastikBS: checks
*** TURN *** [8d Qs 5h] [5c]
kanococo: bets 0.04
SarkastikBS: calls 0.04
*** RIVER *** [8d Qs 5h 5c] [3c]
kanococo: bets 0.14
SarkastikBS: folds
Uncalled bet (0.14) returned to kanococo
kanococo collected 0.28 from pot
kanococo: doesn't show hand
*** SUMMARY ***
Total pot 0.30 | Rake 0.02
Board [ 8d Qs 5h 5c 3c ]
Game ended: 2025/09/02 20:51:05 GMT
Seat 1: Elblop (button) folded before Flop (didn't bet)
Seat 2: kanococo (small blind) collected (0.28)
Seat 3: HoldBabyHold (big blind) folded before Flop
Seat 4: SarkastikBS folded on the River
Seat 5: otaldojamal folded before Flop (didn't bet)
Seat 6: LarryBerry217 folded before Flop (didn't bet)
Seat 7: crispzilla folded before Flop (didn't bet)

CoinPoker Hand #291237052: Hold'em No Limit (0.01/0.02 ) 2025/09/02 20:51:07 GMT
Table 'NL ₮2 III' 7-max Seat #2 is the button
Seat 1: Elblop (2.00 in chips)
Seat 2: kanococo (1.35 in chips)
Seat 3: HoldBabyHold (2.26 in chips)
Seat 4: SarkastikBS (3.36 in chips)
Seat 5: otaldojamal (2.14 in chips)
Seat 6: LarryBerry217 (0.96 in chips)
Seat 7: crispzilla (2.13 in chips)
HoldBabyHold: posts small blind 0.01
SarkastikBS: posts big blind 0.02
*** HOLE CARDS ***
Dealt to kanococo [5h 3h]
otaldojamal: folds
LarryBerry217: raises 0.04 to 0.06
crispzilla: folds
Elblop: folds
kanococo: folds
HoldBabyHold: folds
SarkastikBS: folds
LarryBerry217 collected 0.09 from pot
LarryBerry217: doesn't show hand
*** SUMMARY ***
Total pot 0.09 | Rake 0.00
Board [ ]
Game ended: 2025/09/02 20:51:36 GMT
Seat 1: Elblop folded before Flop (didn't bet)
Seat 2: kanococo (button) folded before Flop (didn't bet)
Seat 3: HoldBabyHold (small blind) folded before Flop
Seat 4: SarkastikBS (big blind) folded before Flop
Seat 5: otaldojamal folded before Flop (didn't bet)
Seat 6: LarryBerry217 collected (0.09)
Seat 7: crispzilla folded before Flop (didn't bet)

CoinPoker Hand #291237366: Hold'em No Limit (0.01/0.02 ) 2025/09/02 20:51:38 GMT
Table 'NL ₮2 III' 7-max Seat #3 is the button
Seat 1: Elblop (2.00 in chips)
Seat 2: kanococo (1.35 in chips)
Seat 3: HoldBabyHold (2.25 in chips)
Seat 4: SarkastikBS (3.34 in chips)
Seat 5: otaldojamal (2.14 in chips)
Seat 6: LarryBerry217 (0.99 in chips)
Seat 7: crispzilla (2.13 in chips)
SarkastikBS: posts small blind 0.01
otaldojamal: posts big blind 0.02
*** HOLE CARDS ***
Dealt to kanococo [5h As]
LarryBerry217: calls 0.02
crispzilla: folds
Elblop: folds
kanococo: raises 0.04 to 0.06
HoldBabyHold: folds
SarkastikBS: folds
otaldojamal: calls 0.04
LarryBerry217: calls 0.04
*** FLOP *** [Ad 7h Kd]
otaldojamal: checks
LarryBerry217: bets 0.93 and is all-in
kanococo: raises 1.29 and is all-in
otaldojamal: folds
Uncalled bet (0.36) returned to kanococo
*** TURN *** [Ad 7h Kd] [Qh]
*** RIVER *** [Ad 7h Kd Qh] [2h]
*** SHOW DOWN ***
kanococo: shows [5h As] (a pair of Aces)
LarryBerry217: shows [Ah 6h] (a flush, Ace high)
LarryBerry217 collected 1.95 from pot
*** SUMMARY ***
Total pot 2.05 | Rake 0.10
Board [ Ad 7h Kd Qh 2h ]
Game ended: 2025/09/02 20:52:53 GMT
Seat 1: Elblop folded before Flop (didn't bet)
Seat 2: kanococo showed [5h As]
Seat 3: HoldBabyHold (button) folded before Flop (didn't bet)
Seat 4: SarkastikBS (small blind) folded before Flop
Seat 5: otaldojamal (big blind) folded on the Flop
Seat 6: LarryBerry217 showed [Ah 6h] and won (1.95) with a flush, Ace high
Seat 7: crispzilla folded before Flop (didn't bet)

CoinPoker Hand #291237872: Hold'em No Limit (0.01/0.02 ) 2025/09/02 20:52:56 GMT
Table 'NL ₮2 III' 7-max Seat #4 is the button
Seat 1: Elblop (2.00 in chips)
Seat 2: kanococo (0.36 in chips)
Seat 3: HoldBabyHold (2.25 in chips)
Seat 4: SarkastikBS (3.33 in chips)
Seat 5: otaldojamal (2.08 in chips)
Seat 6: LarryBerry217 (1.95 in chips)
Seat 7: crispzilla (2.13 in chips)
otaldojamal: posts small blind 0.01
LarryBerry217: posts big blind 0.02
*** HOLE CARDS ***
Dealt to kanococo [4h Tc]
crispzilla: folds
Elblop: folds
kanococo: folds
HoldBabyHold: raises 0.03 to 0.05
SarkastikBS: folds
otaldojamal: folds
LarryBerry217: folds
HoldBabyHold collected 0.08 from pot
HoldBabyHold: doesn't show hand
*** SUMMARY ***
Total pot 0.08 | Rake 0.00
Board [ ]
Game ended: 2025/09/02 20:53:14 GMT
Seat 1: Elblop folded before Flop (didn't bet)
Seat 2: kanococo folded before Flop (didn't bet)
Seat 3: HoldBabyHold collected (0.08)
Seat 4: SarkastikBS (button) folded before Flop (didn't bet)
Seat 5: otaldojamal (small blind) folded before Flop
Seat 6: LarryBerry217 (big blind) folded before Flop
Seat 7: crispzilla folded before Flop (didn't bet)

CoinPoker Hand #291238016: Hold'em No Limit (0.01/0.02 ) 2025/09/02 20:53:17 GMT
Table 'NL ₮2 III' 7-max Seat #5 is the button
Seat 1: Elblop (2.00 in chips)
Seat 2: kanococo (0.36 in chips)
Seat 3: HoldBabyHold (2.28 in chips)
Seat 4: SarkastikBS (3.33 in chips)
Seat 5: otaldojamal (2.07 in chips)
Seat 6: LarryBerry217 (1.93 in chips)
Seat 7: crispzilla (2.13 in chips)
LarryBerry217: posts small blind 0.01
crispzilla: didn't post big blind
Elblop: posts big blind 0.02
*** HOLE CARDS ***
Dealt to kanococo [Kd Qh]
kanococo: raises 0.36 and is all-in
HoldBabyHold: folds
SarkastikBS: folds
otaldojamal: folds
LarryBerry217: folds
Elblop: folds
kanococo collected 0.39 from pot
kanococo: doesn't show hand
*** SUMMARY ***
Total pot 0.39 | Rake 0.00
Board [ ]
Game ended: 2025/09/02 20:53:42 GMT
Seat 1: Elblop (big blind) folded before Flop
Seat 2: kanococo collected (0.39)
Seat 3: HoldBabyHold folded before Flop (didn't bet)
Seat 4: SarkastikBS folded before Flop (didn't bet)
Seat 5: otaldojamal (button) folded before Flop (didn't bet)
Seat 6: LarryBerry217 (small blind) folded before Flop
Seat 7: crispzilla folded before Flop (didn't bet)

CoinPoker Hand #291238112: Hold'em No Limit (0.01/0.02 ) 2025/09/02 20:53:31 GMT
Table 'NL ₮2 I' 7-max Seat #1 is the button
Seat 1: Anonkontello (2.27 in chips)
Seat 2: Aceinthehole (2.98 in chips) out of hand
Seat 3: vicmitch (4.30 in chips)
Seat 4: MarditZion (1.95 in chips)
Seat 5: kanococo (2.00 in chips)
Seat 6: otaldojamal (2.00 in chips)
Seat 7: pash0420 (1.34 in chips)
vicmitch: posts small blind 0.01
MarditZion: posts big blind 0.02
kanococo: posts big blind 0.02
pash0420: posts big blind 0.02
*** HOLE CARDS ***
Dealt to kanococo [4d 7d]
kanococo: checks
otaldojamal: raises 0.09 to 0.11
pash0420: raises 0.11 to 0.22
Anonkontello: calls 0.22
vicmitch has timed out
vicmitch activated time-bank (26 seconds)
vicmitch: folds
MarditZion: folds
kanococo: folds
otaldojamal: calls 0.11
*** FLOP *** [6c 5s Qh]
otaldojamal: checks
pash0420: bets 0.23
Anonkontello: folds
otaldojamal: folds
Uncalled bet (0.23) returned to pash0420
pash0420 collected 0.67 from pot
pash0420: doesn't show hand
*** SUMMARY ***
Total pot 0.71 | Rake 0.04
Board [ 6c 5s Qh ]
Game ended: 2025/09/02 20:54:57 GMT
Seat 1: Anonkontello (button) folded on the Flop
Seat 2: Aceinthehole folded before Flop (didn't bet)
Seat 3: vicmitch (small blind) folded before Flop
Seat 4: MarditZion (big blind) folded before Flop
Seat 5: kanococo folded before Flop
Seat 6: otaldojamal folded on the Flop
Seat 7: pash0420 collected (0.67)

CoinPoker Hand #291238298: Hold'em No Limit (0.01/0.02 ) 2025/09/02 20:53:44 GMT
Table 'NL ₮2 III' 7-max Seat #6 is the button
Seat 1: Elblop (2.00 in chips)
Seat 2: kanococo (0.39 in chips)
Seat 3: HoldBabyHold (2.28 in chips)
Seat 4: SarkastikBS (3.33 in chips)
Seat 5: otaldojamal (2.07 in chips)
Seat 6: LarryBerry217 (1.92 in chips)
Seat 7: crispzilla (2.13 in chips) is sitting out
Elblop: posts small blind 0.01
kanococo: posts big blind 0.02
*** HOLE CARDS ***
Dealt to kanococo [Qc Tc]
HoldBabyHold: folds
SarkastikBS has timed out
SarkastikBS activated time-bank (50 seconds)
SarkastikBS: folds
otaldojamal: folds
LarryBerry217: calls 0.02
Elblop: calls 0.01
kanococo: raises 0.08 to 0.10
LarryBerry217: calls 0.08
Elblop: folds
*** FLOP *** [3c 2d 3d]
kanococo: bets 0.29 and is all-in
LarryBerry217 has timed out
LarryBerry217 activated time-bank (60 seconds)
LarryBerry217: calls 0.29
*** TURN *** [3c 2d 3d] [3s]
*** RIVER *** [3c 2d 3d 3s] [Js]
*** SHOW DOWN ***
kanococo: shows [Qc Tc] (three of kind, Threes)
LarryBerry217: shows [As 7h] (three of kind, Threes)
LarryBerry217 collected 0.76 from pot
*** SUMMARY ***
Total pot 0.80 | Rake 0.04
Board [ 3c 2d 3d 3s Js ]
Game ended: 2025/09/02 20:55:00 GMT
Seat 1: Elblop (small blind) folded before Flop
Seat 2: kanococo (big blind) showed [Qc Tc]
Seat 3: HoldBabyHold folded before Flop (didn't bet)
Seat 4: SarkastikBS folded before Flop (didn't bet)
Seat 5: otaldojamal folded before Flop (didn't bet)
Seat 6: LarryBerry217 (button) showed [As 7h] and won (0.76) with three of kind, Threes
Seat 7: crispzilla folded before Flop (didn't bet)

CoinPoker Hand #291238776: Hold'em No Limit (0.01/0.02 ) 2025/09/02 20:54:59 GMT
Table 'NL ₮2 I' 7-max Seat #3 is the button
Seat 1: Anonkontello (2.05 in chips)
Seat 2: Aceinthehole (2.98 in chips) out of hand
Seat 3: vicmitch (4.29 in chips)
Seat 4: MarditZion (1.93 in chips)
Seat 5: kanococo (1.98 in chips)
Seat 6: otaldojamal (2.00 in chips)
Seat 7: pash0420 (1.79 in chips)
MarditZion: posts small blind 0.01
kanococo: posts big blind 0.02
*** HOLE CARDS ***
Dealt to kanococo [Kh Jd]
otaldojamal: raises 0.03 to 0.05
pash0420: raises 0.05 to 0.10
Anonkontello: calls 0.10
vicmitch: folds
MarditZion: folds
kanococo: calls 0.08
otaldojamal: calls 0.05
*** FLOP *** [5h 9c 7s]
kanococo: checks
otaldojamal has timed out
otaldojamal activated time-bank (41 seconds)
otaldojamal: bets 0.19
pash0420: folds
Anonkontello: folds
kanococo: folds
Uncalled bet (0.19) returned to otaldojamal
otaldojamal collected 0.39 from pot
otaldojamal: doesn't show hand
*** SUMMARY ***
Total pot 0.41 | Rake 0.02
Board [ 5h 9c 7s ]
Game ended: 2025/09/02 20:56:23 GMT
Seat 1: Anonkontello folded on the Flop
Seat 2: Aceinthehole folded before Flop (didn't bet)
Seat 3: vicmitch (button) folded before Flop (didn't bet)
Seat 4: MarditZion (small blind) folded before Flop
Seat 5: kanococo (big blind) folded on the Flop
Seat 6: otaldojamal collected (0.39)
Seat 7: pash0420 folded on the Flop

CoinPoker Hand #291239391: Hold'em No Limit (0.01/0.02 ) 2025/09/02 20:56:25 GMT
Table 'NL ₮2 I' 7-max Seat #4 is the button
Seat 1: Anonkontello (2.00 in chips)
Seat 2: Aceinthehole (2.98 in chips) out of hand
Seat 3: vicmitch (4.29 in chips)
Seat 4: MarditZion (1.92 in chips)
Seat 5: kanococo (1.88 in chips)
Seat 6: otaldojamal (2.29 in chips)
Seat 7: pash0420 (1.69 in chips)
kanococo: posts small blind 0.01
otaldojamal: posts big blind 0.02
*** HOLE CARDS ***
Dealt to kanococo [9d 8s]
pash0420: raises 0.02 to 0.04
Anonkontello: calls 0.04
vicmitch: folds
MarditZion: folds
kanococo: folds
otaldojamal: folds
*** FLOP *** [4s 3h 2s]
pash0420: bets 0.11
Anonkontello: calls 0.11
*** TURN *** [4s 3h 2s] [Ad]
pash0420: bets 0.16
Anonkontello: raises 0.34 to 0.50
pash0420: calls 0.34
*** RIVER *** [4s 3h 2s Ad] [Jc]
pash0420: checks
Anonkontello: bets 1.35 and is all-in
pash0420: folds
Uncalled bet (1.35) returned to Anonkontello
Anonkontello collected 1.26 from pot
Anonkontello: doesn't show hand
*** SUMMARY ***
Total pot 1.33 | Rake 0.07
Board [ 4s 3h 2s Ad Jc ]
Game ended: 2025/09/02 20:57:33 GMT
Seat 1: Anonkontello collected (1.26)
Seat 2: Aceinthehole folded before Flop (didn't bet)
Seat 3: vicmitch folded before Flop (didn't bet)
Seat 4: MarditZion (button) folded before Flop (didn't bet)
Seat 5: kanococo (small blind) folded before Flop
Seat 6: otaldojamal (big blind) folded before Flop
Seat 7: pash0420 folded on the River

CoinPoker Hand #291239604: Hold'em No Limit (0.01/0.02 ) 2025/09/02 20:57:35 GMT
Table 'NL ₮2 I' 7-max Seat #5 is the button
Seat 1: Anonkontello (2.61 in chips)
Seat 2: Aceinthehole (2.98 in chips) out of hand
Seat 3: vicmitch (4.29 in chips)
Seat 4: MarditZion (1.92 in chips)
Seat 5: kanococo (1.87 in chips)
Seat 6: otaldojamal (2.27 in chips)
Seat 7: pash0420 (1.04 in chips)
otaldojamal: posts small blind 0.01
pash0420: posts big blind 0.02
*** HOLE CARDS ***
Dealt to kanococo [As 5d]
Anonkontello: raises 0.03 to 0.05
vicmitch: calls 0.05
MarditZion: folds
kanococo: folds
otaldojamal: folds
pash0420: raises 0.25 to 0.30
Anonkontello: raises 2.56 and is all-in
vicmitch: folds
pash0420: calls 0.74 and is all-in
Uncalled bet (1.57) returned to Anonkontello
*** FLOP *** [4d Th Jd]
*** TURN *** [4d Th Jd] [3s]
*** RIVER *** [4d Th Jd 3s] [Tc]
*** SHOW DOWN ***
Anonkontello: shows [Qd Ad] (a pair of Tens)
pash0420: shows [8s 9d] (a pair of Tens)
Anonkontello collected 2.03 from pot
*** SUMMARY ***
Total pot 2.14 | Rake 0.11
Board [ 4d Th Jd 3s Tc ]
Game ended: 2025/09/02 20:58:28 GMT
Seat 1: Anonkontello showed [Qd Ad] and won (2.03) with a pair of Tens
Seat 2: Aceinthehole folded before Flop (didn't bet)
Seat 3: vicmitch folded before Flop
Seat 4: MarditZion folded before Flop (didn't bet)
Seat 5: kanococo (button) folded before Flop (didn't bet)
Seat 6: otaldojamal (small blind) folded before Flop
Seat 7: pash0420 (big blind) showed [8s 9d]

CoinPoker Hand #291239814: Hold'em No Limit (0.01/0.02 ) 2025/09/02 20:58:31 GMT
Table 'NL ₮2 I' 7-max Seat #6 is the button
Seat 1: Anonkontello (3.60 in chips)
Seat 2: Aceinthehole (2.98 in chips) out of hand
Seat 3: vicmitch (4.24 in chips)
Seat 4: MarditZion (1.92 in chips)
Seat 5: kanococo (1.87 in chips)
Seat 6: otaldojamal (2.26 in chips)
Anonkontello: posts big blind 0.02
*** HOLE CARDS ***
Dealt to kanococo [Kh 6d]
vicmitch: folds
MarditZion: raises 0.04 to 0.06
kanococo: folds
otaldojamal: folds
Anonkontello: calls 0.04
*** FLOP *** [Kc Jh 5d]
Anonkontello: checks
MarditZion: bets 0.05
Anonkontello: folds
Uncalled bet (0.05) returned to MarditZion
MarditZion collected 0.11 from pot
MarditZion: doesn't show hand
*** SUMMARY ***
Total pot 0.12 | Rake 0.01
Board [ Kc Jh 5d ]
Game ended: 2025/09/02 20:59:11 GMT
Seat 1: Anonkontello (big blind) folded on the Flop
Seat 2: Aceinthehole folded before Flop (didn't bet)
Seat 3: vicmitch folded before Flop (didn't bet)
Seat 4: MarditZion collected (0.11)
Seat 5: kanococo folded before Flop (didn't bet)
Seat 6: otaldojamal (button) folded before Flop (didn't bet)

CoinPoker Hand #291239936: Hold'em No Limit (0.01/0.02 ) 2025/09/02 20:59:13 GMT
Table 'NL ₮2 I' 7-max Seat #7 is the button
Seat 1: Anonkontello (3.54 in chips)
Seat 2: Aceinthehole (2.98 in chips)
Seat 3: vicmitch (4.24 in chips)
Seat 4: MarditZion (1.97 in chips)
Seat 5: kanococo (1.87 in chips)
Seat 6: otaldojamal (2.26 in chips)
Seat 7: G3TR3KTF1SH (2.00 in chips)
Anonkontello: posts small blind 0.01
Aceinthehole: posts big blind 0.02
G3TR3KTF1SH: posts big blind 0.02
*** HOLE CARDS ***
Dealt to kanococo [6c 5h]
vicmitch: folds
MarditZion: folds
kanococo: folds
otaldojamal: folds
G3TR3KTF1SH: checks
Anonkontello: raises 0.10 to 0.12
Aceinthehole: calls 0.10
G3TR3KTF1SH: folds
*** FLOP *** [Jd 2s 3d]
Anonkontello: checks
Aceinthehole: checks
*** TURN *** [Jd 2s 3d] [5c]
Anonkontello: bets 0.06
Aceinthehole: calls 0.06
*** RIVER *** [Jd 2s 3d 5c] [Kc]
Anonkontello: bets 0.54
Aceinthehole: folds
Uncalled bet (0.54) returned to Anonkontello
Anonkontello collected 0.36 from pot
Anonkontello: doesn't show hand
*** SUMMARY ***
Total pot 0.38 | Rake 0.02
Board [ Jd 2s 3d 5c Kc ]
Game ended: 2025/09/02 21:00:51 GMT
Seat 1: Anonkontello (small blind) collected (0.36)
Seat 2: Aceinthehole (big blind) folded on the River
Seat 3: vicmitch folded before Flop (didn't bet)
Seat 4: MarditZion folded before Flop (didn't bet)
Seat 5: kanococo folded before Flop (didn't bet)
Seat 6: otaldojamal folded before Flop (didn't bet)
Seat 7: G3TR3KTF1SH (button) folded before Flop

CoinPoker Hand #291240252: Hold'em No Limit (0.01/0.02 ) 2025/09/02 21:00:53 GMT
Table 'NL ₮2 I' 7-max Seat #1 is the button
Seat 1: Anonkontello (3.72 in chips)
Seat 2: Aceinthehole (2.80 in chips)
Seat 3: vicmitch (4.24 in chips)
Seat 4: MarditZion (1.97 in chips)
Seat 5: kanococo (1.87 in chips)
Seat 6: otaldojamal (2.26 in chips)
Seat 7: G3TR3KTF1SH (2.00 in chips)
Aceinthehole: posts small blind 0.01
vicmitch: posts big blind 0.02
*** HOLE CARDS ***
Dealt to kanococo [5s 2d]
MarditZion: folds
kanococo: folds
otaldojamal: folds
G3TR3KTF1SH: folds
Anonkontello: raises 0.04 to 0.06
Aceinthehole: folds
vicmitch: calls 0.04
*** FLOP *** [5d 3d Kd]
vicmitch: checks
Anonkontello has timed out
Anonkontello activated time-bank (60 seconds)
Anonkontello: checks
*** TURN *** [5d 3d Kd] [Tc]
vicmitch: bets 0.12
Anonkontello: folds
Uncalled bet (0.12) returned to vicmitch
vicmitch collected 0.12 from pot
vicmitch: doesn't show hand
*** SUMMARY ***
Total pot 0.13 | Rake 0.01
Board [ 5d 3d Kd Tc ]
Game ended: 2025/09/02 21:01:55 GMT
Seat 1: Anonkontello (button) folded on the Turn
Seat 2: Aceinthehole (small blind) folded before Flop
Seat 3: vicmitch (big blind) collected (0.12)
Seat 4: MarditZion folded before Flop (didn't bet)
Seat 5: kanococo folded before Flop (didn't bet)
Seat 6: otaldojamal folded before Flop (didn't bet)
Seat 7: G3TR3KTF1SH folded before Flop (didn't bet)

CoinPoker Hand #291240514: Hold'em No Limit (0.01/0.02 ) 2025/09/02 21:01:58 GMT
Table 'NL ₮2 I' 7-max Seat #2 is the button
Seat 1: Anonkontello (3.66 in chips)
Seat 2: Aceinthehole (2.79 in chips)
Seat 3: vicmitch (4.30 in chips)
Seat 4: MarditZion (1.97 in chips)
Seat 5: kanococo (1.87 in chips)
Seat 6: otaldojamal (2.26 in chips)
Seat 7: G3TR3KTF1SH (2.00 in chips)
vicmitch: posts small blind 0.01
MarditZion: posts big blind 0.02
*** HOLE CARDS ***
Dealt to kanococo [4c Js]
kanococo: folds
otaldojamal: folds
G3TR3KTF1SH: raises 0.03 to 0.05
Anonkontello: raises 0.13 to 0.18
Aceinthehole: folds
vicmitch: folds
MarditZion: folds
G3TR3KTF1SH: folds
Anonkontello collected 0.26 from pot
Anonkontello: doesn't show hand
*** SUMMARY ***
Total pot 0.26 | Rake 0.00
Board [ ]
Game ended: 2025/09/02 21:02:32 GMT
Seat 1: Anonkontello collected (0.26)
Seat 2: Aceinthehole (button) folded before Flop (didn't bet)
Seat 3: vicmitch (small blind) folded before Flop
Seat 4: MarditZion (big blind) folded before Flop
Seat 5: kanococo folded before Flop (didn't bet)
Seat 6: otaldojamal folded before Flop (didn't bet)
Seat 7: G3TR3KTF1SH folded before Flop

CoinPoker Hand #291240658: Hold'em No Limit (0.01/0.02 ) 2025/09/02 21:02:35 GMT
Table 'NL ₮2 I' 7-max Seat #3 is the button
Seat 1: Anonkontello (3.74 in chips) is sitting out
Seat 2: Aceinthehole (2.79 in chips)
Seat 3: vicmitch (4.29 in chips)
Seat 4: MarditZion (1.95 in chips)
Seat 5: kanococo (1.87 in chips)
Seat 6: otaldojamal (2.26 in chips)
Seat 7: G3TR3KTF1SH (2.00 in chips)
MarditZion: posts small blind 0.01
kanococo: posts big blind 0.02
*** HOLE CARDS ***
Dealt to kanococo [3c Td]
otaldojamal: folds
G3TR3KTF1SH: folds
Dtappp is disconnected
Aceinthehole: raises 0.04 to 0.06
Dtappp has reconnected
vicmitch: calls 0.06
MarditZion: folds
kanococo: folds
*** FLOP *** [3s 9d 8d]
Aceinthehole: bets 0.09
vicmitch: calls 0.09
*** TURN *** [3s 9d 8d] [5h]
Aceinthehole: checks
vicmitch: checks
*** RIVER *** [3s 9d 8d 5h] [8c]
Aceinthehole: bets 0.02
vicmitch: folds
Uncalled bet (0.02) returned to Aceinthehole
Aceinthehole collected 0.31 from pot
Aceinthehole: doesn't show hand
*** SUMMARY ***
Total pot 0.33 | Rake 0.02
Board [ 3s 9d 8d 5h 8c ]
Game ended: 2025/09/02 21:03:48 GMT
Seat 1: Anonkontello folded before Flop (didn't bet)
Seat 2: Aceinthehole collected (0.31)
Seat 3: vicmitch (button) folded on the River
Seat 4: MarditZion (small blind) folded before Flop
Seat 5: kanococo (big blind) folded before Flop
Seat 6: otaldojamal folded before Flop (didn't bet)
Seat 7: G3TR3KTF1SH folded before Flop (didn't bet)

CoinPoker Hand #291241167: Hold'em No Limit (0.01/0.02 ) 2025/09/02 21:03:50 GMT
Table 'NL ₮2 I' 7-max Seat #4 is the button
Seat 1: Dtappp (2.00 in chips)
Seat 2: Aceinthehole (2.95 in chips)
Seat 3: vicmitch (4.14 in chips)
Seat 4: MarditZion (1.94 in chips)
Seat 5: kanococo (1.85 in chips)
Seat 6: otaldojamal (2.26 in chips)
Seat 7: G3TR3KTF1SH (2.00 in chips)
kanococo: posts small blind 0.01
otaldojamal: posts big blind 0.02
Dtappp: posts big blind 0.02
*** HOLE CARDS ***
Dealt to kanococo [Js Td]
G3TR3KTF1SH: raises 0.03 to 0.05
Dtappp: folds
Aceinthehole: folds
vicmitch: folds
MarditZion: folds
kanococo: calls 0.04
otaldojamal: raises 0.17 to 0.22
G3TR3KTF1SH: calls 0.17
kanococo: folds
*** FLOP *** [3s 7h Ac]
otaldojamal: checks
G3TR3KTF1SH: checks
*** TURN *** [3s 7h Ac] [Jc]
otaldojamal: bets 0.24
G3TR3KTF1SH: raises 0.48 to 0.72
otaldojamal: raises 1.80 and is all-in
G3TR3KTF1SH: folds
Uncalled bet (1.32) returned to otaldojamal
otaldojamal collected 1.92 from pot
otaldojamal: doesn't show hand
*** SUMMARY ***
Total pot 1.95 | Rake 0.03
Board [ 3s 7h Ac Jc ]
Game ended: 2025/09/02 21:05:06 GMT
Seat 1: Dtappp folded before Flop
Seat 2: Aceinthehole folded before Flop (didn't bet)
Seat 3: vicmitch folded before Flop (didn't bet)
Seat 4: MarditZion (button) folded before Flop (didn't bet)
Seat 5: kanococo (small blind) folded before Flop
Seat 6: otaldojamal (big blind) collected (1.92)
Seat 7: G3TR3KTF1SH folded on the Turn

CoinPoker Hand #291241832: Hold'em No Limit (0.01/0.02 ) 2025/09/02 21:05:10 GMT
Table 'NL ₮2 I' 7-max Seat #5 is the button
Seat 1: Dtappp (1.98 in chips)
Seat 2: Aceinthehole (2.95 in chips)
Seat 3: vicmitch (4.14 in chips)
Seat 4: MarditZion (1.94 in chips)
Seat 5: kanococo (1.80 in chips)
Seat 6: otaldojamal (3.24 in chips)
Seat 7: G3TR3KTF1SH (2.00 in chips)
otaldojamal: posts small blind 0.01
G3TR3KTF1SH: posts big blind 0.02
*** HOLE CARDS ***
Dealt to kanococo [Kd Js]
Dtappp: folds
Aceinthehole: folds
kanococo is disconnected
kanococo has reconnected
vicmitch: folds
MarditZion: folds
kanococo: raises 0.06 to 0.08
otaldojamal: folds
G3TR3KTF1SH: folds
kanococo collected 0.11 from pot
kanococo: doesn't show hand
*** SUMMARY ***
Total pot 0.11 | Rake 0.00
Board [ ]
Game ended: 2025/09/02 21:05:44 GMT
Seat 1: Dtappp folded before Flop (didn't bet)
Seat 2: Aceinthehole folded before Flop (didn't bet)
Seat 3: vicmitch folded before Flop (didn't bet)
Seat 4: MarditZion folded before Flop (didn't bet)
Seat 5: kanococo (button) collected (0.11)
Seat 6: otaldojamal (small blind) folded before Flop
Seat 7: G3TR3KTF1SH (big blind) folded before Flop

CoinPoker Hand #291242083: Hold'em No Limit (0.01/0.02 ) 2025/09/02 21:05:46 GMT
Table 'NL ₮2 I' 7-max Seat #6 is the button
Seat 1: Dtappp (2.00 in chips)
Seat 2: Aceinthehole (2.95 in chips)
Seat 3: vicmitch (4.14 in chips)
Seat 4: MarditZion (1.94 in chips)
Seat 5: kanococo (1.83 in chips)
Seat 6: otaldojamal (3.23 in chips)
Seat 7: G3TR3KTF1SH (2.00 in chips)
G3TR3KTF1SH: posts small blind 0.01
Dtappp: posts big blind 0.02
*** HOLE CARDS ***
Dealt to kanococo [Ks 2c]
Aceinthehole: folds
vicmitch: calls 0.02
MarditZion: folds
kanococo: folds
otaldojamal has timed out
otaldojamal activated time-bank (40 seconds)
otaldojamal: raises 0.06 to 0.08
G3TR3KTF1SH: folds
Dtappp: folds
vicmitch: calls 0.06
*** FLOP *** [4s 3d 8h]
vicmitch: checks
otaldojamal: bets 0.05
vicmitch: calls 0.05
*** TURN *** [4s 3d 8h] [3h]
vicmitch: checks
otaldojamal: checks
*** RIVER *** [4s 3d 8h 3h] [Kd]
vicmitch: checks
otaldojamal: bets 0.28
vicmitch: folds
Uncalled bet (0.28) returned to otaldojamal
otaldojamal collected 0.28 from pot
otaldojamal: doesn't show hand
*** SUMMARY ***
Total pot 0.29 | Rake 0.01
Board [ 4s 3d 8h 3h Kd ]
Game ended: 2025/09/02 21:07:36 GMT
Seat 1: Dtappp (big blind) folded before Flop
Seat 2: Aceinthehole folded before Flop (didn't bet)
Seat 3: vicmitch folded on the River
Seat 4: MarditZion folded before Flop (didn't bet)
Seat 5: kanococo folded before Flop (didn't bet)
Seat 6: otaldojamal (button) collected (0.28)
Seat 7: G3TR3KTF1SH (small blind) folded before Flop

CoinPoker Hand #291243010: Hold'em No Limit (0.01/0.02 ) 2025/09/02 21:07:38 GMT
Table 'NL ₮2 I' 7-max Seat #7 is the button
Seat 1: SQuest (2.00 in chips)
Seat 2: Aceinthehole (2.95 in chips)
Seat 3: vicmitch (4.01 in chips)
Seat 4: MarditZion (1.94 in chips)
Seat 5: kanococo (1.83 in chips)
Seat 6: otaldojamal (3.38 in chips)
Seat 7: G3TR3KTF1SH (1.99 in chips)
SQuest: posts small blind 0.01
Aceinthehole: didn't post big blind
vicmitch: posts big blind 0.02
*** HOLE CARDS ***
Dealt to kanococo [7h Qc]
MarditZion: folds
kanococo: raises 0.04 to 0.06
otaldojamal: folds
G3TR3KTF1SH: calls 0.06
SQuest: folds
vicmitch: folds
*** FLOP *** [4c Kh 9d]
kanococo: checks
G3TR3KTF1SH: checks
*** TURN *** [4c Kh 9d] [9c]
kanococo: bets 0.07
G3TR3KTF1SH: calls 0.07
*** RIVER *** [4c Kh 9d 9c] [Jd]
kanococo: bets 0.14
G3TR3KTF1SH: folds
Uncalled bet (0.14) returned to kanococo
kanococo collected 0.28 from pot
kanococo: doesn't show hand
*** SUMMARY ***
Total pot 0.29 | Rake 0.01
Board [ 4c Kh 9d 9c Jd ]
Game ended: 2025/09/02 21:08:38 GMT
Seat 1: SQuest (small blind) folded before Flop
Seat 2: Aceinthehole folded before Flop (didn't bet)
Seat 3: vicmitch (big blind) folded before Flop
Seat 4: MarditZion folded before Flop (didn't bet)
Seat 5: kanococo collected (0.28)
Seat 6: otaldojamal folded before Flop (didn't bet)
Seat 7: G3TR3KTF1SH (button) folded on the River

CoinPoker Hand #291243497: Hold'em No Limit (0.01/0.02 ) 2025/09/02 21:08:40 GMT
Table 'NL ₮2 I' 7-max Seat #1 is the button
Seat 1: SQuest (1.99 in chips)
Seat 2: Aceinthehole (2.95 in chips) is sitting out
Seat 3: vicmitch (3.99 in chips)
Seat 4: MarditZion (1.94 in chips)
Seat 5: kanococo (1.98 in chips)
Seat 6: otaldojamal (3.38 in chips)
Seat 7: G3TR3KTF1SH (2.00 in chips)
vicmitch: posts small blind 0.01
MarditZion: posts big blind 0.02
*** HOLE CARDS ***
Dealt to kanococo [Jc 7h]
kanococo: folds
otaldojamal: folds
G3TR3KTF1SH: folds
SQuest: raises 0.04 to 0.06
vicmitch: folds
MarditZion: folds
SQuest collected 0.09 from pot
SQuest: doesn't show hand
*** SUMMARY ***
Total pot 0.09 | Rake 0.00
Board [ ]
Game ended: 2025/09/02 21:09:12 GMT
Seat 1: SQuest (button) collected (0.09)
Seat 2: Aceinthehole folded before Flop (didn't bet)
Seat 3: vicmitch (small blind) folded before Flop
Seat 4: MarditZion (big blind) folded before Flop
Seat 5: kanococo folded before Flop (didn't bet)
Seat 6: otaldojamal folded before Flop (didn't bet)
Seat 7: G3TR3KTF1SH folded before Flop (didn't bet)

CoinPoker Hand #291243790: Hold'em No Limit (0.01/0.02 ) 2025/09/02 21:09:14 GMT
Table 'NL ₮2 I' 7-max Seat #3 is the button
Seat 1: SQuest (2.02 in chips)
Seat 2: Aceinthehole (2.95 in chips) is sitting out
Seat 3: vicmitch (3.98 in chips)
Seat 4: MarditZion (1.92 in chips)
Seat 5: kanococo (1.98 in chips)
Seat 6: otaldojamal (3.38 in chips)
Seat 7: G3TR3KTF1SH (2.00 in chips)
MarditZion: posts small blind 0.01
kanococo: posts big blind 0.02
*** HOLE CARDS ***
Dealt to kanococo [Jc Kc]
otaldojamal: folds
G3TR3KTF1SH: folds
SQuest: folds
vicmitch: folds
MarditZion: folds
kanococo collected 0.03 from pot
kanococo: doesn't show hand
*** SUMMARY ***
Total pot 0.03 | Rake 0.00
Board [ ]
Game ended: 2025/09/02 21:09:45 GMT
Seat 1: SQuest folded before Flop (didn't bet)
Seat 2: Aceinthehole folded before Flop (didn't bet)
Seat 3: vicmitch (button) folded before Flop (didn't bet)
Seat 4: MarditZion (small blind) folded before Flop
Seat 5: kanococo (big blind) collected (0.03)
Seat 6: otaldojamal folded before Flop (didn't bet)
Seat 7: G3TR3KTF1SH folded before Flop (didn't bet)

CoinPoker Hand #291244089: Hold'em No Limit (0.01/0.02 ) 2025/09/02 21:09:48 GMT
Table 'NL ₮2 I' 7-max Seat #4 is the button
Seat 1: SQuest (2.02 in chips)
Seat 2: Aceinthehole (2.95 in chips) is sitting out
Seat 3: vicmitch (3.98 in chips)
Seat 4: MarditZion (1.91 in chips)
Seat 5: kanococo (1.99 in chips)
Seat 6: otaldojamal (3.38 in chips)
Seat 7: G3TR3KTF1SH (2.00 in chips)
kanococo: posts small blind 0.01
otaldojamal: posts big blind 0.02
*** HOLE CARDS ***
Dealt to kanococo [Ts 7s]
G3TR3KTF1SH: folds
SQuest: folds
vicmitch: folds
MarditZion: folds
kanococo: raises 0.02 to 0.04
otaldojamal: calls 0.02
*** FLOP *** [3c Jd Kd]
kanococo: checks
otaldojamal: bets 0.02
kanococo: calls 0.02
*** TURN *** [3c Jd Kd] [Qs]
kanococo: checks
otaldojamal: bets 0.05
kanococo: folds
Uncalled bet (0.05) returned to otaldojamal
otaldojamal collected 0.11 from pot
otaldojamal: doesn't show hand
*** SUMMARY ***
Total pot 0.12 | Rake 0.01
Board [ 3c Jd Kd Qs ]
Game ended: 2025/09/02 21:10:47 GMT
Seat 1: SQuest folded before Flop (didn't bet)
Seat 2: Aceinthehole folded before Flop (didn't bet)
Seat 3: vicmitch folded before Flop (didn't bet)
Seat 4: MarditZion (button) folded before Flop (didn't bet)
Seat 5: kanococo (small blind) folded on the Turn
Seat 6: otaldojamal (big blind) collected (0.11)
Seat 7: G3TR3KTF1SH folded before Flop (didn't bet)

CoinPoker Hand #291244521: Hold'em No Limit (0.01/0.02 ) 2025/09/02 21:10:50 GMT
Table 'NL ₮2 I' 7-max Seat #5 is the button
Seat 1: SQuest (2.02 in chips)
Seat 2: Aceinthehole (2.95 in chips) is sitting out
Seat 3: vicmitch (3.98 in chips)
Seat 4: MarditZion (1.91 in chips)
Seat 5: kanococo (1.93 in chips)
Seat 6: otaldojamal (3.43 in chips)
Seat 7: G3TR3KTF1SH (2.00 in chips)
otaldojamal: posts small blind 0.01
G3TR3KTF1SH: posts big blind 0.02
*** HOLE CARDS ***
Dealt to kanococo [Jd Ac]
SQuest: folds
vicmitch: folds
MarditZion: raises 0.04 to 0.06
kanococo: raises 0.06 to 0.12
otaldojamal: folds
G3TR3KTF1SH: folds
MarditZion: calls 0.06
*** FLOP *** [Ks 5h 5d]
MarditZion: checks
kanococo: bets 0.06
MarditZion: calls 0.06
*** TURN *** [Ks 5h 5d] [6c]
MarditZion: checks
kanococo: checks
*** RIVER *** [Ks 5h 5d 6c] [3d]
MarditZion: checks
kanococo: bets 0.10
MarditZion: calls 0.10
*** SHOW DOWN ***
kanococo: shows [Jd Ac] (a pair of Fives)
MarditZion: shows [9c 9s] (two pairs, Nines and Fives)
MarditZion collected 0.56 from pot
*** SUMMARY ***
Total pot 0.59 | Rake 0.03
Board [ Ks 5h 5d 6c 3d ]
Game ended: 2025/09/02 21:12:21 GMT
Seat 1: SQuest folded before Flop (didn't bet)
Seat 2: Aceinthehole folded before Flop (didn't bet)
Seat 3: vicmitch folded before Flop (didn't bet)
Seat 4: MarditZion showed [9c 9s] and won (0.56) with two pairs, Nines and Fives
Seat 5: kanococo (button) showed [Jd Ac]
Seat 6: otaldojamal (small blind) folded before Flop
Seat 7: G3TR3KTF1SH (big blind) folded before Flop

CoinPoker Hand #291245147: Hold'em No Limit (0.01/0.02 ) 2025/09/02 21:12:23 GMT
Table 'NL ₮2 I' 7-max Seat #6 is the button
Seat 1: SQuest (2.02 in chips)
Seat 2: Aceinthehole (2.95 in chips) is sitting out
Seat 3: vicmitch (3.98 in chips)
Seat 4: MarditZion (2.19 in chips)
Seat 5: kanococo (1.65 in chips)
Seat 6: otaldojamal (3.42 in chips)
Seat 7: G3TR3KTF1SH (1.98 in chips)
G3TR3KTF1SH: posts small blind 0.01
SQuest: posts big blind 0.02
*** HOLE CARDS ***
Dealt to kanococo [Qd 4h]
vicmitch: folds
MarditZion: folds
kanococo: folds
otaldojamal: folds
G3TR3KTF1SH: raises 0.04 to 0.06
SQuest: folds
G3TR3KTF1SH collected 0.08 from pot
G3TR3KTF1SH: doesn't show hand
*** SUMMARY ***
Total pot 0.08 | Rake 0.00
Board [ ]
Game ended: 2025/09/02 21:12:46 GMT
Seat 1: SQuest (big blind) folded before Flop
Seat 2: Aceinthehole folded before Flop (didn't bet)
Seat 3: vicmitch folded before Flop (didn't bet)
Seat 4: MarditZion folded before Flop (didn't bet)
Seat 5: kanococo folded before Flop (didn't bet)
Seat 6: otaldojamal (button) folded before Flop (didn't bet)
Seat 7: G3TR3KTF1SH (small blind) collected (0.08)

CoinPoker Hand #291245403: Hold'em No Limit (0.01/0.02 ) 2025/09/02 21:12:48 GMT
Table 'NL ₮2 I' 7-max Seat #7 is the button
Seat 1: SQuest (2.00 in chips)
Seat 2: Aceinthehole (2.95 in chips) is sitting out
Seat 3: vicmitch (3.98 in chips)
Seat 4: MarditZion (2.19 in chips)
Seat 5: kanococo (1.65 in chips)
Seat 6: otaldojamal (3.42 in chips)
Seat 7: G3TR3KTF1SH (2.00 in chips)
SQuest: posts small blind 0.01
vicmitch: posts big blind 0.02
*** HOLE CARDS ***
Dealt to kanococo [4h Kd]
MarditZion: folds
kanococo: folds
otaldojamal: folds
G3TR3KTF1SH: folds
SQuest: raises 0.03 to 0.05
vicmitch: calls 0.03
*** FLOP *** [5s Qd Td]
SQuest: bets 0.06
vicmitch: folds
Uncalled bet (0.06) returned to SQuest
SQuest collected 0.09 from pot
SQuest: doesn't show hand
*** SUMMARY ***
Total pot 0.10 | Rake 0.01
Board [ 5s Qd Td ]
Game ended: 2025/09/02 21:13:26 GMT
Seat 1: SQuest (small blind) collected (0.09)
Seat 2: Aceinthehole folded before Flop (didn't bet)
Seat 3: vicmitch (big blind) folded on the Flop
Seat 4: MarditZion folded before Flop (didn't bet)
Seat 5: kanococo folded before Flop (didn't bet)
Seat 6: otaldojamal folded before Flop (didn't bet)
Seat 7: G3TR3KTF1SH (button) folded before Flop (didn't bet)

CoinPoker Hand #291245714: Hold'em No Limit (0.01/0.02 ) 2025/09/02 21:13:28 GMT
Table 'NL ₮2 I' 7-max Seat #1 is the button
Seat 1: SQuest (2.04 in chips)
Seat 2: Aceinthehole (2.95 in chips) is sitting out
Seat 3: vicmitch (3.93 in chips)
Seat 4: MarditZion (2.19 in chips)
Seat 5: kanococo (1.65 in chips)
Seat 6: otaldojamal (3.42 in chips)
Seat 7: G3TR3KTF1SH (2.00 in chips)
vicmitch: posts small blind 0.01
MarditZion: posts big blind 0.02
*** HOLE CARDS ***
Dealt to kanococo [5h 8d]
kanococo: folds
otaldojamal: folds
G3TR3KTF1SH: folds
SQuest: folds
vicmitch: calls 0.01
MarditZion: checks
*** FLOP *** [Kc 3h 4c]
vicmitch: checks
MarditZion: bets 0.10
vicmitch has timed out
vicmitch activated time-bank (9 seconds)
vicmitch: folds
Uncalled bet (0.10) returned to MarditZion
MarditZion collected 0.04 from pot
MarditZion: doesn't show hand
*** SUMMARY ***
Total pot 0.04 | Rake 0.00
Board [ Kc 3h 4c ]
Game ended: 2025/09/02 21:14:30 GMT
Seat 1: SQuest (button) folded before Flop (didn't bet)
Seat 2: Aceinthehole folded before Flop (didn't bet)
Seat 3: vicmitch (small blind) folded on the Flop
Seat 4: MarditZion (big blind) collected (0.04)
Seat 5: kanococo folded before Flop (didn't bet)
Seat 6: otaldojamal folded before Flop (didn't bet)
Seat 7: G3TR3KTF1SH folded before Flop (didn't bet)

CoinPoker Hand #291246223: Hold'em No Limit (0.01/0.02 ) 2025/09/02 21:14:34 GMT
Table 'NL ₮2 I' 7-max Seat #3 is the button
Seat 1: SQuest (2.04 in chips)
Seat 2: Aceinthehole (2.95 in chips) is sitting out
Seat 3: vicmitch (3.91 in chips)
Seat 4: MarditZion (2.21 in chips)
Seat 5: kanococo (1.65 in chips)
Seat 6: otaldojamal (3.42 in chips)
Seat 7: G3TR3KTF1SH (2.00 in chips)
MarditZion: posts small blind 0.01
kanococo: posts big blind 0.02
*** HOLE CARDS ***
Dealt to kanococo [3s Kh]
otaldojamal: folds
G3TR3KTF1SH: folds
SQuest: folds
vicmitch: calls 0.02
MarditZion: raises 0.04 to 0.06
kanococo: folds
vicmitch: calls 0.04
*** FLOP *** [8s 7c 7d]
MarditZion: bets 0.06
vicmitch: calls 0.06
*** TURN *** [8s 7c 7d] [Qc]
MarditZion: checks
vicmitch: checks
*** RIVER *** [8s 7c 7d Qc] [5h]
MarditZion: checks
vicmitch: checks
*** SHOW DOWN ***
MarditZion: shows [Ts 9s] (a pair of Sevens)
vicmitch: shows [As 9d] (a pair of Sevens)
vicmitch collected 0.25 from pot
*** SUMMARY ***
Total pot 0.26 | Rake 0.01
Board [ 8s 7c 7d Qc 5h ]
Game ended: 2025/09/02 21:15:31 GMT
Seat 1: SQuest folded before Flop (didn't bet)
Seat 2: Aceinthehole folded before Flop (didn't bet)
Seat 3: vicmitch (button) showed [As 9d] and won (0.25) with a pair of Sevens
Seat 4: MarditZion (small blind) showed [Ts 9s]
Seat 5: kanococo (big blind) folded before Flop
Seat 6: otaldojamal folded before Flop (didn't bet)
Seat 7: G3TR3KTF1SH folded before Flop (didn't bet)

CoinPoker Hand #291246646: Hold'em No Limit (0.01/0.02 ) 2025/09/02 21:15:33 GMT
Table 'NL ₮2 I' 7-max Seat #4 is the button
Seat 1: SQuest (2.04 in chips)
Seat 2: Aceinthehole (2.95 in chips) is sitting out
Seat 3: vicmitch (4.04 in chips)
Seat 4: MarditZion (2.09 in chips)
Seat 5: kanococo (1.63 in chips)
Seat 6: otaldojamal (3.42 in chips)
Seat 7: G3TR3KTF1SH (2.00 in chips)
kanococo: posts small blind 0.01
otaldojamal: posts big blind 0.02
*** HOLE CARDS ***
Dealt to kanococo [Tc 5s]
G3TR3KTF1SH: folds
SQuest: folds
vicmitch: calls 0.02
MarditZion: folds
kanococo: raises 0.04 to 0.06
otaldojamal: folds
vicmitch: calls 0.04
*** FLOP *** [Qd Qs 8c]
kanococo: checks
vicmitch: checks
*** TURN *** [Qd Qs 8c] [6h]
kanococo: bets 0.06
vicmitch: calls 0.06
*** RIVER *** [Qd Qs 8c 6h] [7c]
kanococo: bets 0.25
vicmitch: folds
Uncalled bet (0.25) returned to kanococo
kanococo collected 0.25 from pot
kanococo: doesn't show hand
*** SUMMARY ***
Total pot 0.26 | Rake 0.01
Board [ Qd Qs 8c 6h 7c ]
Game ended: 2025/09/02 21:16:41 GMT
Seat 1: SQuest folded before Flop (didn't bet)
Seat 2: Aceinthehole folded before Flop (didn't bet)
Seat 3: vicmitch folded on the River
Seat 4: MarditZion (button) folded before Flop (didn't bet)
Seat 5: kanococo (small blind) collected (0.25)
Seat 6: otaldojamal (big blind) folded before Flop
Seat 7: G3TR3KTF1SH folded before Flop (didn't bet)

CoinPoker Hand #291247185: Hold'em No Limit (0.01/0.02 ) 2025/09/02 21:16:43 GMT
Table 'NL ₮2 I' 7-max Seat #5 is the button
Seat 1: SQuest (2.04 in chips)
Seat 2: Aceinthehole (2.95 in chips) is sitting out
Seat 3: vicmitch (3.92 in chips)
Seat 4: MarditZion (2.09 in chips)
Seat 5: kanococo (1.76 in chips)
Seat 6: otaldojamal (3.40 in chips)
Seat 7: G3TR3KTF1SH (2.00 in chips)
otaldojamal: posts small blind 0.01
G3TR3KTF1SH: posts big blind 0.02
*** HOLE CARDS ***
Dealt to kanococo [6d 6h]
SQuest: folds
vicmitch: calls 0.02
MarditZion: folds
kanococo: raises 0.04 to 0.06
otaldojamal: folds
G3TR3KTF1SH: folds
vicmitch: calls 0.04
*** FLOP *** [7s 4c 3d]
vicmitch: checks
kanococo: bets 0.07
vicmitch: calls 0.07
*** TURN *** [7s 4c 3d] [7d]
vicmitch: checks
kanococo: checks
*** RIVER *** [7s 4c 3d 7d] [6s]
vicmitch: bets 0.16
kanococo: raises 1.63 and is all-in
vicmitch: folds
Uncalled bet (1.47) returned to kanococo
kanococo collected 0.60 from pot
kanococo: doesn't show hand
*** SUMMARY ***
Total pot 0.61 | Rake 0.01
Board [ 7s 4c 3d 7d 6s ]
Game ended: 2025/09/02 21:17:58 GMT
Seat 1: SQuest folded before Flop (didn't bet)
Seat 2: Aceinthehole folded before Flop (didn't bet)
Seat 3: vicmitch folded on the River
Seat 4: MarditZion folded before Flop (didn't bet)
Seat 5: kanococo (button) collected (0.60)
Seat 6: otaldojamal (small blind) folded before Flop
Seat 7: G3TR3KTF1SH (big blind) folded before Flop

CoinPoker Hand #291247656: Hold'em No Limit (0.01/0.02 ) 2025/09/02 21:18:00 GMT
Table 'NL ₮2 I' 7-max Seat #6 is the button
Seat 1: SQuest (2.04 in chips)
Seat 2: SoBrokeAF (2.00 in chips) out of hand
Seat 3: vicmitch (3.63 in chips)
Seat 4: MarditZion (2.09 in chips)
Seat 5: kanococo (2.07 in chips)
Seat 6: otaldojamal (3.39 in chips)
Seat 7: G3TR3KTF1SH (1.98 in chips)
G3TR3KTF1SH: posts small blind 0.01
SQuest: posts big blind 0.02
*** HOLE CARDS ***
Dealt to kanococo [2h 9d]
vicmitch: folds
MarditZion: folds
kanococo: folds
otaldojamal: raises 0.03 to 0.05
G3TR3KTF1SH: folds
SQuest: folds
otaldojamal collected 0.08 from pot
otaldojamal: doesn't show hand
*** SUMMARY ***
Total pot 0.08 | Rake 0.00
Board [ ]
Game ended: 2025/09/02 21:18:22 GMT
Seat 1: SQuest (big blind) folded before Flop
Seat 2: SoBrokeAF folded before Flop (didn't bet)
Seat 3: vicmitch folded before Flop (didn't bet)
Seat 4: MarditZion folded before Flop (didn't bet)
Seat 5: kanococo folded before Flop (didn't bet)
Seat 6: otaldojamal (button) collected (0.08)
Seat 7: G3TR3KTF1SH (small blind) folded before Flop

CoinPoker Hand #291247847: Hold'em No Limit (0.01/0.02 ) 2025/09/02 21:18:26 GMT
Table 'NL ₮2 I' 7-max Seat #7 is the button
Seat 1: SQuest (2.02 in chips)
Seat 2: SoBrokeAF (2.00 in chips)
Seat 3: vicmitch (3.63 in chips)
Seat 4: MarditZion (2.09 in chips)
Seat 5: kanococo (2.07 in chips)
Seat 6: otaldojamal (3.42 in chips)
Seat 7: G3TR3KTF1SH (1.99 in chips)
SQuest: posts small blind 0.01
SoBrokeAF: posts big blind 0.02
*** HOLE CARDS ***
Dealt to kanococo [2h Qh]
vicmitch: folds
MarditZion: raises 0.04 to 0.06
kanococo: folds
otaldojamal: raises 0.15 to 0.21
G3TR3KTF1SH: folds
SQuest: folds
SoBrokeAF: folds
MarditZion: folds
otaldojamal collected 0.30 from pot
otaldojamal: doesn't show hand
*** SUMMARY ***
Total pot 0.30 | Rake 0.00
Board [ ]
Game ended: 2025/09/02 21:18:57 GMT
Seat 1: SQuest (small blind) folded before Flop
Seat 2: SoBrokeAF (big blind) folded before Flop
Seat 3: vicmitch folded before Flop (didn't bet)
Seat 4: MarditZion folded before Flop
Seat 5: kanococo folded before Flop (didn't bet)
Seat 6: otaldojamal collected (0.30)
Seat 7: G3TR3KTF1SH (button) folded before Flop (didn't bet)

CoinPoker Hand #291248112: Hold'em No Limit (0.01/0.02 ) 2025/09/02 21:18:59 GMT
Table 'NL ₮2 I' 7-max Seat #1 is the button
Seat 1: SQuest (2.01 in chips)
Seat 2: SoBrokeAF (1.98 in chips)
Seat 3: vicmitch (3.63 in chips)
Seat 4: MarditZion (2.03 in chips)
Seat 5: kanococo (2.07 in chips)
Seat 6: otaldojamal (3.51 in chips)
Seat 7: G3TR3KTF1SH (2.00 in chips)
SoBrokeAF: posts small blind 0.01
vicmitch: posts big blind 0.02
*** HOLE CARDS ***
Dealt to kanococo [Ad Js]
MarditZion: folds
kanococo: raises 0.04 to 0.06
otaldojamal: folds
G3TR3KTF1SH: folds
SQuest: calls 0.06
SoBrokeAF: calls 0.05
vicmitch: folds
*** FLOP *** [Ks Ah 2c]
SoBrokeAF: checks
kanococo: bets 0.04
SQuest: folds
SoBrokeAF: folds
Uncalled bet (0.04) returned to kanococo
kanococo collected 0.19 from pot
kanococo: doesn't show hand
*** SUMMARY ***
Total pot 0.20 | Rake 0.01
Board [ Ks Ah 2c ]
Game ended: 2025/09/02 21:19:54 GMT
Seat 1: SQuest (button) folded on the Flop
Seat 2: SoBrokeAF (small blind) folded on the Flop
Seat 3: vicmitch (big blind) folded before Flop
Seat 4: MarditZion folded before Flop (didn't bet)
Seat 5: kanococo collected (0.19)
Seat 6: otaldojamal folded before Flop (didn't bet)
Seat 7: G3TR3KTF1SH folded before Flop (didn't bet)

CoinPoker Hand #291248401: Hold'em No Limit (0.01/0.02 ) 2025/09/02 21:19:56 GMT
Table 'NL ₮2 I' 7-max Seat #2 is the button
Seat 1: SQuest (2.00 in chips)
Seat 2: SoBrokeAF (2.00 in chips)
Seat 3: vicmitch (3.61 in chips)
Seat 4: MarditZion (2.03 in chips)
Seat 5: kanococo (2.20 in chips)
Seat 6: otaldojamal (3.51 in chips)
Seat 7: G3TR3KTF1SH (2.00 in chips)
vicmitch: posts small blind 0.01
MarditZion: posts big blind 0.02
*** HOLE CARDS ***
Dealt to kanococo [Ts 9s]
kanococo: folds
otaldojamal: raises 0.03 to 0.05
G3TR3KTF1SH: folds
SQuest: folds
SoBrokeAF: folds
vicmitch: calls 0.04
MarditZion has timed out
MarditZion activated time-bank (60 seconds)
MarditZion: folds
*** FLOP *** [3h Qh As]
vicmitch: checks
otaldojamal: checks
*** TURN *** [3h Qh As] [Ad]
vicmitch: bets 0.11
otaldojamal: folds
Uncalled bet (0.11) returned to vicmitch
vicmitch collected 0.11 from pot
vicmitch: doesn't show hand
*** SUMMARY ***
Total pot 0.12 | Rake 0.01
Board [ 3h Qh As Ad ]
Game ended: 2025/09/02 21:21:12 GMT
Seat 1: SQuest folded before Flop (didn't bet)
Seat 2: SoBrokeAF (button) folded before Flop (didn't bet)
Seat 3: vicmitch (small blind) collected (0.11)
Seat 4: MarditZion (big blind) folded before Flop
Seat 5: kanococo folded before Flop (didn't bet)
Seat 6: otaldojamal folded on the Turn
Seat 7: G3TR3KTF1SH folded before Flop (didn't bet)

CoinPoker Hand #291248909: Hold'em No Limit (0.01/0.02 ) 2025/09/02 21:21:13 GMT
Table 'NL ₮2 I' 7-max Seat #3 is the button
Seat 1: SQuest (2.00 in chips)
Seat 2: SoBrokeAF (2.00 in chips)
Seat 3: vicmitch (3.67 in chips)
Seat 4: MarditZion (2.01 in chips)
Seat 5: kanococo (2.20 in chips)
Seat 6: otaldojamal (3.46 in chips)
Seat 7: G3TR3KTF1SH (2.00 in chips)
MarditZion: posts small blind 0.01
kanococo: posts big blind 0.02
*** HOLE CARDS ***
Dealt to kanococo [9c Ac]
otaldojamal: folds
G3TR3KTF1SH: folds
SQuest: folds
SoBrokeAF: folds
vicmitch: folds
MarditZion: folds
kanococo collected 0.03 from pot
kanococo: doesn't show hand
*** SUMMARY ***
Total pot 0.03 | Rake 0.00
Board [ ]
Game ended: 2025/09/02 21:21:51 GMT
Seat 1: SQuest folded before Flop (didn't bet)
Seat 2: SoBrokeAF folded before Flop (didn't bet)
Seat 3: vicmitch (button) folded before Flop (didn't bet)
Seat 4: MarditZion (small blind) folded before Flop
Seat 5: kanococo (big blind) collected (0.03)
Seat 6: otaldojamal folded before Flop (didn't bet)
Seat 7: G3TR3KTF1SH folded before Flop (didn't bet)

CoinPoker Hand #291249186: Hold'em No Limit (0.01/0.02 ) 2025/09/02 21:21:53 GMT
Table 'NL ₮2 I' 7-max Seat #4 is the button
Seat 1: SQuest (2.00 in chips)
Seat 2: SoBrokeAF (2.00 in chips)
Seat 3: vicmitch (3.67 in chips)
Seat 4: MarditZion (2.00 in chips)
Seat 5: kanococo (2.21 in chips)
Seat 6: otaldojamal (3.46 in chips)
Seat 7: G3TR3KTF1SH (2.00 in chips)
kanococo: posts small blind 0.01
otaldojamal: posts big blind 0.02
*** HOLE CARDS ***
Dealt to kanococo [2h 6c]
G3TR3KTF1SH: folds
SQuest: folds
SoBrokeAF: folds
vicmitch: folds
MarditZion: folds
kanococo: raises 0.02 to 0.04
otaldojamal has timed out
otaldojamal activated time-bank (60 seconds)
otaldojamal: folds
kanococo collected 0.06 from pot
kanococo: doesn't show hand
*** SUMMARY ***
Total pot 0.06 | Rake 0.00
Board [ ]
Game ended: 2025/09/02 21:22:40 GMT
Seat 1: SQuest folded before Flop (didn't bet)
Seat 2: SoBrokeAF folded before Flop (didn't bet)
Seat 3: vicmitch folded before Flop (didn't bet)
Seat 4: MarditZion (button) folded before Flop (didn't bet)
Seat 5: kanococo (small blind) collected (0.06)
Seat 6: otaldojamal (big blind) folded before Flop
Seat 7: G3TR3KTF1SH folded before Flop (didn't bet)

CoinPoker Hand #291249526: Hold'em No Limit (0.01/0.02 ) 2025/09/02 21:22:42 GMT
Table 'NL ₮2 I' 7-max Seat #5 is the button
Seat 1: SQuest (2.00 in chips)
Seat 2: SoBrokeAF (2.00 in chips)
Seat 3: vicmitch (3.67 in chips)
Seat 4: MarditZion (2.00 in chips)
Seat 5: kanococo (2.23 in chips)
Seat 6: otaldojamal (3.44 in chips)
Seat 7: G3TR3KTF1SH (2.00 in chips)
otaldojamal: posts small blind 0.01
G3TR3KTF1SH: posts big blind 0.02
*** HOLE CARDS ***
Dealt to kanococo [5s 9h]
SQuest: folds
SoBrokeAF: folds
vicmitch: folds
MarditZion: folds
kanococo: folds
otaldojamal: folds
G3TR3KTF1SH collected 0.03 from pot
G3TR3KTF1SH: doesn't show hand
*** SUMMARY ***
Total pot 0.03 | Rake 0.00
Board [ ]
Game ended: 2025/09/02 21:23:07 GMT
Seat 1: SQuest folded before Flop (didn't bet)
Seat 2: SoBrokeAF folded before Flop (didn't bet)
Seat 3: vicmitch folded before Flop (didn't bet)
Seat 4: MarditZion folded before Flop (didn't bet)
Seat 5: kanococo (button) folded before Flop (didn't bet)
Seat 6: otaldojamal (small blind) folded before Flop
Seat 7: G3TR3KTF1SH (big blind) collected (0.03)

CoinPoker Hand #291249689: Hold'em No Limit (0.01/0.02 ) 2025/09/02 21:23:10 GMT
Table 'NL ₮2 I' 7-max Seat #6 is the button
Seat 1: SQuest (2.00 in chips)
Seat 2: SoBrokeAF (2.00 in chips)
Seat 3: vicmitch (3.67 in chips)
Seat 4: MarditZion (2.00 in chips)
Seat 5: kanococo (2.23 in chips)
Seat 6: otaldojamal (3.43 in chips)
Seat 7: G3TR3KTF1SH (2.01 in chips)
G3TR3KTF1SH: posts small blind 0.01
SQuest: posts big blind 0.02
*** HOLE CARDS ***
Dealt to kanococo [5c 8s]
SoBrokeAF: folds
vicmitch: folds
MarditZion: raises 0.04 to 0.06
kanococo: folds
otaldojamal: folds
G3TR3KTF1SH: folds
SQuest: folds
MarditZion collected 0.09 from pot
MarditZion: doesn't show hand
*** SUMMARY ***
Total pot 0.09 | Rake 0.00
Board [ ]
Game ended: 2025/09/02 21:23:39 GMT
Seat 1: SQuest (big blind) folded before Flop
Seat 2: SoBrokeAF folded before Flop (didn't bet)
Seat 3: vicmitch folded before Flop (didn't bet)
Seat 4: MarditZion collected (0.09)
Seat 5: kanococo folded before Flop (didn't bet)
Seat 6: otaldojamal (button) folded before Flop (didn't bet)
Seat 7: G3TR3KTF1SH (small blind) folded before Flop

CoinPoker Hand #291249881: Hold'em No Limit (0.01/0.02 ) 2025/09/02 21:23:42 GMT
Table 'NL ₮2 I' 7-max Seat #7 is the button
Seat 1: SQuest (2.00 in chips)
Seat 2: SoBrokeAF (2.00 in chips)
Seat 3: vicmitch (3.67 in chips)
Seat 4: MarditZion (2.03 in chips)
Seat 5: kanococo (2.23 in chips)
Seat 6: otaldojamal (3.43 in chips)
Seat 7: G3TR3KTF1SH (2.00 in chips)
SQuest: posts small blind 0.01
SoBrokeAF: posts big blind 0.02
*** HOLE CARDS ***
Dealt to kanococo [Qc 6h]
vicmitch: folds
MarditZion: folds
kanococo: folds
otaldojamal: folds
G3TR3KTF1SH: folds
SQuest: folds
SoBrokeAF collected 0.03 from pot
SoBrokeAF: doesn't show hand
*** SUMMARY ***
Total pot 0.03 | Rake 0.00
Board [ ]
Game ended: 2025/09/02 21:24:06 GMT
Seat 1: SQuest (small blind) folded before Flop
Seat 2: SoBrokeAF (big blind) collected (0.03)
Seat 3: vicmitch folded before Flop (didn't bet)
Seat 4: MarditZion folded before Flop (didn't bet)
Seat 5: kanococo folded before Flop (didn't bet)
Seat 6: otaldojamal folded before Flop (didn't bet)
Seat 7: G3TR3KTF1SH (button) folded before Flop (didn't bet)

CoinPoker Hand #291250098: Hold'em No Limit (0.01/0.02 ) 2025/09/02 21:24:08 GMT
Table 'NL ₮2 I' 7-max Seat #1 is the button
Seat 1: SQuest (2.00 in chips)
Seat 2: SoBrokeAF (2.01 in chips)
Seat 3: vicmitch (3.67 in chips)
Seat 4: MarditZion (2.03 in chips)
Seat 5: kanococo (2.23 in chips)
Seat 6: otaldojamal (3.43 in chips)
Seat 7: G3TR3KTF1SH (2.00 in chips)
SoBrokeAF: posts small blind 0.01
vicmitch: posts big blind 0.02
*** HOLE CARDS ***
Dealt to kanococo [3d 9c]
MarditZion: folds
kanococo: folds
otaldojamal: folds
G3TR3KTF1SH: folds
SQuest: folds
SoBrokeAF: folds
vicmitch collected 0.03 from pot
vicmitch: doesn't show hand
*** SUMMARY ***
Total pot 0.03 | Rake 0.00
Board [ ]
Game ended: 2025/09/02 21:24:29 GMT
Seat 1: SQuest (button) folded before Flop (didn't bet)
Seat 2: SoBrokeAF (small blind) folded before Flop
Seat 3: vicmitch (big blind) collected (0.03)
Seat 4: MarditZion folded before Flop (didn't bet)
Seat 5: kanococo folded before Flop (didn't bet)
Seat 6: otaldojamal folded before Flop (didn't bet)
Seat 7: G3TR3KTF1SH folded before Flop (didn't bet)

CoinPoker Hand #291250279: Hold'em No Limit (0.01/0.02 ) 2025/09/02 21:24:31 GMT
Table 'NL ₮2 I' 7-max Seat #2 is the button
Seat 1: SQuest (2.00 in chips)
Seat 2: SoBrokeAF (2.00 in chips)
Seat 3: vicmitch (3.68 in chips)
Seat 4: MarditZion (2.03 in chips)
Seat 5: kanococo (2.23 in chips)
Seat 6: otaldojamal (3.43 in chips)
Seat 7: G3TR3KTF1SH (2.00 in chips)
vicmitch: posts small blind 0.01
MarditZion: posts big blind 0.02
*** HOLE CARDS ***
Dealt to kanococo [3h 7s]
kanococo: folds
otaldojamal: folds
G3TR3KTF1SH: folds
SoBrokeAF is disconnected
SQuest: raises 0.03 to 0.05
SoBrokeAF has reconnected
SoBrokeAF: raises 0.11 to 0.16
vicmitch: folds
MarditZion: folds
SQuest: calls 0.11
*** FLOP *** [Tc Td 5h]
SQuest: checks
SoBrokeAF: bets 0.10
SQuest: calls 0.10
*** TURN *** [Tc Td 5h] [Jh]
SQuest: checks
SoBrokeAF: bets 0.26
SQuest: folds
Uncalled bet (0.26) returned to SoBrokeAF
SoBrokeAF collected 0.52 from pot
SoBrokeAF: doesn't show hand
*** SUMMARY ***
Total pot 0.55 | Rake 0.03
Board [ Tc Td 5h Jh ]
Game ended: 2025/09/02 21:26:13 GMT
Seat 1: SQuest folded on the Turn
Seat 2: SoBrokeAF (button) collected (0.52)
Seat 3: vicmitch (small blind) folded before Flop
Seat 4: MarditZion (big blind) folded before Flop
Seat 5: kanococo folded before Flop (didn't bet)
Seat 6: otaldojamal folded before Flop (didn't bet)
Seat 7: G3TR3KTF1SH folded before Flop (didn't bet)

CoinPoker Hand #291250934: Hold'em No Limit (0.01/0.02 ) 2025/09/02 21:26:15 GMT
Table 'NL ₮2 I' 7-max Seat #3 is the button
Seat 1: SQuest (2.00 in chips)
Seat 2: SoBrokeAF (2.26 in chips)
Seat 3: vicmitch (3.67 in chips)
Seat 4: MarditZion (2.01 in chips)
Seat 5: kanococo (2.23 in chips)
Seat 6: otaldojamal (3.43 in chips)
Seat 7: G3TR3KTF1SH (2.00 in chips)
MarditZion: posts small blind 0.01
kanococo: posts big blind 0.02
*** HOLE CARDS ***
Dealt to kanococo [5c Qc]
otaldojamal: folds
G3TR3KTF1SH: folds
SQuest: raises 0.04 to 0.06
SoBrokeAF: raises 0.12 to 0.18
vicmitch: folds
MarditZion: folds
kanococo: folds
SQuest: calls 0.12
*** FLOP *** [Ac 7h Ks]
SQuest: checks
SoBrokeAF: bets 0.12
SQuest: calls 0.12
*** TURN *** [Ac 7h Ks] [2h]
SQuest: checks
SoBrokeAF: bets 0.30
SQuest: folds
Uncalled bet (0.30) returned to SoBrokeAF
SoBrokeAF collected 0.60 from pot
SoBrokeAF: doesn't show hand
*** SUMMARY ***
Total pot 0.63 | Rake 0.03
Board [ Ac 7h Ks 2h ]
Game ended: 2025/09/02 21:27:11 GMT
Seat 1: SQuest folded on the Turn
Seat 2: SoBrokeAF collected (0.60)
Seat 3: vicmitch (button) folded before Flop (didn't bet)
Seat 4: MarditZion (small blind) folded before Flop
Seat 5: kanococo (big blind) folded before Flop
Seat 6: otaldojamal folded before Flop (didn't bet)
Seat 7: G3TR3KTF1SH folded before Flop (didn't bet)

CoinPoker Hand #291251292: Hold'em No Limit (0.01/0.02 ) 2025/09/02 21:27:13 GMT
Table 'NL ₮2 I' 7-max Seat #4 is the button
Seat 1: SQuest (2.00 in chips)
Seat 2: SoBrokeAF (2.56 in chips)
Seat 3: vicmitch (3.67 in chips)
Seat 4: MarditZion (2.00 in chips)
Seat 5: kanococo (2.21 in chips)
Seat 6: otaldojamal (3.43 in chips)
Seat 7: G3TR3KTF1SH (2.00 in chips)
kanococo: posts small blind 0.01
otaldojamal: posts big blind 0.02
*** HOLE CARDS ***
Dealt to kanococo [Ts 6c]
G3TR3KTF1SH: folds
SQuest: folds
SoBrokeAF: folds
vicmitch: folds
MarditZion: folds
kanococo: raises 0.04 to 0.06
otaldojamal: calls 0.04
*** FLOP *** [4h Ks Jc]
kanococo: checks
otaldojamal: bets 0.03
kanococo: folds
Uncalled bet (0.03) returned to otaldojamal
otaldojamal collected 0.11 from pot
otaldojamal: doesn't show hand
*** SUMMARY ***
Total pot 0.12 | Rake 0.01
Board [ 4h Ks Jc ]
Game ended: 2025/09/02 21:27:59 GMT
Seat 1: SQuest folded before Flop (didn't bet)
Seat 2: SoBrokeAF folded before Flop (didn't bet)
Seat 3: vicmitch folded before Flop (didn't bet)
Seat 4: MarditZion (button) folded before Flop (didn't bet)
Seat 5: kanococo (small blind) folded on the Flop
Seat 6: otaldojamal (big blind) collected (0.11)
Seat 7: G3TR3KTF1SH folded before Flop (didn't bet)

CoinPoker Hand #291251678: Hold'em No Limit (0.01/0.02 ) 2025/09/02 21:28:01 GMT
Table 'NL ₮2 I' 7-max Seat #5 is the button
Seat 1: SQuest (2.00 in chips)
Seat 2: SoBrokeAF (2.56 in chips)
Seat 3: vicmitch (3.67 in chips)
Seat 4: MarditZion (2.00 in chips)
Seat 5: kanococo (2.15 in chips)
Seat 6: otaldojamal (3.48 in chips)
Seat 7: G3TR3KTF1SH (2.00 in chips)
otaldojamal: posts small blind 0.01
G3TR3KTF1SH: posts big blind 0.02
*** HOLE CARDS ***
Dealt to kanococo [Ad Qd]
SQuest: folds
SoBrokeAF: folds
vicmitch: calls 0.02
MarditZion: folds
kanococo: raises 0.08 to 0.10
otaldojamal: folds
G3TR3KTF1SH: raises 0.26 to 0.36
vicmitch: folds
kanococo has timed out
kanococo activated time-bank (60 seconds)
kanococo: calls 0.26
*** FLOP *** [3h Qc 4d]
G3TR3KTF1SH: checks
kanococo: bets 0.35
G3TR3KTF1SH: raises 0.35 to 0.70
kanococo: calls 0.35
*** TURN *** [3h Qc 4d] [3d]
G3TR3KTF1SH: bets 0.94 and is all-in
kanococo: calls 0.94
*** RIVER *** [3h Qc 4d 3d] [Kc]
*** SHOW DOWN ***
G3TR3KTF1SH: shows [As Ks] (two pairs, Kings and Threes)
kanococo: shows [Ad Qd] (two pairs, Queens and Threes)
G3TR3KTF1SH collected 3.83 from pot
*** SUMMARY ***
Total pot 4.03 | Rake 0.20
Board [ 3h Qc 4d 3d Kc ]
Game ended: 2025/09/02 21:29:26 GMT
Seat 1: SQuest folded before Flop (didn't bet)
Seat 2: SoBrokeAF folded before Flop (didn't bet)
Seat 3: vicmitch folded before Flop
Seat 4: MarditZion folded before Flop (didn't bet)
Seat 5: kanococo (button) showed [Ad Qd]
Seat 6: otaldojamal (small blind) folded before Flop
Seat 7: G3TR3KTF1SH (big blind) showed [As Ks] and won (3.83) with two pairs, Kings and Threes

CoinPoker Hand #291252229: Hold'em No Limit (0.01/0.02 ) 2025/09/02 21:29:28 GMT
Table 'NL ₮2 I' 7-max Seat #6 is the button
Seat 1: SQuest (2.00 in chips)
Seat 2: SoBrokeAF (2.56 in chips)
Seat 3: vicmitch (3.65 in chips)
Seat 4: MarditZion (2.00 in chips)
Seat 5: kanococo (0.15 in chips)
Seat 6: otaldojamal (3.47 in chips)
Seat 7: G3TR3KTF1SH (3.83 in chips)
G3TR3KTF1SH: posts small blind 0.01
SQuest: didn't post big blind
SoBrokeAF: posts big blind 0.02
*** HOLE CARDS ***
Dealt to kanococo [2h 8h]
vicmitch: folds
MarditZion: folds
kanococo: calls 0.02
otaldojamal: folds
G3TR3KTF1SH: calls 0.01
SoBrokeAF: checks
*** FLOP *** [9h 3h 9d]
G3TR3KTF1SH: checks
SoBrokeAF: checks
kanococo: bets 0.13 and is all-in
G3TR3KTF1SH: calls 0.13
SoBrokeAF: folds
*** TURN *** [9h 3h 9d] [8d]
*** RIVER *** [9h 3h 9d 8d] [7h]
*** SHOW DOWN ***
kanococo: shows [2h 8h] (a flush, Nine high)
G3TR3KTF1SH: shows [9c Td] (three of kind, Nines)
kanococo collected 0.30 from pot
*** SUMMARY ***
Total pot 0.32 | Rake 0.02
Board [ 9h 3h 9d 8d 7h ]
Game ended: 2025/09/02 21:30:24 GMT
Seat 1: SQuest folded before Flop (didn't bet)
Seat 2: SoBrokeAF (big blind) folded on the Flop
Seat 3: vicmitch folded before Flop (didn't bet)
Seat 4: MarditZion folded before Flop (didn't bet)
Seat 5: kanococo showed [2h 8h] and won (0.30) with a flush, Nine high
Seat 6: otaldojamal (button) folded before Flop (didn't bet)
Seat 7: G3TR3KTF1SH (small blind) showed [9c Td]

CoinPoker Hand #291252584: Hold'em No Limit (0.01/0.02 ) 2025/09/02 21:30:26 GMT
Table 'NL ₮2 I' 7-max Seat #7 is the button
Seat 1: rRubbB (2.00 in chips)
Seat 2: SoBrokeAF (2.54 in chips)
Seat 3: vicmitch (3.65 in chips)
Seat 4: MarditZion (2.00 in chips)
Seat 5: kanococo (0.30 in chips)
Seat 6: otaldojamal (3.47 in chips)
Seat 7: G3TR3KTF1SH (3.68 in chips)
SoBrokeAF: posts small blind 0.01
vicmitch: posts big blind 0.02
rRubbB: posts big blind 0.02
*** HOLE CARDS ***
Dealt to kanococo [7c 4d]
MarditZion: folds
kanococo: folds
otaldojamal: folds
G3TR3KTF1SH: folds
rRubbB: checks
SoBrokeAF: calls 0.01
vicmitch: checks
*** FLOP *** [Ah 3s 6h]
rRubbB: checks
SoBrokeAF: checks
vicmitch: checks
*** TURN *** [Ah 3s 6h] [Ts]
rRubbB: bets 0.08
SoBrokeAF: folds
vicmitch: calls 0.08
*** RIVER *** [Ah 3s 6h Ts] [Ks]
rRubbB: bets 0.24
vicmitch: calls 0.24
*** SHOW DOWN ***
rRubbB: shows [6s 5s] (a flush, King high)
vicmitch: mucks hand
rRubbB collected 0.66 from pot
*** SUMMARY ***
Total pot 0.70 | Rake 0.04
Board [ Ah 3s 6h Ts Ks ]
Game ended: 2025/09/02 21:31:31 GMT
Seat 1: rRubbB showed [6s 5s] and won (0.66) with a flush, King high
Seat 2: SoBrokeAF (small blind) folded on the Turn
Seat 3: vicmitch (big blind) mucked
Seat 4: MarditZion folded before Flop (didn't bet)
Seat 5: kanococo folded before Flop (didn't bet)
Seat 6: otaldojamal folded before Flop (didn't bet)
Seat 7: G3TR3KTF1SH (button) folded before Flop (didn't bet)

CoinPoker Hand #291253189: Hold'em No Limit (0.01/0.02 ) 2025/09/02 21:31:34 GMT
Table 'NL ₮2 I' 7-max Seat #2 is the button
Seat 1: rRubbB (2.32 in chips)
Seat 2: SoBrokeAF (2.52 in chips)
Seat 3: vicmitch (3.31 in chips)
Seat 4: MarditZion (2.00 in chips)
Seat 5: kanococo (0.30 in chips)
Seat 6: otaldojamal (3.47 in chips)
Seat 7: G3TR3KTF1SH (3.68 in chips)
vicmitch: posts small blind 0.01
MarditZion: posts big blind 0.02
*** HOLE CARDS ***
Dealt to kanococo [6s Js]
kanococo: raises 0.30 and is all-in
otaldojamal: folds
G3TR3KTF1SH: folds
rRubbB: folds
SoBrokeAF: folds
vicmitch: folds
MarditZion: folds
kanococo collected 0.33 from pot
kanococo: doesn't show hand
*** SUMMARY ***
Total pot 0.33 | Rake 0.00
Board [ ]
Game ended: 2025/09/02 21:31:57 GMT
Seat 1: rRubbB folded before Flop (didn't bet)
Seat 2: SoBrokeAF (button) folded before Flop (didn't bet)
Seat 3: vicmitch (small blind) folded before Flop
Seat 4: MarditZion (big blind) folded before Flop
Seat 5: kanococo collected (0.33)
Seat 6: otaldojamal folded before Flop (didn't bet)
Seat 7: G3TR3KTF1SH folded before Flop (didn't bet)

CoinPoker Hand #291253379: Hold'em No Limit (0.01/0.02 ) 2025/09/02 21:31:59 GMT
Table 'NL ₮2 I' 7-max Seat #3 is the button
Seat 1: rRubbB (2.32 in chips)
Seat 2: SoBrokeAF (2.52 in chips)
Seat 3: vicmitch (3.30 in chips)
Seat 4: MarditZion (1.98 in chips)
Seat 5: kanococo (0.33 in chips)
Seat 6: otaldojamal (3.47 in chips)
Seat 7: G3TR3KTF1SH (3.68 in chips)
MarditZion: posts small blind 0.01
kanococo: posts big blind 0.02
*** HOLE CARDS ***
Dealt to kanococo [Ad Jh]
otaldojamal: folds
G3TR3KTF1SH: folds
rRubbB: raises 0.04 to 0.06
SoBrokeAF: folds
vicmitch: raises 0.16 to 0.22
MarditZion: folds
kanococo: raises 0.31 and is all-in
rRubbB: folds
vicmitch: calls 0.11
*** FLOP *** [Jd 3s As]
*** TURN *** [Jd 3s As] [7c]
*** RIVER *** [Jd 3s As 7c] [4h]
*** SHOW DOWN ***
kanococo: shows [Ad Jh] (two pairs, Aces and Jacks)
vicmitch: shows [Qs Ac] (a pair of Aces)
kanococo collected 0.69 from pot
*** SUMMARY ***
Total pot 0.73 | Rake 0.04
Board [ Jd 3s As 7c 4h ]
Game ended: 2025/09/02 21:32:40 GMT
Seat 1: rRubbB folded before Flop
Seat 2: SoBrokeAF folded before Flop (didn't bet)
Seat 3: vicmitch (button) showed [Qs Ac]
Seat 4: MarditZion (small blind) folded before Flop
Seat 5: kanococo (big blind) showed [Ad Jh] and won (0.69) with two pairs, Aces and Jacks
Seat 6: otaldojamal folded before Flop (didn't bet)
Seat 7: G3TR3KTF1SH folded before Flop (didn't bet)

CoinPoker Hand #291253630: Hold'em No Limit (0.01/0.02 ) 2025/09/02 21:32:42 GMT
Table 'NL ₮2 I' 7-max Seat #4 is the button
Seat 1: rRubbB (2.26 in chips)
Seat 2: SoBrokeAF (2.52 in chips)
Seat 3: vicmitch (2.97 in chips)
Seat 4: MarditZion (1.97 in chips)
Seat 5: kanococo (0.69 in chips)
Seat 6: otaldojamal (3.47 in chips)
Seat 7: G3TR3KTF1SH (3.68 in chips)
kanococo: posts small blind 0.01
otaldojamal: posts big blind 0.02
*** HOLE CARDS ***
Dealt to kanococo [4h 2d]
G3TR3KTF1SH: folds
rRubbB: folds
SoBrokeAF has timed out
SoBrokeAF activated time-bank (60 seconds)
SoBrokeAF: folds
vicmitch: calls 0.02
MarditZion: raises 0.04 to 0.06
kanococo: folds
otaldojamal: folds
vicmitch: calls 0.04
*** FLOP *** [Ac 2h 8s]
vicmitch: checks
MarditZion: bets 0.07
vicmitch: folds
Uncalled bet (0.07) returned to MarditZion
MarditZion collected 0.14 from pot
MarditZion: doesn't show hand
*** SUMMARY ***
Total pot 0.15 | Rake 0.01
Board [ Ac 2h 8s ]
Game ended: 2025/09/02 21:33:28 GMT
Seat 1: rRubbB folded before Flop (didn't bet)
Seat 2: SoBrokeAF folded before Flop (didn't bet)
Seat 3: vicmitch folded on the Flop
Seat 4: MarditZion (button) collected (0.14)
Seat 5: kanococo (small blind) folded before Flop
Seat 6: otaldojamal (big blind) folded before Flop
Seat 7: G3TR3KTF1SH folded before Flop (didn't bet)

CoinPoker Hand #291253969: Hold'em No Limit (0.01/0.02 ) 2025/09/02 21:33:31 GMT
Table 'NL ₮2 I' 7-max Seat #5 is the button
Seat 1: rRubbB (2.26 in chips)
Seat 2: SoBrokeAF (2.52 in chips)
Seat 3: vicmitch (2.91 in chips)
Seat 4: MarditZion (2.05 in chips)
Seat 5: kanococo (0.68 in chips)
Seat 6: otaldojamal (3.45 in chips)
Seat 7: G3TR3KTF1SH (3.68 in chips)
otaldojamal: posts small blind 0.01
G3TR3KTF1SH: posts big blind 0.02
*** HOLE CARDS ***
Dealt to kanococo [Ac 3c]
rRubbB: raises 0.04 to 0.06
SoBrokeAF: folds
vicmitch: calls 0.06
MarditZion: folds
kanococo: calls 0.06
otaldojamal: folds
G3TR3KTF1SH: raises 0.34 to 0.40
rRubbB: folds
vicmitch: calls 0.34
kanococo: folds
*** FLOP *** [Ks Ad 2h]
G3TR3KTF1SH: checks
vicmitch: checks
*** TURN *** [Ks Ad 2h] [7d]
G3TR3KTF1SH: bets 0.24
vicmitch: calls 0.24
*** RIVER *** [Ks Ad 2h 7d] [5c]
G3TR3KTF1SH: bets 1.00
vicmitch: folds
Uncalled bet (1.00) returned to G3TR3KTF1SH
G3TR3KTF1SH collected 1.34 from pot
G3TR3KTF1SH: doesn't show hand
*** SUMMARY ***
Total pot 1.41 | Rake 0.07
Board [ Ks Ad 2h 7d 5c ]
Game ended: 2025/09/02 21:34:41 GMT
Seat 1: rRubbB folded before Flop
Seat 2: SoBrokeAF folded before Flop (didn't bet)
Seat 3: vicmitch folded on the River
Seat 4: MarditZion folded before Flop (didn't bet)
Seat 5: kanococo (button) folded before Flop
Seat 6: otaldojamal (small blind) folded before Flop
Seat 7: G3TR3KTF1SH (big blind) collected (1.34)

CoinPoker Hand #291254567: Hold'em No Limit (0.01/0.02 ) 2025/09/02 21:34:44 GMT
Table 'NL ₮2 I' 7-max Seat #6 is the button
Seat 1: rRubbB (2.20 in chips)
Seat 2: SoBrokeAF (2.52 in chips)
Seat 3: vicmitch (2.27 in chips)
Seat 4: MarditZion (2.05 in chips)
Seat 5: kanococo (0.62 in chips)
Seat 6: otaldojamal (3.44 in chips)
Seat 7: G3TR3KTF1SH (4.38 in chips)
G3TR3KTF1SH: posts small blind 0.01
rRubbB: posts big blind 0.02
*** HOLE CARDS ***
Dealt to kanococo [6s Js]
SoBrokeAF: folds
vicmitch: calls 0.02
MarditZion: folds
kanococo: raises 0.62 and is all-in
otaldojamal: folds
G3TR3KTF1SH: folds
rRubbB: folds
vicmitch: calls 0.60
*** FLOP *** [Ah 6h 7s]
*** TURN *** [Ah 6h 7s] [4h]
*** RIVER *** [Ah 6h 7s 4h] [8s]
*** SHOW DOWN ***
kanococo: shows [6s Js] (a pair of Sixes)
vicmitch: shows [8d 6d] (two pairs, Eights and Sixes)
vicmitch collected 1.21 from pot
*** SUMMARY ***
Total pot 1.27 | Rake 0.06
Board [ Ah 6h 7s 4h 8s ]
Game ended: 2025/09/02 21:35:13 GMT
Seat 1: rRubbB (big blind) folded before Flop
Seat 2: SoBrokeAF folded before Flop (didn't bet)
Seat 3: vicmitch showed [8d 6d] and won (1.21) with two pairs, Eights and Sixes
Seat 4: MarditZion folded before Flop (didn't bet)
Seat 5: kanococo showed [6s Js]
Seat 6: otaldojamal (button) folded before Flop (didn't bet)
Seat 7: G3TR3KTF1SH (small blind) folded before Flop

CoinPoker Hand #291718010: Hold'em No Limit (0.01/0.02 ) 2025/09/03 22:15:44 GMT
Table 'NL ₮2 III' 7-max Seat #5 is the button
Seat 1: AladeenMF (3.37 in chips)
Seat 2: AAdem (1.01 in chips)
Seat 3: HailToTheKing (2.83 in chips)
Seat 4: kanococo (2.00 in chips)
Seat 5: pscxlt (1.88 in chips)
Seat 6: Aceinthehole (2.27 in chips)
Seat 7: ColdFish (2.03 in chips)
Aceinthehole: posts small blind 0.01
ColdFish: posts big blind 0.02
kanococo: posts big blind 0.02
*** HOLE CARDS ***
Dealt to kanococo [Ah Kh]
AladeenMF: folds
AAdem: calls 0.02
HailToTheKing: folds
kanococo: raises 0.04 to 0.06
pscxlt: folds
Aceinthehole: folds
ColdFish: folds
AAdem: calls 0.04
*** FLOP *** [9s 9d Jd]
AAdem: checks
kanococo: checks
*** TURN *** [9s 9d Jd] [Kd]
AAdem: bets 0.06
kanococo: calls 0.06
*** RIVER *** [9s 9d Jd Kd] [Jc]
AAdem: bets 0.10
kanococo: calls 0.10
*** SHOW DOWN ***
AAdem: shows [8c Ad] (two pairs, Jacks and Nines)
kanococo: shows [Ah Kh] (two pairs, Kings and Jacks)
kanococo collected 0.45 from pot
*** SUMMARY ***
Total pot 0.47 | Rake 0.02
Board [ 9s 9d Jd Kd Jc ]
Game ended: 2025/09/03 22:16:46 GMT
Seat 1: AladeenMF folded before Flop (didn't bet)
Seat 2: AAdem showed [8c Ad]
Seat 3: HailToTheKing folded before Flop (didn't bet)
Seat 4: kanococo showed [Ah Kh] and won (0.45) with two pairs, Kings and Jacks
Seat 5: pscxlt (button) folded before Flop (didn't bet)
Seat 6: Aceinthehole (small blind) folded before Flop
Seat 7: ColdFish (big blind) folded before Flop

CoinPoker Hand #291718421: Hold'em No Limit (0.01/0.02 ) 2025/09/03 22:16:48 GMT
Table 'NL ₮2 III' 7-max Seat #6 is the button
Seat 1: AladeenMF (3.37 in chips)
Seat 2: AAdem (0.79 in chips)
Seat 3: HailToTheKing (2.83 in chips)
Seat 4: kanococo (2.23 in chips)
Seat 5: pscxlt (2.00 in chips)
Seat 6: Aceinthehole (2.26 in chips)
Seat 7: ColdFish (2.01 in chips)
ColdFish: posts small blind 0.01
AladeenMF: posts big blind 0.02
*** HOLE CARDS ***
Dealt to kanococo [8c Kd]
AAdem: folds
HailToTheKing: folds
kanococo: raises 0.02 to 0.04
pscxlt: folds
Aceinthehole: folds
ColdFish: folds
AladeenMF: calls 0.02
*** FLOP *** [Jd 7d 5d]
AladeenMF: checks
kanococo: checks
*** TURN *** [Jd 7d 5d] [Ks]
AladeenMF: checks
kanococo: bets 0.04
AladeenMF: calls 0.04
*** RIVER *** [Jd 7d 5d Ks] [5h]
AladeenMF: checks
kanococo: bets 0.16
AladeenMF: folds
Uncalled bet (0.16) returned to kanococo
kanococo collected 0.16 from pot
kanococo: doesn't show hand
*** SUMMARY ***
Total pot 0.17 | Rake 0.01
Board [ Jd 7d 5d Ks 5h ]
Game ended: 2025/09/03 22:17:35 GMT
Seat 1: AladeenMF (big blind) folded on the River
Seat 2: AAdem folded before Flop (didn't bet)
Seat 3: HailToTheKing folded before Flop (didn't bet)
Seat 4: kanococo collected (0.16)
Seat 5: pscxlt folded before Flop (didn't bet)
Seat 6: Aceinthehole (button) folded before Flop (didn't bet)
Seat 7: ColdFish (small blind) folded before Flop

CoinPoker Hand #291718725: Hold'em No Limit (0.01/0.02 ) 2025/09/03 22:17:37 GMT
Table 'NL ₮2 III' 7-max Seat #7 is the button
Seat 1: AladeenMF (3.29 in chips)
Seat 2: AAdem (0.79 in chips)
Seat 3: HailToTheKing (2.83 in chips)
Seat 4: kanococo (2.31 in chips)
Seat 5: pscxlt (2.00 in chips)
Seat 6: Aceinthehole (2.26 in chips)
Seat 7: ColdFish (2.00 in chips)
AladeenMF: posts small blind 0.01
AAdem: posts big blind 0.02
*** HOLE CARDS ***
Dealt to kanococo [8d 2s]
HailToTheKing: folds
kanococo: folds
pscxlt: raises 0.03 to 0.05
Aceinthehole: folds
ColdFish: raises 0.15 to 0.20
AladeenMF: folds
AAdem: raises 0.77 and is all-in
pscxlt: folds
ColdFish: calls 0.59
*** FLOP *** [Qh Kh 7c]
*** TURN *** [Qh Kh 7c] [5d]
*** RIVER *** [Qh Kh 7c 5d] [Th]
*** SHOW DOWN ***
AAdem: shows [Js As] (a straight, Ace high)
ColdFish: shows [Qs Ks] (two pairs, Kings and Queens)
AAdem collected 1.56 from pot
*** SUMMARY ***
Total pot 1.64 | Rake 0.08
Board [ Qh Kh 7c 5d Th ]
Game ended: 2025/09/03 22:18:27 GMT
Seat 1: AladeenMF (small blind) folded before Flop
Seat 2: AAdem (big blind) showed [Js As] and won (1.56) with a straight, Ace high
Seat 3: HailToTheKing folded before Flop (didn't bet)
Seat 4: kanococo folded before Flop (didn't bet)
Seat 5: pscxlt folded before Flop
Seat 6: Aceinthehole folded before Flop (didn't bet)
Seat 7: ColdFish (button) showed [Qs Ks]

CoinPoker Hand #291719045: Hold'em No Limit (0.01/0.02 ) 2025/09/03 22:18:29 GMT
Table 'NL ₮2 III' 7-max Seat #1 is the button
Seat 1: AladeenMF (3.28 in chips)
Seat 2: AAdem (1.56 in chips)
Seat 3: HailToTheKing (2.83 in chips)
Seat 4: kanococo (2.31 in chips)
Seat 5: pscxlt (1.95 in chips)
Seat 6: Aceinthehole (2.26 in chips)
Seat 7: ColdFish (2.00 in chips)
AAdem: posts small blind 0.01
HailToTheKing: posts big blind 0.02
*** HOLE CARDS ***
Dealt to kanococo [Ks 4d]
kanococo has timed out
kanococo activated time-bank (60 seconds)
kanococo: folds
pscxlt: folds
Aceinthehole: raises 0.04 to 0.06
ColdFish: folds
AladeenMF: folds
AAdem: calls 0.05
HailToTheKing: folds
*** FLOP *** [6d 5s 5d]
AAdem: checks
Aceinthehole: bets 0.09
AAdem: calls 0.09
*** TURN *** [6d 5s 5d] [Td]
AAdem: checks
Aceinthehole: checks
*** RIVER *** [6d 5s 5d Td] [Ts]
AAdem: checks
Aceinthehole: checks
*** SHOW DOWN ***
AAdem: shows [9c 7h] (two pairs, Tens and Fives)
Aceinthehole: shows [Qs Ah] (two pairs, Tens and Fives)
Aceinthehole collected 0.30 from pot
*** SUMMARY ***
Total pot 0.32 | Rake 0.02
Board [ 6d 5s 5d Td Ts ]
Game ended: 2025/09/03 22:20:11 GMT
Seat 1: AladeenMF (button) folded before Flop (didn't bet)
Seat 2: AAdem (small blind) showed [9c 7h]
Seat 3: HailToTheKing (big blind) folded before Flop
Seat 4: kanococo folded before Flop (didn't bet)
Seat 5: pscxlt folded before Flop (didn't bet)
Seat 6: Aceinthehole showed [Qs Ah] and won (0.30) with two pairs, Tens and Fives
Seat 7: ColdFish folded before Flop (didn't bet)

CoinPoker Hand #291719666: Hold'em No Limit (0.01/0.02 ) 2025/09/03 22:20:13 GMT
Table 'NL ₮2 III' 7-max Seat #2 is the button
Seat 1: AladeenMF (3.28 in chips)
Seat 2: AAdem (1.41 in chips)
Seat 3: HailToTheKing (2.81 in chips)
Seat 4: kanococo (2.31 in chips)
Seat 5: pscxlt (2.00 in chips)
Seat 6: Aceinthehole (2.41 in chips)
Seat 7: ColdFish (2.00 in chips)
HailToTheKing: posts small blind 0.01
kanococo: posts big blind 0.02
*** HOLE CARDS ***
Dealt to kanococo [9h 8h]
pscxlt: folds
Aceinthehole: folds
ColdFish: folds
AladeenMF: folds
AAdem: calls 0.02
HailToTheKing: raises 0.07 to 0.09
kanococo: calls 0.07
AAdem: calls 0.07
*** FLOP *** [9d Ac Tc]
HailToTheKing: checks
kanococo: checks
AAdem: checks
*** TURN *** [9d Ac Tc] [5s]
HailToTheKing: checks
kanococo: bets 0.13
AAdem: calls 0.13
HailToTheKing: folds
*** RIVER *** [9d Ac Tc 5s] [3c]
kanococo: bets 0.25
AAdem: folds
Uncalled bet (0.25) returned to kanococo
kanococo collected 0.50 from pot
kanococo: doesn't show hand
*** SUMMARY ***
Total pot 0.53 | Rake 0.03
Board [ 9d Ac Tc 5s 3c ]
Game ended: 2025/09/03 22:21:29 GMT
Seat 1: AladeenMF folded before Flop (didn't bet)
Seat 2: AAdem (button) folded on the River
Seat 3: HailToTheKing (small blind) folded on the Turn
Seat 4: kanococo (big blind) collected (0.50)
Seat 5: pscxlt folded before Flop (didn't bet)
Seat 6: Aceinthehole folded before Flop (didn't bet)
Seat 7: ColdFish folded before Flop (didn't bet)

CoinPoker Hand #291720059: Hold'em No Limit (0.01/0.02 ) 2025/09/03 22:21:31 GMT
Table 'NL ₮2 III' 7-max Seat #3 is the button
Seat 1: AladeenMF (3.28 in chips)
Seat 2: AAdem (1.19 in chips)
Seat 3: HailToTheKing (2.72 in chips)
Seat 4: kanococo (2.59 in chips)
Seat 5: pscxlt (2.00 in chips)
Seat 6: Aceinthehole (2.41 in chips)
Seat 7: ColdFish (2.00 in chips)
kanococo: posts small blind 0.01
pscxlt: posts big blind 0.02
*** HOLE CARDS ***
Dealt to kanococo [Kd 2c]
Aceinthehole: folds
ColdFish: folds
AladeenMF: folds
AAdem: calls 0.02
HailToTheKing: folds
kanococo: raises 0.02 to 0.04
pscxlt: folds
AAdem: calls 0.02
*** FLOP *** [5h 4h 3c]
kanococo: checks
AAdem: checks
*** TURN *** [5h 4h 3c] [9h]
kanococo: bets 0.04
AAdem: calls 0.04
*** RIVER *** [5h 4h 3c 9h] [Qh]
kanococo: bets 0.02
AAdem: raises 0.10 to 0.12
kanococo: folds
Uncalled bet (0.10) returned to AAdem
AAdem collected 0.21 from pot
AAdem: doesn't show hand
*** SUMMARY ***
Total pot 0.22 | Rake 0.01
Board [ 5h 4h 3c 9h Qh ]
Game ended: 2025/09/03 22:22:37 GMT
Seat 1: AladeenMF folded before Flop (didn't bet)
Seat 2: AAdem collected (0.21)
Seat 3: HailToTheKing (button) folded before Flop (didn't bet)
Seat 4: kanococo (small blind) folded on the River
Seat 5: pscxlt (big blind) folded before Flop
Seat 6: Aceinthehole folded before Flop (didn't bet)
Seat 7: ColdFish folded before Flop (didn't bet)

CoinPoker Hand #291720566: Hold'em No Limit (0.01/0.02 ) 2025/09/03 22:22:40 GMT
Table 'NL ₮2 III' 7-max Seat #4 is the button
Seat 1: AladeenMF (3.28 in chips)
Seat 2: AAdem (1.30 in chips)
Seat 3: HailToTheKing (2.72 in chips)
Seat 4: kanococo (2.49 in chips)
Seat 5: pscxlt (1.98 in chips)
Seat 6: Aceinthehole (2.41 in chips)
Seat 7: ColdFish (2.00 in chips)
pscxlt: posts small blind 0.01
Aceinthehole: posts big blind 0.02
*** HOLE CARDS ***
Dealt to kanococo [6s Ah]
ColdFish: folds
AladeenMF: folds
AAdem: calls 0.02
HailToTheKing: folds
kanococo: folds
pscxlt: folds
Aceinthehole: checks
*** FLOP *** [Js 2c 6c]
Aceinthehole: checks
AAdem: bets 0.02
Aceinthehole: calls 0.02
*** TURN *** [Js 2c 6c] [Td]
Aceinthehole: checks
AAdem: bets 0.04
Aceinthehole: calls 0.04
*** RIVER *** [Js 2c 6c Td] [7h]
Aceinthehole: checks
AAdem: checks
*** SHOW DOWN ***
Aceinthehole: shows [6d 8h] (a pair of Sixes)
AAdem: mucks hand
Aceinthehole collected 0.16 from pot
*** SUMMARY ***
Total pot 0.17 | Rake 0.01
Board [ Js 2c 6c Td 7h ]
Game ended: 2025/09/03 22:23:26 GMT
Seat 1: AladeenMF folded before Flop (didn't bet)
Seat 2: AAdem mucked
Seat 3: HailToTheKing folded before Flop (didn't bet)
Seat 4: kanococo (button) folded before Flop (didn't bet)
Seat 5: pscxlt (small blind) folded before Flop
Seat 6: Aceinthehole (big blind) showed [6d 8h] and won (0.16) with a pair of Sixes
Seat 7: ColdFish folded before Flop (didn't bet)

CoinPoker Hand #291720892: Hold'em No Limit (0.01/0.02 ) 2025/09/03 22:23:28 GMT
Table 'NL ₮2 III' 7-max Seat #5 is the button
Seat 1: AladeenMF (3.28 in chips)
Seat 2: AAdem (1.22 in chips)
Seat 3: HailToTheKing (2.72 in chips)
Seat 4: kanococo (2.49 in chips)
Seat 5: pscxlt (1.99 in chips)
Seat 6: Aceinthehole (2.49 in chips) is sitting out
Seat 7: ColdFish (2.00 in chips)
ColdFish: posts small blind 0.01
AladeenMF: posts big blind 0.02
*** HOLE CARDS ***
Dealt to kanococo [Js 8s]
AAdem: folds
HailToTheKing: folds
kanococo: folds
pscxlt: raises 0.03 to 0.05
ColdFish: folds
AladeenMF: folds
pscxlt collected 0.08 from pot
pscxlt: doesn't show hand
*** SUMMARY ***
Total pot 0.08 | Rake 0.00
Board [ ]
Game ended: 2025/09/03 22:23:50 GMT
Seat 1: AladeenMF (big blind) folded before Flop
Seat 2: AAdem folded before Flop (didn't bet)
Seat 3: HailToTheKing folded before Flop (didn't bet)
Seat 4: kanococo folded before Flop (didn't bet)
Seat 5: pscxlt (button) collected (0.08)
Seat 6: Aceinthehole folded before Flop (didn't bet)
Seat 7: ColdFish (small blind) folded before Flop

CoinPoker Hand #291721008: Hold'em No Limit (0.01/0.02 ) 2025/09/03 22:23:52 GMT
Table 'NL ₮2 III' 7-max Seat #7 is the button
Seat 1: AladeenMF (3.26 in chips)
Seat 2: AAdem (1.22 in chips)
Seat 3: HailToTheKing (2.72 in chips)
Seat 4: kanococo (2.49 in chips)
Seat 5: pscxlt (2.02 in chips)
Seat 6: Aceinthehole (2.49 in chips) is sitting out
Seat 7: ColdFish (1.99 in chips)
AladeenMF: posts small blind 0.01
AAdem: posts big blind 0.02
*** HOLE CARDS ***
Dealt to kanococo [3d Jc]
HailToTheKing: raises 0.03 to 0.05
kanococo: folds
pscxlt: folds
ColdFish: folds
AladeenMF: folds
AAdem: calls 0.03
*** FLOP *** [3h 7d 9d]
AAdem: checks
HailToTheKing: checks
*** TURN *** [3h 7d 9d] [9s]
AAdem: checks
HailToTheKing: checks
*** RIVER *** [3h 7d 9d 9s] [Qs]
AAdem: checks
HailToTheKing: checks
*** SHOW DOWN ***
AAdem: shows [8h 5s] (a pair of Nines)
HailToTheKing: shows [Jd Ks] (a pair of Nines)
HailToTheKing collected 0.10 from pot
*** SUMMARY ***
Total pot 0.11 | Rake 0.01
Board [ 3h 7d 9d 9s Qs ]
Game ended: 2025/09/03 22:24:47 GMT
Seat 1: AladeenMF (small blind) folded before Flop
Seat 2: AAdem (big blind) showed [8h 5s]
Seat 3: HailToTheKing showed [Jd Ks] and won (0.10) with a pair of Nines
Seat 4: kanococo folded before Flop (didn't bet)
Seat 5: pscxlt folded before Flop (didn't bet)
Seat 6: Aceinthehole folded before Flop (didn't bet)
Seat 7: ColdFish (button) folded before Flop (didn't bet)

CoinPoker Hand #291721306: Hold'em No Limit (0.01/0.02 ) 2025/09/03 22:24:48 GMT
Table 'NL ₮2 III' 7-max Seat #1 is the button
Seat 1: AladeenMF (3.25 in chips)
Seat 2: AAdem (1.17 in chips)
Seat 3: HailToTheKing (2.77 in chips)
Seat 4: kanococo (2.49 in chips)
Seat 5: pscxlt (2.02 in chips)
Seat 6: Aceinthehole (2.49 in chips) is sitting out
Seat 7: ColdFish (2.00 in chips)
AAdem: posts small blind 0.01
HailToTheKing: posts big blind 0.02
*** HOLE CARDS ***
Dealt to kanococo [9s Jc]
kanococo: folds
pscxlt: folds
ColdFish: folds
AladeenMF: folds
AAdem: calls 0.01
HailToTheKing: raises 0.06 to 0.08
AAdem: folds
HailToTheKing collected 0.10 from pot
HailToTheKing: doesn't show hand
*** SUMMARY ***
Total pot 0.10 | Rake 0.00
Board [ ]
Game ended: 2025/09/03 22:25:18 GMT
Seat 1: AladeenMF (button) folded before Flop (didn't bet)
Seat 2: AAdem (small blind) folded before Flop
Seat 3: HailToTheKing (big blind) collected (0.10)
Seat 4: kanococo folded before Flop (didn't bet)
Seat 5: pscxlt folded before Flop (didn't bet)
Seat 6: Aceinthehole folded before Flop (didn't bet)
Seat 7: ColdFish folded before Flop (didn't bet)

CoinPoker Hand #291721485: Hold'em No Limit (0.01/0.02 ) 2025/09/03 22:25:20 GMT
Table 'NL ₮2 III' 7-max Seat #2 is the button
Seat 1: AladeenMF (3.25 in chips)
Seat 2: AAdem (1.15 in chips)
Seat 3: HailToTheKing (2.79 in chips)
Seat 4: kanococo (2.49 in chips)
Seat 5: pscxlt (2.02 in chips)
Seat 6: Aceinthehole (2.49 in chips) is sitting out
Seat 7: ColdFish (2.00 in chips)
HailToTheKing: posts small blind 0.01
kanococo: posts big blind 0.02
*** HOLE CARDS ***
Dealt to kanococo [7d Kh]
pscxlt: folds
ColdFish: folds
AladeenMF: folds
AAdem: calls 0.02
HailToTheKing: folds
kanococo: checks
*** FLOP *** [8c Qs 9d]
kanococo: checks
AAdem: checks
*** TURN *** [8c Qs 9d] [7c]
kanococo: checks
AAdem: bets 0.02
kanococo: calls 0.02
*** RIVER *** [8c Qs 9d 7c] [3h]
kanococo: bets 0.09
AAdem: calls 0.09
*** SHOW DOWN ***
kanococo: shows [7d Kh] (a pair of Sevens)
AAdem: shows [9c As] (a pair of Nines)
AAdem collected 0.26 from pot
*** SUMMARY ***
Total pot 0.27 | Rake 0.01
Board [ 8c Qs 9d 7c 3h ]
Game ended: 2025/09/03 22:26:09 GMT
Seat 1: AladeenMF folded before Flop (didn't bet)
Seat 2: AAdem (button) showed [9c As] and won (0.26) with a pair of Nines
Seat 3: HailToTheKing (small blind) folded before Flop
Seat 4: kanococo (big blind) showed [7d Kh]
Seat 5: pscxlt folded before Flop (didn't bet)
Seat 6: Aceinthehole folded before Flop (didn't bet)
Seat 7: ColdFish folded before Flop (didn't bet)

CoinPoker Hand #291721820: Hold'em No Limit (0.01/0.02 ) 2025/09/03 22:26:10 GMT
Table 'NL ₮2 III' 7-max Seat #3 is the button
Seat 1: AladeenMF (3.25 in chips)
Seat 2: AAdem (1.28 in chips)
Seat 3: HailToTheKing (2.78 in chips)
Seat 4: kanococo (2.36 in chips)
Seat 5: pscxlt (2.02 in chips)
Seat 6: Aceinthehole (2.49 in chips) is sitting out
Seat 7: ColdFish (2.00 in chips)
kanococo: posts small blind 0.01
pscxlt: posts big blind 0.02
*** HOLE CARDS ***
Dealt to kanococo [8s Kh]
ColdFish: folds
AladeenMF: folds
AAdem: calls 0.02
HailToTheKing: folds
kanococo: calls 0.01
pscxlt: checks
*** FLOP *** [9d 5c Kc]
kanococo: checks
pscxlt: bets 0.03
AAdem: calls 0.03
kanococo: raises 0.03 to 0.06
pscxlt: folds
AAdem: calls 0.03
*** TURN *** [9d 5c Kc] [7h]
kanococo: bets 0.10
AAdem: calls 0.10
*** RIVER *** [9d 5c Kc 7h] [Kd]
kanococo: bets 0.39
AAdem: calls 0.39
*** SHOW DOWN ***
kanococo: shows [8s Kh] (three of kind, Kings)
AAdem: shows [Ks Jd] (three of kind, Kings)
AAdem collected 1.13 from pot
*** SUMMARY ***
Total pot 1.19 | Rake 0.06
Board [ 9d 5c Kc 7h Kd ]
Game ended: 2025/09/03 22:27:18 GMT
Seat 1: AladeenMF folded before Flop (didn't bet)
Seat 2: AAdem showed [Ks Jd] and won (1.13) with three of kind, Kings
Seat 3: HailToTheKing (button) folded before Flop (didn't bet)
Seat 4: kanococo (small blind) showed [8s Kh]
Seat 5: pscxlt (big blind) folded on the Flop
Seat 6: Aceinthehole folded before Flop (didn't bet)
Seat 7: ColdFish folded before Flop (didn't bet)

CoinPoker Hand #291722269: Hold'em No Limit (0.01/0.02 ) 2025/09/03 22:27:20 GMT
Table 'NL ₮2 III' 7-max Seat #4 is the button
Seat 1: AladeenMF (3.25 in chips)
Seat 2: AAdem (1.84 in chips)
Seat 3: HailToTheKing (2.78 in chips)
Seat 4: kanococo (1.79 in chips)
Seat 5: pscxlt (1.97 in chips)
Seat 6: Aceinthehole (2.49 in chips) is sitting out
Seat 7: ColdFish (2.00 in chips)
pscxlt: posts small blind 0.01
ColdFish: posts big blind 0.02
*** HOLE CARDS ***
Dealt to kanococo [5d 3s]
AladeenMF: folds
AAdem: calls 0.02
HailToTheKing: folds
kanococo: folds
pscxlt: raises 0.06 to 0.08
ColdFish: folds
AAdem: calls 0.06
*** FLOP *** [4d 7h Kc]
pscxlt: bets 0.06
AAdem: folds
Uncalled bet (0.06) returned to pscxlt
pscxlt collected 0.17 from pot
pscxlt: doesn't show hand
*** SUMMARY ***
Total pot 0.18 | Rake 0.01
Board [ 4d 7h Kc ]
Game ended: 2025/09/03 22:28:03 GMT
Seat 1: AladeenMF folded before Flop (didn't bet)
Seat 2: AAdem folded on the Flop
Seat 3: HailToTheKing folded before Flop (didn't bet)
Seat 4: kanococo (button) folded before Flop (didn't bet)
Seat 5: pscxlt (small blind) collected (0.17)
Seat 6: Aceinthehole folded before Flop (didn't bet)
Seat 7: ColdFish (big blind) folded before Flop

CoinPoker Hand #291722501: Hold'em No Limit (0.01/0.02 ) 2025/09/03 22:28:05 GMT
Table 'NL ₮2 III' 7-max Seat #5 is the button
Seat 1: AladeenMF (3.25 in chips)
Seat 2: AAdem (1.76 in chips)
Seat 3: HailToTheKing (2.78 in chips)
Seat 4: kanococo (1.79 in chips)
Seat 5: pscxlt (2.06 in chips)
Seat 6: Aceinthehole (2.49 in chips) is sitting out
Seat 7: ColdFish (1.98 in chips)
ColdFish: posts small blind 0.01
AladeenMF: posts big blind 0.02
*** HOLE CARDS ***
Dealt to kanococo [6h 6d]
AAdem: folds
HailToTheKing: folds
kanococo: raises 0.04 to 0.06
pscxlt: folds
ColdFish: calls 0.05
AladeenMF: calls 0.04
*** FLOP *** [Qd 8c 6s]
ColdFish: checks
AladeenMF: checks
kanococo: bets 0.08
ColdFish: calls 0.08
AladeenMF: calls 0.08
*** TURN *** [Qd 8c 6s] [Qc]
ColdFish: checks
AladeenMF: bets 0.16
kanococo: raises 0.36 to 0.52
ColdFish: folds
AladeenMF: calls 0.36
*** RIVER *** [Qd 8c 6s Qc] [Qh]
AladeenMF: checks
kanococo: checks
*** SHOW DOWN ***
AladeenMF: shows [5d 7s] (three of kind, Queens)
kanococo: shows [6h 6d] (a full house, Queens over Sixes)
kanococo collected 1.39 from pot
*** SUMMARY ***
Total pot 1.46 | Rake 0.07
Board [ Qd 8c 6s Qc Qh ]
Game ended: 2025/09/03 22:29:08 GMT
Seat 1: AladeenMF (big blind) showed [5d 7s]
Seat 2: AAdem folded before Flop (didn't bet)
Seat 3: HailToTheKing folded before Flop (didn't bet)
Seat 4: kanococo showed [6h 6d] and won (1.39) with a full house, Queens over Sixes
Seat 5: pscxlt (button) folded before Flop (didn't bet)
Seat 6: Aceinthehole folded before Flop (didn't bet)
Seat 7: ColdFish (small blind) folded on the Turn

CoinPoker Hand #291722869: Hold'em No Limit (0.01/0.02 ) 2025/09/03 22:29:10 GMT
Table 'NL ₮2 III' 7-max Seat #7 is the button
Seat 1: AladeenMF (2.59 in chips)
Seat 2: AAdem (1.76 in chips)
Seat 3: HailToTheKing (2.78 in chips)
Seat 4: kanococo (2.52 in chips)
Seat 5: pscxlt (2.06 in chips)
Seat 6: Aceinthehole (2.49 in chips) out of hand
Seat 7: ColdFish (2.00 in chips)
AladeenMF: posts small blind 0.01
AAdem: posts big blind 0.02
*** HOLE CARDS ***
Dealt to kanococo [Qc As]
HailToTheKing: folds
kanococo: raises 0.04 to 0.06
pscxlt: folds
ColdFish: folds
AladeenMF: folds
AAdem: folds
kanococo collected 0.09 from pot
kanococo: doesn't show hand
*** SUMMARY ***
Total pot 0.09 | Rake 0.00
Board [ ]
Game ended: 2025/09/03 22:29:40 GMT
Seat 1: AladeenMF (small blind) folded before Flop
Seat 2: AAdem (big blind) folded before Flop
Seat 3: HailToTheKing folded before Flop (didn't bet)
Seat 4: kanococo collected (0.09)
Seat 5: pscxlt folded before Flop (didn't bet)
Seat 6: Aceinthehole folded before Flop (didn't bet)
Seat 7: ColdFish (button) folded before Flop (didn't bet)

CoinPoker Hand #291723030: Hold'em No Limit (0.01/0.02 ) 2025/09/03 22:29:42 GMT
Table 'NL ₮2 III' 7-max Seat #1 is the button
Seat 1: AladeenMF (2.58 in chips)
Seat 2: AAdem (1.74 in chips)
Seat 3: HailToTheKing (2.78 in chips)
Seat 4: kanococo (2.55 in chips)
Seat 5: pscxlt (2.06 in chips)
Seat 6: Aceinthehole (2.49 in chips) out of hand
Seat 7: ColdFish (2.00 in chips)
AAdem: posts small blind 0.01
HailToTheKing: posts big blind 0.02
*** HOLE CARDS ***
Dealt to kanococo [Ad 2h]
kanococo: calls 0.02
pscxlt: folds
ColdFish: raises 0.06 to 0.08
AladeenMF: folds
AAdem: folds
HailToTheKing: raises 0.12 to 0.20
kanococo: folds
ColdFish: calls 0.12
*** FLOP *** [6c 7d Ts]
HailToTheKing: bets 0.20
ColdFish: folds
Uncalled bet (0.20) returned to HailToTheKing
HailToTheKing collected 0.41 from pot
HailToTheKing: doesn't show hand
*** SUMMARY ***
Total pot 0.43 | Rake 0.02
Board [ 6c 7d Ts ]
Game ended: 2025/09/03 22:30:40 GMT
Seat 1: AladeenMF (button) folded before Flop (didn't bet)
Seat 2: AAdem (small blind) folded before Flop
Seat 3: HailToTheKing (big blind) collected (0.41)
Seat 4: kanococo folded before Flop
Seat 5: pscxlt folded before Flop (didn't bet)
Seat 6: Aceinthehole folded before Flop (didn't bet)
Seat 7: ColdFish folded on the Flop

CoinPoker Hand #291723366: Hold'em No Limit (0.01/0.02 ) 2025/09/03 22:30:41 GMT
Table 'NL ₮2 III' 7-max Seat #2 is the button
Seat 1: AladeenMF (2.58 in chips)
Seat 2: AAdem (1.73 in chips)
Seat 3: HailToTheKing (2.99 in chips)
Seat 4: kanococo (2.53 in chips)
Seat 5: pscxlt (2.06 in chips)
Seat 6: Aceinthehole (2.49 in chips) out of hand
Seat 7: ColdFish (2.00 in chips)
HailToTheKing: posts small blind 0.01
kanococo: posts big blind 0.02
*** HOLE CARDS ***
Dealt to kanococo [Th 3s]
pscxlt: folds
ColdFish: raises 0.04 to 0.06
AladeenMF: folds
AAdem: folds
HailToTheKing: folds
kanococo: calls 0.04
*** FLOP *** [7c Qs 3d]
kanococo: checks
ColdFish: bets 0.08
kanococo: calls 0.08
*** TURN *** [7c Qs 3d] [3c]
kanococo: checks
ColdFish: bets 0.18
kanococo: calls 0.18
*** RIVER *** [7c Qs 3d 3c] [Kc]
kanococo: bets 0.62
ColdFish: folds
Uncalled bet (0.62) returned to kanococo
kanococo collected 0.62 from pot
kanococo: doesn't show hand
*** SUMMARY ***
Total pot 0.65 | Rake 0.03
Board [ 7c Qs 3d 3c Kc ]
Game ended: 2025/09/03 22:31:44 GMT
Seat 1: AladeenMF folded before Flop (didn't bet)
Seat 2: AAdem (button) folded before Flop (didn't bet)
Seat 3: HailToTheKing (small blind) folded before Flop
Seat 4: kanococo (big blind) collected (0.62)
Seat 5: pscxlt folded before Flop (didn't bet)
Seat 6: Aceinthehole folded before Flop (didn't bet)
Seat 7: ColdFish folded on the River

CoinPoker Hand #291723710: Hold'em No Limit (0.01/0.02 ) 2025/09/03 22:31:46 GMT
Table 'NL ₮2 III' 7-max Seat #3 is the button
Seat 1: AladeenMF (2.58 in chips)
Seat 2: AAdem (1.73 in chips)
Seat 3: HailToTheKing (2.98 in chips)
Seat 4: kanococo (2.83 in chips)
Seat 5: pscxlt (2.06 in chips)
Seat 6: Aceinthehole (2.49 in chips) out of hand
Seat 7: ColdFish (2.00 in chips)
kanococo: posts small blind 0.01
pscxlt: posts big blind 0.02
*** HOLE CARDS ***
Dealt to kanococo [Ac Ts]
ColdFish: folds
AladeenMF: folds
AAdem: folds
HailToTheKing: raises 0.04 to 0.06
kanococo: calls 0.05
pscxlt: calls 0.04
*** FLOP *** [9h 4c Kh]
kanococo: bets 0.04
pscxlt: calls 0.04
HailToTheKing: folds
*** TURN *** [9h 4c Kh] [8h]
kanococo: checks
pscxlt: checks
*** RIVER *** [9h 4c Kh 8h] [4h]
kanococo: checks
pscxlt: checks
*** SHOW DOWN ***
kanococo: shows [Ac Ts] (a pair of Fours)
pscxlt: shows [3d Kd] (two pairs, Kings and Fours)
pscxlt collected 0.25 from pot
*** SUMMARY ***
Total pot 0.26 | Rake 0.01
Board [ 9h 4c Kh 8h 4h ]
Game ended: 2025/09/03 22:32:51 GMT
Seat 1: AladeenMF folded before Flop (didn't bet)
Seat 2: AAdem folded before Flop (didn't bet)
Seat 3: HailToTheKing (button) folded on the Flop
Seat 4: kanococo (small blind) showed [Ac Ts]
Seat 5: pscxlt (big blind) showed [3d Kd] and won (0.25) with two pairs, Kings and Fours
Seat 6: Aceinthehole folded before Flop (didn't bet)
Seat 7: ColdFish folded before Flop (didn't bet)

CoinPoker Hand #291724055: Hold'em No Limit (0.01/0.02 ) 2025/09/03 22:32:54 GMT
Table 'NL ₮2 III' 7-max Seat #4 is the button
Seat 1: AladeenMF (2.58 in chips)
Seat 2: AAdem (1.73 in chips)
Seat 3: HailToTheKing (2.92 in chips)
Seat 4: kanococo (2.73 in chips)
Seat 5: pscxlt (2.21 in chips)
Seat 6: Aceinthehole (2.49 in chips)
Seat 7: ColdFish (2.00 in chips)
pscxlt: posts small blind 0.01
Aceinthehole: posts big blind 0.02
*** HOLE CARDS ***
Dealt to kanococo [9d Kc]
ColdFish: folds
AladeenMF: folds
AAdem: folds
HailToTheKing: folds
kanococo: raises 0.04 to 0.06
pscxlt: folds
Aceinthehole: folds
kanococo collected 0.09 from pot
kanococo: doesn't show hand
*** SUMMARY ***
Total pot 0.09 | Rake 0.00
Board [ ]
Game ended: 2025/09/03 22:33:22 GMT
Seat 1: AladeenMF folded before Flop (didn't bet)
Seat 2: AAdem folded before Flop (didn't bet)
Seat 3: HailToTheKing folded before Flop (didn't bet)
Seat 4: kanococo (button) collected (0.09)
Seat 5: pscxlt (small blind) folded before Flop
Seat 6: Aceinthehole (big blind) folded before Flop
Seat 7: ColdFish folded before Flop (didn't bet)

CoinPoker Hand #291724225: Hold'em No Limit (0.01/0.02 ) 2025/09/03 22:33:25 GMT
Table 'NL ₮2 III' 7-max Seat #5 is the button
Seat 1: AladeenMF (2.58 in chips)
Seat 2: AAdem (1.73 in chips)
Seat 3: HailToTheKing (2.92 in chips)
Seat 4: kanococo (2.76 in chips)
Seat 5: pscxlt (2.20 in chips)
Seat 6: Aceinthehole (2.47 in chips)
Seat 7: ColdFish (2.00 in chips)
Aceinthehole: posts small blind 0.01
ColdFish: posts big blind 0.02
*** HOLE CARDS ***
Dealt to kanococo [5c 3s]
AladeenMF: folds
AAdem: folds
HailToTheKing: folds
kanococo: folds
pscxlt: raises 0.03 to 0.05
Aceinthehole: folds
ColdFish: folds
pscxlt collected 0.08 from pot
pscxlt: doesn't show hand
*** SUMMARY ***
Total pot 0.08 | Rake 0.00
Board [ ]
Game ended: 2025/09/03 22:33:54 GMT
Seat 1: AladeenMF folded before Flop (didn't bet)
Seat 2: AAdem folded before Flop (didn't bet)
Seat 3: HailToTheKing folded before Flop (didn't bet)
Seat 4: kanococo folded before Flop (didn't bet)
Seat 5: pscxlt (button) collected (0.08)
Seat 6: Aceinthehole (small blind) folded before Flop
Seat 7: ColdFish (big blind) folded before Flop

CoinPoker Hand #291724478: Hold'em No Limit (0.01/0.02 ) 2025/09/03 22:33:56 GMT
Table 'NL ₮2 III' 7-max Seat #6 is the button
Seat 1: AladeenMF (2.58 in chips)
Seat 2: AAdem (1.73 in chips)
Seat 3: HailToTheKing (2.92 in chips)
Seat 4: kanococo (2.76 in chips)
Seat 5: pscxlt (2.23 in chips)
Seat 6: Aceinthehole (2.46 in chips)
Seat 7: ColdFish (2.00 in chips)
ColdFish: posts small blind 0.01
AladeenMF: posts big blind 0.02
*** HOLE CARDS ***
Dealt to kanococo [9h 8d]
AAdem: calls 0.02
HailToTheKing: folds
kanococo: folds
pscxlt: raises 0.06 to 0.08
Aceinthehole: folds
ColdFish: folds
AladeenMF: folds
AAdem: folds
pscxlt collected 0.13 from pot
pscxlt: doesn't show hand
*** SUMMARY ***
Total pot 0.13 | Rake 0.00
Board [ ]
Game ended: 2025/09/03 22:34:25 GMT
Seat 1: AladeenMF (big blind) folded before Flop
Seat 2: AAdem folded before Flop
Seat 3: HailToTheKing folded before Flop (didn't bet)
Seat 4: kanococo folded before Flop (didn't bet)
Seat 5: pscxlt collected (0.13)
Seat 6: Aceinthehole (button) folded before Flop (didn't bet)
Seat 7: ColdFish (small blind) folded before Flop

CoinPoker Hand #291724657: Hold'em No Limit (0.01/0.02 ) 2025/09/03 22:34:27 GMT
Table 'NL ₮2 III' 7-max Seat #7 is the button
Seat 1: AladeenMF (2.56 in chips)
Seat 2: AAdem (1.71 in chips)
Seat 3: HailToTheKing (2.92 in chips)
Seat 4: kanococo (2.76 in chips)
Seat 5: pscxlt (2.28 in chips)
Seat 6: Aceinthehole (2.46 in chips)
Seat 7: ColdFish (1.99 in chips)
AladeenMF: posts small blind 0.01
AAdem: posts big blind 0.02
*** HOLE CARDS ***
Dealt to kanococo [Td 4s]
HailToTheKing: raises 0.03 to 0.05
kanococo: folds
pscxlt: folds
Aceinthehole: folds
ColdFish: folds
AladeenMF: folds
AAdem: calls 0.03
*** FLOP *** [9c 3c Jh]
AAdem: checks
HailToTheKing: checks
*** TURN *** [9c 3c Jh] [8h]
AAdem: checks
HailToTheKing: checks
*** RIVER *** [9c 3c Jh 8h] [As]
AAdem: checks
HailToTheKing: bets 0.06
AAdem: folds
Uncalled bet (0.06) returned to HailToTheKing
HailToTheKing collected 0.10 from pot
HailToTheKing: doesn't show hand
*** SUMMARY ***
Total pot 0.11 | Rake 0.01
Board [ 9c 3c Jh 8h As ]
Game ended: 2025/09/03 22:35:33 GMT
Seat 1: AladeenMF (small blind) folded before Flop
Seat 2: AAdem (big blind) folded on the River
Seat 3: HailToTheKing collected (0.10)
Seat 4: kanococo folded before Flop (didn't bet)
Seat 5: pscxlt folded before Flop (didn't bet)
Seat 6: Aceinthehole folded before Flop (didn't bet)
Seat 7: ColdFish (button) folded before Flop (didn't bet)

CoinPoker Hand #291725088: Hold'em No Limit (0.01/0.02 ) 2025/09/03 22:35:35 GMT
Table 'NL ₮2 III' 7-max Seat #1 is the button
Seat 1: AladeenMF (2.55 in chips)
Seat 2: AAdem (1.66 in chips)
Seat 3: HailToTheKing (2.97 in chips)
Seat 4: kanococo (2.76 in chips)
Seat 5: pscxlt (2.28 in chips)
Seat 6: Aceinthehole (2.46 in chips)
Seat 7: ColdFish (2.00 in chips)
AAdem: posts small blind 0.01
HailToTheKing: posts big blind 0.02
*** HOLE CARDS ***
Dealt to kanococo [7c Ts]
kanococo: folds
pscxlt: folds
Aceinthehole: folds
ColdFish: folds
AladeenMF: folds
AAdem: folds
HailToTheKing collected 0.03 from pot
HailToTheKing: doesn't show hand
*** SUMMARY ***
Total pot 0.03 | Rake 0.00
Board [ ]
Game ended: 2025/09/03 22:35:52 GMT
Seat 1: AladeenMF (button) folded before Flop (didn't bet)
Seat 2: AAdem (small blind) folded before Flop
Seat 3: HailToTheKing (big blind) collected (0.03)
Seat 4: kanococo folded before Flop (didn't bet)
Seat 5: pscxlt folded before Flop (didn't bet)
Seat 6: Aceinthehole folded before Flop (didn't bet)
Seat 7: ColdFish folded before Flop (didn't bet)

CoinPoker Hand #291725167: Hold'em No Limit (0.01/0.02 ) 2025/09/03 22:35:55 GMT
Table 'NL ₮2 III' 7-max Seat #2 is the button
Seat 1: AladeenMF (2.55 in chips)
Seat 2: AAdem (1.65 in chips)
Seat 3: HailToTheKing (2.98 in chips)
Seat 4: kanococo (2.76 in chips)
Seat 5: pscxlt (2.28 in chips)
Seat 6: Aceinthehole (2.46 in chips)
Seat 7: ColdFish (2.00 in chips)
HailToTheKing: posts small blind 0.01
kanococo: posts big blind 0.02
*** HOLE CARDS ***
Dealt to kanococo [6s Jc]
pscxlt: folds
Aceinthehole: folds
ColdFish: folds
AladeenMF: folds
AAdem: calls 0.02
HailToTheKing: folds
kanococo: checks
*** FLOP *** [Qs 4d 6c]
kanococo: bets 0.06
AAdem: calls 0.06
*** TURN *** [Qs 4d 6c] [Kd]
kanococo: checks
AAdem: checks
*** RIVER *** [Qs 4d 6c Kd] [Ah]
kanococo: bets 0.08
AAdem: folds
Uncalled bet (0.08) returned to kanococo
kanococo collected 0.16 from pot
kanococo: doesn't show hand
*** SUMMARY ***
Total pot 0.17 | Rake 0.01
Board [ Qs 4d 6c Kd Ah ]
Game ended: 2025/09/03 22:36:55 GMT
Seat 1: AladeenMF folded before Flop (didn't bet)
Seat 2: AAdem (button) folded on the River
Seat 3: HailToTheKing (small blind) folded before Flop
Seat 4: kanococo (big blind) collected (0.16)
Seat 5: pscxlt folded before Flop (didn't bet)
Seat 6: Aceinthehole folded before Flop (didn't bet)
Seat 7: ColdFish folded before Flop (didn't bet)

CoinPoker Hand #291725587: Hold'em No Limit (0.01/0.02 ) 2025/09/03 22:36:58 GMT
Table 'NL ₮2 III' 7-max Seat #3 is the button
Seat 1: AladeenMF (2.55 in chips)
Seat 2: AAdem (1.57 in chips)
Seat 3: HailToTheKing (2.97 in chips)
Seat 4: kanococo (2.84 in chips)
Seat 5: pscxlt (2.28 in chips)
Seat 6: Aceinthehole (2.46 in chips)
Seat 7: ColdFish (2.00 in chips)
kanococo: posts small blind 0.01
pscxlt: posts big blind 0.02
*** HOLE CARDS ***
Dealt to kanococo [3c 4c]
Aceinthehole: raises 0.04 to 0.06
ColdFish: folds
AladeenMF: folds
AAdem: folds
HailToTheKing: folds
kanococo: folds
pscxlt: folds
Aceinthehole collected 0.09 from pot
Aceinthehole: doesn't show hand
*** SUMMARY ***
Total pot 0.09 | Rake 0.00
Board [ ]
Game ended: 2025/09/03 22:37:29 GMT
Seat 1: AladeenMF folded before Flop (didn't bet)
Seat 2: AAdem folded before Flop (didn't bet)
Seat 3: HailToTheKing (button) folded before Flop (didn't bet)
Seat 4: kanococo (small blind) folded before Flop
Seat 5: pscxlt (big blind) folded before Flop
Seat 6: Aceinthehole collected (0.09)
Seat 7: ColdFish folded before Flop (didn't bet)

CoinPoker Hand #291725836: Hold'em No Limit (0.01/0.02 ) 2025/09/03 22:37:31 GMT
Table 'NL ₮2 III' 7-max Seat #4 is the button
Seat 1: AladeenMF (2.55 in chips)
Seat 2: AAdem (1.57 in chips)
Seat 3: HailToTheKing (2.97 in chips)
Seat 4: kanococo (2.83 in chips)
Seat 5: pscxlt (2.26 in chips)
Seat 6: Aceinthehole (2.49 in chips)
Seat 7: ColdFish (2.00 in chips)
pscxlt: posts small blind 0.01
Aceinthehole: posts big blind 0.02
*** HOLE CARDS ***
Dealt to kanococo [5c 2h]
ColdFish: folds
AladeenMF: folds
AAdem: calls 0.02
HailToTheKing: folds
kanococo: folds
pscxlt: calls 0.01
Aceinthehole: checks
*** FLOP *** [3c 6s 9c]
pscxlt: checks
Aceinthehole: checks
AAdem: checks
*** TURN *** [3c 6s 9c] [6d]
pscxlt: checks
Aceinthehole: checks
AAdem: checks
*** RIVER *** [3c 6s 9c 6d] [Kh]
pscxlt: checks
Aceinthehole: checks
AAdem: checks
*** SHOW DOWN ***
pscxlt: shows [9s 7s] (two pairs, Nines and Sixes)
Aceinthehole: mucks hand
AAdem: mucks hand
pscxlt collected 0.06 from pot
*** SUMMARY ***
Total pot 0.06 | Rake 0.00
Board [ 3c 6s 9c 6d Kh ]
Game ended: 2025/09/03 22:38:28 GMT
Seat 1: AladeenMF folded before Flop (didn't bet)
Seat 2: AAdem mucked
Seat 3: HailToTheKing folded before Flop (didn't bet)
Seat 4: kanococo (button) folded before Flop (didn't bet)
Seat 5: pscxlt (small blind) showed [9s 7s] and won (0.06) with two pairs, Nines and Sixes
Seat 6: Aceinthehole (big blind) mucked
Seat 7: ColdFish folded before Flop (didn't bet)

CoinPoker Hand #291726221: Hold'em No Limit (0.01/0.02 ) 2025/09/03 22:38:30 GMT
Table 'NL ₮2 III' 7-max Seat #5 is the button
Seat 1: AladeenMF (2.55 in chips)
Seat 2: AAdem (1.55 in chips)
Seat 3: HailToTheKing (2.97 in chips)
Seat 4: kanococo (2.83 in chips)
Seat 5: pscxlt (2.30 in chips)
Seat 6: Aceinthehole (2.47 in chips)
Seat 7: ColdFish (2.00 in chips)
Aceinthehole: posts small blind 0.01
ColdFish: posts big blind 0.02
*** HOLE CARDS ***
Dealt to kanococo [Ts 3c]
AladeenMF: folds
AAdem: folds
HailToTheKing: raises 0.04 to 0.06
kanococo: folds
pscxlt: folds
Aceinthehole: folds
ColdFish: folds
HailToTheKing collected 0.09 from pot
HailToTheKing: doesn't show hand
*** SUMMARY ***
Total pot 0.09 | Rake 0.00
Board [ ]
Game ended: 2025/09/03 22:38:55 GMT
Seat 1: AladeenMF folded before Flop (didn't bet)
Seat 2: AAdem folded before Flop (didn't bet)
Seat 3: HailToTheKing collected (0.09)
Seat 4: kanococo folded before Flop (didn't bet)
Seat 5: pscxlt (button) folded before Flop (didn't bet)
Seat 6: Aceinthehole (small blind) folded before Flop
Seat 7: ColdFish (big blind) folded before Flop

CoinPoker Hand #291726388: Hold'em No Limit (0.01/0.02 ) 2025/09/03 22:38:57 GMT
Table 'NL ₮2 III' 7-max Seat #6 is the button
Seat 1: AladeenMF (2.55 in chips)
Seat 2: AAdem (1.55 in chips)
Seat 3: HailToTheKing (3.00 in chips)
Seat 4: kanococo (2.83 in chips)
Seat 5: pscxlt (2.30 in chips)
Seat 6: Aceinthehole (2.46 in chips)
Seat 7: ColdFish (2.00 in chips)
ColdFish: posts small blind 0.01
AladeenMF: posts big blind 0.02
*** HOLE CARDS ***
Dealt to kanococo [Qs Tc]
AAdem: folds
HailToTheKing: raises 0.02 to 0.04
kanococo: calls 0.04
pscxlt: folds
Aceinthehole: calls 0.04
ColdFish: folds
AladeenMF: folds
*** FLOP *** [Ac 3d 4d]
HailToTheKing: checks
kanococo: bets 0.07
Aceinthehole: folds
HailToTheKing: calls 0.07
*** TURN *** [Ac 3d 4d] [Qd]
HailToTheKing: checks
kanococo: checks
*** RIVER *** [Ac 3d 4d Qd] [Ts]
HailToTheKing: checks
kanococo: bets 0.14
HailToTheKing: folds
Uncalled bet (0.14) returned to kanococo
kanococo collected 0.28 from pot
kanococo: doesn't show hand
*** SUMMARY ***
Total pot 0.29 | Rake 0.01
Board [ Ac 3d 4d Qd Ts ]
Game ended: 2025/09/03 22:40:01 GMT
Seat 1: AladeenMF (big blind) folded before Flop
Seat 2: AAdem folded before Flop (didn't bet)
Seat 3: HailToTheKing folded on the River
Seat 4: kanococo collected (0.28)
Seat 5: pscxlt folded before Flop (didn't bet)
Seat 6: Aceinthehole (button) folded on the Flop
Seat 7: ColdFish (small blind) folded before Flop

CoinPoker Hand #291726870: Hold'em No Limit (0.01/0.02 ) 2025/09/03 22:40:03 GMT
Table 'NL ₮2 III' 7-max Seat #7 is the button
Seat 1: AladeenMF (2.53 in chips)
Seat 2: AAdem (1.55 in chips)
Seat 3: HailToTheKing (2.89 in chips)
Seat 4: kanococo (3.00 in chips)
Seat 5: pscxlt (2.30 in chips)
Seat 6: Aceinthehole (2.42 in chips)
Seat 7: ColdFish (2.00 in chips)
AladeenMF: posts small blind 0.01
AAdem: posts big blind 0.02
*** HOLE CARDS ***
Dealt to kanococo [3s 6s]
HailToTheKing: folds
kanococo: folds
pscxlt: raises 0.03 to 0.05
Aceinthehole: calls 0.05
ColdFish: folds
AladeenMF: folds
AAdem: calls 0.03
*** FLOP *** [7d 9h 2d]
AAdem: checks
pscxlt: checks
Aceinthehole: checks
*** TURN *** [7d 9h 2d] [Kd]
AAdem: checks
pscxlt: bets 0.07
Aceinthehole: calls 0.07
AAdem: calls 0.07
*** RIVER *** [7d 9h 2d Kd] [5s]
AAdem: checks
pscxlt: checks
Aceinthehole: bets 0.24
AAdem: folds
pscxlt: folds
Uncalled bet (0.24) returned to Aceinthehole
Aceinthehole collected 0.35 from pot
Aceinthehole: doesn't show hand
*** SUMMARY ***
Total pot 0.37 | Rake 0.02
Board [ 7d 9h 2d Kd 5s ]
Game ended: 2025/09/03 22:41:37 GMT
Seat 1: AladeenMF (small blind) folded before Flop
Seat 2: AAdem (big blind) folded on the River
Seat 3: HailToTheKing folded before Flop (didn't bet)
Seat 4: kanococo folded before Flop (didn't bet)
Seat 5: pscxlt folded on the River
Seat 6: Aceinthehole collected (0.35)
Seat 7: ColdFish (button) folded before Flop (didn't bet)

CoinPoker Hand #291727573: Hold'em No Limit (0.01/0.02 ) 2025/09/03 22:41:39 GMT
Table 'NL ₮2 III' 7-max Seat #1 is the button
Seat 1: AladeenMF (2.52 in chips)
Seat 2: AAdem (1.43 in chips)
Seat 3: HailToTheKing (2.89 in chips)
Seat 4: kanococo (3.00 in chips)
Seat 5: pscxlt (2.18 in chips)
Seat 6: Aceinthehole (2.65 in chips)
Seat 7: ColdFish (2.00 in chips)
AAdem: posts small blind 0.01
HailToTheKing: posts big blind 0.02
*** HOLE CARDS ***
Dealt to kanococo [Ah 6h]
kanococo: raises 0.02 to 0.04
pscxlt: folds
Aceinthehole: folds
ColdFish: folds
AladeenMF: folds
AAdem: calls 0.03
HailToTheKing: calls 0.02
*** FLOP *** [7s 3c 9h]
AAdem: checks
HailToTheKing: checks
kanococo: checks
*** TURN *** [7s 3c 9h] [4h]
AAdem: checks
HailToTheKing: checks
kanococo: checks
*** RIVER *** [7s 3c 9h 4h] [Kc]
AAdem: checks
HailToTheKing: checks
kanococo: checks
*** SHOW DOWN ***
AAdem: shows [Qs Jc] (King high)
HailToTheKing: shows [3s 5s] (a pair of Threes)
kanococo: mucks hand
HailToTheKing collected 0.11 from pot
*** SUMMARY ***
Total pot 0.12 | Rake 0.01
Board [ 7s 3c 9h 4h Kc ]
Game ended: 2025/09/03 22:43:08 GMT
Seat 1: AladeenMF (button) folded before Flop (didn't bet)
Seat 2: AAdem (small blind) showed [Qs Jc]
Seat 3: HailToTheKing (big blind) showed [3s 5s] and won (0.11) with a pair of Threes
Seat 4: kanococo mucked
Seat 5: pscxlt folded before Flop (didn't bet)
Seat 6: Aceinthehole folded before Flop (didn't bet)
Seat 7: ColdFish folded before Flop (didn't bet)

CoinPoker Hand #291728026: Hold'em No Limit (0.01/0.02 ) 2025/09/03 22:43:10 GMT
Table 'NL ₮2 III' 7-max Seat #2 is the button
Seat 1: AladeenMF (2.52 in chips)
Seat 2: AAdem (1.39 in chips)
Seat 3: HailToTheKing (2.96 in chips)
Seat 4: kanococo (2.96 in chips)
Seat 5: pscxlt (2.18 in chips)
Seat 6: Aceinthehole (2.65 in chips)
Seat 7: ColdFish (2.00 in chips)
HailToTheKing: posts small blind 0.01
kanococo: posts big blind 0.02
*** HOLE CARDS ***
Dealt to kanococo [As 5d]
pscxlt: folds
Aceinthehole: folds
ColdFish: folds
AladeenMF: folds
AAdem: folds
HailToTheKing: folds
kanococo collected 0.03 from pot
kanococo: doesn't show hand
*** SUMMARY ***
Total pot 0.03 | Rake 0.00
Board [ ]
Game ended: 2025/09/03 22:43:23 GMT
Seat 1: AladeenMF folded before Flop (didn't bet)
Seat 2: AAdem (button) folded before Flop (didn't bet)
Seat 3: HailToTheKing (small blind) folded before Flop
Seat 4: kanococo (big blind) collected (0.03)
Seat 5: pscxlt folded before Flop (didn't bet)
Seat 6: Aceinthehole folded before Flop (didn't bet)
Seat 7: ColdFish folded before Flop (didn't bet)

CoinPoker Hand #291728076: Hold'em No Limit (0.01/0.02 ) 2025/09/03 22:43:25 GMT
Table 'NL ₮2 III' 7-max Seat #3 is the button
Seat 1: AladeenMF (2.52 in chips)
Seat 2: AAdem (1.39 in chips)
Seat 3: HailToTheKing (2.95 in chips)
Seat 4: kanococo (2.97 in chips)
Seat 5: pscxlt (2.18 in chips)
Seat 6: Aceinthehole (2.65 in chips)
Seat 7: ColdFish (2.00 in chips)
kanococo: posts small blind 0.01
pscxlt: posts big blind 0.02
*** HOLE CARDS ***
Dealt to kanococo [4s Tc]
Aceinthehole: folds
ColdFish: folds
AladeenMF: raises 0.04 to 0.06
AAdem: calls 0.06
HailToTheKing: folds
kanococo: folds
pscxlt: calls 0.04
*** FLOP *** [4h Jc Ac]
pscxlt: checks
AladeenMF: bets 0.04
AAdem: folds
pscxlt: calls 0.04
*** TURN *** [4h Jc Ac] [5c]
pscxlt: checks
AladeenMF: checks
*** RIVER *** [4h Jc Ac 5c] [As]
pscxlt: bets 0.06
AladeenMF: folds
Uncalled bet (0.06) returned to pscxlt
pscxlt collected 0.26 from pot
pscxlt: doesn't show hand
*** SUMMARY ***
Total pot 0.27 | Rake 0.01
Board [ 4h Jc Ac 5c As ]
Game ended: 2025/09/03 22:44:26 GMT
Seat 1: AladeenMF folded on the River
Seat 2: AAdem folded on the Flop
Seat 3: HailToTheKing (button) folded before Flop (didn't bet)
Seat 4: kanococo (small blind) folded before Flop
Seat 5: pscxlt (big blind) collected (0.26)
Seat 6: Aceinthehole folded before Flop (didn't bet)
Seat 7: ColdFish folded before Flop (didn't bet)

CoinPoker Hand #291728507: Hold'em No Limit (0.01/0.02 ) 2025/09/03 22:44:28 GMT
Table 'NL ₮2 III' 7-max Seat #4 is the button
Seat 1: AladeenMF (2.42 in chips)
Seat 2: AAdem (1.33 in chips)
Seat 3: HailToTheKing (2.95 in chips)
Seat 4: kanococo (2.96 in chips)
Seat 5: pscxlt (2.34 in chips)
Seat 6: Aceinthehole (2.65 in chips)
Seat 7: ColdFish (2.00 in chips)
pscxlt: posts small blind 0.01
Aceinthehole: posts big blind 0.02
*** HOLE CARDS ***
Dealt to kanococo [7c 6c]
ColdFish: folds
AladeenMF: folds
AAdem: calls 0.02
HailToTheKing: folds
HailToTheKing is disconnected
HailToTheKing has reconnected
kanococo: folds
pscxlt: calls 0.01
Aceinthehole: checks
*** FLOP *** [9s Kc Th]
pscxlt: checks
Aceinthehole: checks
Aceinthehole is disconnected
AAdem: checks
Aceinthehole has reconnected
*** TURN *** [9s Kc Th] [5h]
pscxlt: checks
Aceinthehole: checks
AAdem: checks
*** RIVER *** [9s Kc Th 5h] [Qh]
pscxlt: checks
Aceinthehole: checks
AAdem: checks
*** SHOW DOWN ***
pscxlt: shows [4c 4d] (a pair of Fours)
Aceinthehole: mucks hand
AAdem: mucks hand
pscxlt collected 0.06 from pot
*** SUMMARY ***
Total pot 0.06 | Rake 0.00
Board [ 9s Kc Th 5h Qh ]
Game ended: 2025/09/03 22:45:28 GMT
Seat 1: AladeenMF folded before Flop (didn't bet)
Seat 2: AAdem mucked
Seat 3: HailToTheKing folded before Flop (didn't bet)
Seat 4: kanococo (button) folded before Flop (didn't bet)
Seat 5: pscxlt (small blind) showed [4c 4d] and won (0.06) with a pair of Fours
Seat 6: Aceinthehole (big blind) mucked
Seat 7: ColdFish folded before Flop (didn't bet)

CoinPoker Hand #291729037: Hold'em No Limit (0.01/0.02 ) 2025/09/03 22:45:30 GMT
Table 'NL ₮2 III' 7-max Seat #5 is the button
Seat 1: AladeenMF (2.42 in chips)
Seat 2: AAdem (1.31 in chips)
Seat 3: HailToTheKing (2.95 in chips)
Seat 4: kanococo (2.96 in chips)
Seat 5: pscxlt (2.38 in chips)
Seat 6: Aceinthehole (2.63 in chips)
Seat 7: ColdFish (2.00 in chips)
Aceinthehole: posts small blind 0.01
ColdFish: posts big blind 0.02
*** HOLE CARDS ***
Dealt to kanococo [Ah Tc]
AladeenMF: folds
AAdem: folds
HailToTheKing: folds
kanococo: raises 0.02 to 0.04
pscxlt: folds
Aceinthehole: folds
ColdFish: folds
kanococo collected 0.07 from pot
kanococo: doesn't show hand
*** SUMMARY ***
Total pot 0.07 | Rake 0.00
Board [ ]
Game ended: 2025/09/03 22:45:50 GMT
Seat 1: AladeenMF folded before Flop (didn't bet)
Seat 2: AAdem folded before Flop (didn't bet)
Seat 3: HailToTheKing folded before Flop (didn't bet)
Seat 4: kanococo collected (0.07)
Seat 5: pscxlt (button) folded before Flop (didn't bet)
Seat 6: Aceinthehole (small blind) folded before Flop
Seat 7: ColdFish (big blind) folded before Flop

CoinPoker Hand #291729169: Hold'em No Limit (0.01/0.02 ) 2025/09/03 22:45:52 GMT
Table 'NL ₮2 III' 7-max Seat #6 is the button
Seat 1: AladeenMF (2.42 in chips)
Seat 2: AAdem (1.31 in chips)
Seat 3: HailToTheKing (2.95 in chips)
Seat 4: kanococo (2.99 in chips)
Seat 5: pscxlt (2.38 in chips)
Seat 6: Aceinthehole (2.62 in chips)
Seat 7: ColdFish (2.00 in chips)
ColdFish: posts small blind 0.01
AladeenMF: posts big blind 0.02
*** HOLE CARDS ***
Dealt to kanococo [9s Ac]
AAdem: calls 0.02
HailToTheKing: raises 0.06 to 0.08
kanococo: folds
pscxlt: folds
Aceinthehole: folds
ColdFish: folds
AladeenMF: folds
AAdem: folds
HailToTheKing collected 0.13 from pot
HailToTheKing: doesn't show hand
*** SUMMARY ***
Total pot 0.13 | Rake 0.00
Board [ ]
Game ended: 2025/09/03 22:46:16 GMT
Seat 1: AladeenMF (big blind) folded before Flop
Seat 2: AAdem folded before Flop
Seat 3: HailToTheKing collected (0.13)
Seat 4: kanococo folded before Flop (didn't bet)
Seat 5: pscxlt folded before Flop (didn't bet)
Seat 6: Aceinthehole (button) folded before Flop (didn't bet)
Seat 7: ColdFish (small blind) folded before Flop

CoinPoker Hand #291729344: Hold'em No Limit (0.01/0.02 ) 2025/09/03 22:46:18 GMT
Table 'NL ₮2 III' 7-max Seat #7 is the button
Seat 1: AladeenMF (2.40 in chips)
Seat 2: AAdem (1.29 in chips)
Seat 3: HailToTheKing (3.00 in chips)
Seat 4: kanococo (2.99 in chips)
Seat 5: pscxlt (2.38 in chips)
Seat 6: Aceinthehole (2.62 in chips)
Seat 7: ColdFish (1.99 in chips)
AladeenMF: posts small blind 0.01
AAdem: posts big blind 0.02
*** HOLE CARDS ***
Dealt to kanococo [Qh 3h]
HailToTheKing: folds
kanococo: folds
pscxlt: raises 0.03 to 0.05
Aceinthehole: folds
ColdFish: raises 0.13 to 0.18
AladeenMF: folds
AAdem: folds
pscxlt: calls 0.13
*** FLOP *** [8c Kd 8s]
pscxlt: checks
ColdFish: bets 0.12
pscxlt: folds
Uncalled bet (0.12) returned to ColdFish
ColdFish collected 0.37 from pot
ColdFish: doesn't show hand
*** SUMMARY ***
Total pot 0.39 | Rake 0.02
Board [ 8c Kd 8s ]
Game ended: 2025/09/03 22:47:20 GMT
Seat 1: AladeenMF (small blind) folded before Flop
Seat 2: AAdem (big blind) folded before Flop
Seat 3: HailToTheKing folded before Flop (didn't bet)
Seat 4: kanococo folded before Flop (didn't bet)
Seat 5: pscxlt folded on the Flop
Seat 6: Aceinthehole folded before Flop (didn't bet)
Seat 7: ColdFish (button) collected (0.37)

CoinPoker Hand #291729648: Hold'em No Limit (0.01/0.02 ) 2025/09/03 22:47:22 GMT
Table 'NL ₮2 III' 7-max Seat #1 is the button
Seat 1: AladeenMF (2.39 in chips)
Seat 2: AAdem (1.27 in chips)
Seat 3: HailToTheKing (3.00 in chips)
Seat 4: kanococo (2.99 in chips)
Seat 5: pscxlt (2.20 in chips)
Seat 6: Aceinthehole (2.62 in chips)
Seat 7: ColdFish (2.18 in chips)
AAdem: posts small blind 0.01
HailToTheKing: posts big blind 0.02
*** HOLE CARDS ***
Dealt to kanococo [9h Ks]
kanococo: raises 0.02 to 0.04
pscxlt: folds
Aceinthehole: calls 0.04
ColdFish: folds
AladeenMF: folds
AAdem: calls 0.03
HailToTheKing: raises 0.08 to 0.12
kanococo: calls 0.08
Aceinthehole: calls 0.08
AAdem: folds
*** FLOP *** [Jh Kc 3s]
HailToTheKing: bets 0.14
kanococo: calls 0.14
Aceinthehole: calls 0.14
*** TURN *** [Jh Kc 3s] [3c]
HailToTheKing: checks
kanococo: bets 0.39
Aceinthehole: folds
HailToTheKing: folds
Uncalled bet (0.39) returned to kanococo
kanococo collected 0.78 from pot
kanococo: doesn't show hand
*** SUMMARY ***
Total pot 0.82 | Rake 0.04
Board [ Jh Kc 3s 3c ]
Game ended: 2025/09/03 22:48:24 GMT
Seat 1: AladeenMF (button) folded before Flop (didn't bet)
Seat 2: AAdem (small blind) folded before Flop
Seat 3: HailToTheKing (big blind) folded on the Turn
Seat 4: kanococo collected (0.78)
Seat 5: pscxlt folded before Flop (didn't bet)
Seat 6: Aceinthehole folded on the Turn
Seat 7: ColdFish folded before Flop (didn't bet)

CoinPoker Hand #291730048: Hold'em No Limit (0.01/0.02 ) 2025/09/03 22:48:27 GMT
Table 'NL ₮2 III' 7-max Seat #2 is the button
Seat 1: AladeenMF (2.39 in chips)
Seat 2: AAdem (1.23 in chips)
Seat 3: HailToTheKing (2.74 in chips)
Seat 4: kanococo (3.51 in chips)
Seat 5: pscxlt (2.20 in chips)
Seat 6: Aceinthehole (2.36 in chips)
Seat 7: ColdFish (2.18 in chips)
HailToTheKing: posts small blind 0.01
kanococo: posts big blind 0.02
*** HOLE CARDS ***
Dealt to kanococo [3s 3h]
pscxlt: folds
Aceinthehole: raises 0.04 to 0.06
ColdFish: folds
AladeenMF: folds
AAdem: folds
HailToTheKing: folds
kanococo: calls 0.04
*** FLOP *** [Ad 8s Ah]
kanococo: bets 0.06
Aceinthehole: raises 0.16 to 0.22
kanococo has timed out
kanococo activated time-bank (56 seconds)
kanococo: folds
Uncalled bet (0.16) returned to Aceinthehole
Aceinthehole collected 0.24 from pot
Aceinthehole: doesn't show hand
*** SUMMARY ***
Total pot 0.25 | Rake 0.01
Board [ Ad 8s Ah ]
Game ended: 2025/09/03 22:49:33 GMT
Seat 1: AladeenMF folded before Flop (didn't bet)
Seat 2: AAdem (button) folded before Flop (didn't bet)
Seat 3: HailToTheKing (small blind) folded before Flop
Seat 4: kanococo (big blind) folded on the Flop
Seat 5: pscxlt folded before Flop (didn't bet)
Seat 6: Aceinthehole collected (0.24)
Seat 7: ColdFish folded before Flop (didn't bet)

CoinPoker Hand #291730471: Hold'em No Limit (0.01/0.02 ) 2025/09/03 22:49:35 GMT
Table 'NL ₮2 III' 7-max Seat #3 is the button
Seat 1: AladeenMF (2.39 in chips)
Seat 2: AAdem (1.23 in chips)
Seat 3: HailToTheKing (2.73 in chips)
Seat 4: kanococo (3.39 in chips)
Seat 5: pscxlt (2.20 in chips)
Seat 6: Aceinthehole (2.48 in chips)
Seat 7: ColdFish (2.18 in chips)
kanococo: posts small blind 0.01
pscxlt: posts big blind 0.02
*** HOLE CARDS ***
Dealt to kanococo [2s 7h]
Aceinthehole: folds
ColdFish: raises 0.04 to 0.06
AladeenMF: folds
AAdem: folds
HailToTheKing: folds
kanococo: folds
pscxlt: folds
ColdFish collected 0.09 from pot
ColdFish: doesn't show hand
*** SUMMARY ***
Total pot 0.09 | Rake 0.00
Board [ ]
Game ended: 2025/09/03 22:50:03 GMT
Seat 1: AladeenMF folded before Flop (didn't bet)
Seat 2: AAdem folded before Flop (didn't bet)
Seat 3: HailToTheKing (button) folded before Flop (didn't bet)
Seat 4: kanococo (small blind) folded before Flop
Seat 5: pscxlt (big blind) folded before Flop
Seat 6: Aceinthehole folded before Flop (didn't bet)
Seat 7: ColdFish collected (0.09)

CoinPoker Hand #291730678: Hold'em No Limit (0.01/0.02 ) 2025/09/03 22:50:05 GMT
Table 'NL ₮2 III' 7-max Seat #4 is the button
Seat 1: AladeenMF (2.39 in chips)
Seat 2: AAdem (1.23 in chips)
Seat 3: HailToTheKing (2.73 in chips)
Seat 4: kanococo (3.38 in chips)
Seat 5: pscxlt (2.18 in chips)
Seat 6: Aceinthehole (2.48 in chips)
Seat 7: ColdFish (2.21 in chips)
pscxlt: posts small blind 0.01
Aceinthehole: posts big blind 0.02
*** HOLE CARDS ***
Dealt to kanococo [8h 4h]
ColdFish: folds
AladeenMF: folds
AAdem: folds
HailToTheKing: raises 0.04 to 0.06
kanococo: folds
pscxlt: calls 0.05
Aceinthehole: folds
*** FLOP *** [7c Jc 7s]
pscxlt: checks
HailToTheKing: checks
*** TURN *** [7c Jc 7s] [Qh]
pscxlt: checks
HailToTheKing: bets 0.08
pscxlt: folds
Uncalled bet (0.08) returned to HailToTheKing
HailToTheKing collected 0.13 from pot
HailToTheKing: doesn't show hand
*** SUMMARY ***
Total pot 0.14 | Rake 0.01
Board [ 7c Jc 7s Qh ]
Game ended: 2025/09/03 22:51:12 GMT
Seat 1: AladeenMF folded before Flop (didn't bet)
Seat 2: AAdem folded before Flop (didn't bet)
Seat 3: HailToTheKing collected (0.13)
Seat 4: kanococo (button) folded before Flop (didn't bet)
Seat 5: pscxlt (small blind) folded on the Turn
Seat 6: Aceinthehole (big blind) folded before Flop
Seat 7: ColdFish folded before Flop (didn't bet)

CoinPoker Hand #291731078: Hold'em No Limit (0.01/0.02 ) 2025/09/03 22:51:14 GMT
Table 'NL ₮2 III' 7-max Seat #5 is the button
Seat 1: AladeenMF (2.39 in chips)
Seat 2: AAdem (1.23 in chips)
Seat 3: HailToTheKing (2.80 in chips)
Seat 4: kanococo (3.38 in chips)
Seat 5: pscxlt (2.12 in chips)
Seat 6: Aceinthehole (2.46 in chips)
Seat 7: ColdFish (2.21 in chips)
Aceinthehole: posts small blind 0.01
ColdFish: posts big blind 0.02
*** HOLE CARDS ***
Dealt to kanococo [Jh 9c]
AladeenMF: folds
AAdem: folds
HailToTheKing: folds
kanococo: raises 0.02 to 0.04
pscxlt: folds
Aceinthehole: folds
ColdFish: folds
kanococo collected 0.07 from pot
kanococo: doesn't show hand
*** SUMMARY ***
Total pot 0.07 | Rake 0.00
Board [ ]
Game ended: 2025/09/03 22:51:45 GMT
Seat 1: AladeenMF folded before Flop (didn't bet)
Seat 2: AAdem folded before Flop (didn't bet)
Seat 3: HailToTheKing folded before Flop (didn't bet)
Seat 4: kanococo collected (0.07)
Seat 5: pscxlt (button) folded before Flop (didn't bet)
Seat 6: Aceinthehole (small blind) folded before Flop
Seat 7: ColdFish (big blind) folded before Flop

CoinPoker Hand #291731240: Hold'em No Limit (0.01/0.02 ) 2025/09/03 22:51:47 GMT
Table 'NL ₮2 III' 7-max Seat #6 is the button
Seat 1: AladeenMF (2.39 in chips)
Seat 2: AAdem (1.23 in chips)
Seat 3: HailToTheKing (2.80 in chips)
Seat 4: kanococo (3.41 in chips)
Seat 5: pscxlt (2.12 in chips)
Seat 6: Aceinthehole (2.45 in chips)
Seat 7: ColdFish (2.19 in chips)
ColdFish: posts small blind 0.01
AladeenMF: posts big blind 0.02
*** HOLE CARDS ***
Dealt to kanococo [9h 4h]
AAdem: folds
HailToTheKing: folds
kanococo: folds
pscxlt: folds
Aceinthehole: raises 0.03 to 0.05
ColdFish: folds
AladeenMF: folds
Aceinthehole collected 0.08 from pot
Aceinthehole: doesn't show hand
*** SUMMARY ***
Total pot 0.08 | Rake 0.00
Board [ ]
Game ended: 2025/09/03 22:52:18 GMT
Seat 1: AladeenMF (big blind) folded before Flop
Seat 2: AAdem folded before Flop (didn't bet)
Seat 3: HailToTheKing folded before Flop (didn't bet)
Seat 4: kanococo folded before Flop (didn't bet)
Seat 5: pscxlt folded before Flop (didn't bet)
Seat 6: Aceinthehole (button) collected (0.08)
Seat 7: ColdFish (small blind) folded before Flop

CoinPoker Hand #291731505: Hold'em No Limit (0.01/0.02 ) 2025/09/03 22:52:20 GMT
Table 'NL ₮2 III' 7-max Seat #7 is the button
Seat 1: AladeenMF (2.37 in chips)
Seat 2: AAdem (1.23 in chips)
Seat 3: HailToTheKing (2.80 in chips)
Seat 4: kanococo (3.41 in chips)
Seat 5: pscxlt (2.12 in chips)
Seat 6: Aceinthehole (2.48 in chips)
Seat 7: ColdFish (2.18 in chips)
AladeenMF: posts small blind 0.01
AAdem: posts big blind 0.02
*** HOLE CARDS ***
Dealt to kanococo [Ad 8s]
HailToTheKing: folds
kanococo: folds
pscxlt: folds
Aceinthehole: folds
ColdFish: folds
AladeenMF: folds
AAdem collected 0.03 from pot
AAdem: doesn't show hand
*** SUMMARY ***
Total pot 0.03 | Rake 0.00
Board [ ]
Game ended: 2025/09/03 22:52:50 GMT
Seat 1: AladeenMF (small blind) folded before Flop
Seat 2: AAdem (big blind) collected (0.03)
Seat 3: HailToTheKing folded before Flop (didn't bet)
Seat 4: kanococo folded before Flop (didn't bet)
Seat 5: pscxlt folded before Flop (didn't bet)
Seat 6: Aceinthehole folded before Flop (didn't bet)
Seat 7: ColdFish (button) folded before Flop (didn't bet)

CoinPoker Hand #291764751: Hold'em No Limit (0.01/0.02 ) 2025/09/04 00:56:03 GMT
Table 'NL ₮2 IV' 7-max Seat #4 is the button
Seat 1: Rocky27 (2.00 in chips)
Seat 3: kanococo (2.00 in chips) out of hand
Seat 4: yonmon (1.97 in chips)
Seat 5: KiMiPhantom (0.83 in chips)
Seat 6: JT0 (2.00 in chips)
Seat 7: chakhssin (2.00 in chips) out of hand
KiMiPhantom: posts small blind 0.01
JT0: posts big blind 0.02
Rocky27: posts big blind 0.02
*** HOLE CARDS ***
Rocky27: checks
yonmon: folds
KiMiPhantom: folds
JT0: checks
*** FLOP *** [3c 4s 6c]
JT0: checks
Rocky27: bets 0.02
JT0: raises 0.10 to 0.12
Rocky27: raises 0.12 to 0.24
JT0: calls 0.12
*** TURN *** [3c 4s 6c] [Qh]
JT0: checks
Rocky27: bets 0.19
JT0: calls 0.19
*** RIVER *** [3c 4s 6c Qh] [Ad]
JT0: checks
Rocky27: bets 0.43
JT0: folds
Uncalled bet (0.43) returned to Rocky27
Rocky27 collected 0.86 from pot
Rocky27: doesn't show hand
*** SUMMARY ***
Total pot 0.91 | Rake 0.05
Board [ 3c 4s 6c Qh Ad ]
Game ended: 2025/09/04 00:57:38 GMT
Seat 1: Rocky27 collected (0.86)
Seat 3: kanococo folded before Flop (didn't bet)
Seat 4: yonmon (button) folded before Flop (didn't bet)
Seat 5: KiMiPhantom (small blind) folded before Flop
Seat 6: JT0 (big blind) folded on the River
Seat 7: chakhssin folded before Flop (didn't bet)

CoinPoker Hand #291765018: Hold'em No Limit (0.01/0.02 ) 2025/09/04 00:57:40 GMT
Table 'NL ₮2 IV' 7-max Seat #5 is the button
Seat 1: Rocky27 (2.41 in chips)
Seat 3: kanococo (2.00 in chips)
Seat 4: yonmon (1.97 in chips)
Seat 5: KiMiPhantom (0.82 in chips)
Seat 6: JT0 (2.00 in chips)
Seat 7: chakhssin (2.00 in chips)
JT0: posts small blind 0.01
chakhssin: posts big blind 0.02
kanococo: posts big blind 0.02
*** HOLE CARDS ***
Dealt to kanococo [4d 6d]
Rocky27: folds
kanococo: checks
yonmon: folds
KiMiPhantom: raises 0.02 to 0.04
JT0: folds
chakhssin: calls 0.02
kanococo: calls 0.02
*** FLOP *** [2h 5c 3h]
chakhssin: checks
kanococo: bets 0.06
KiMiPhantom: calls 0.06
chakhssin: raises 0.14 to 0.20
kanococo: calls 0.14
KiMiPhantom: raises 0.72 and is all-in
chakhssin: raises 1.76 and is all-in
kanococo: calls 1.76 and is all-in
*** TURN *** [2h 5c 3h] [Ad]
*** RIVER *** [2h 5c 3h Ad] [6h]
*** SHOW DOWN ***
chakhssin: shows [8c 8s] (a pair of Eights)
kanococo: shows [4d 6d] (a straight, Six high)
kanococo collected 2.28 from side-pot 1
KiMiPhantom: shows [Th Jh] (a flush, Jack high)
KiMiPhantom collected 2.35 from pot
*** SUMMARY ***
Total pot 4.83 | Rake 0.20
Board [ 2h 5c 3h Ad 6h ]
Game ended: 2025/09/04 00:59:08 GMT
Seat 1: Rocky27 folded before Flop (didn't bet)
Seat 3: kanococo showed [4d 6d] and won (2.28) with a straight, Six high
Seat 4: yonmon folded before Flop (didn't bet)
Seat 5: KiMiPhantom (button) showed [Th Jh] and won (2.35) with a flush, Jack high
Seat 6: JT0 (small blind) folded before Flop
Seat 7: chakhssin (big blind) showed [8c 8s]

CoinPoker Hand #291765212: Hold'em No Limit (0.01/0.02 ) 2025/09/04 00:59:09 GMT
Table 'NL ₮2 IV' 7-max Seat #6 is the button
Seat 1: Thwingfish (0.91 in chips)
Seat 3: kanococo (2.28 in chips)
Seat 4: yonmon (1.97 in chips)
Seat 5: KiMiPhantom (2.35 in chips)
Seat 6: JT0 (1.99 in chips)
Seat 7: chakhssin (2.00 in chips)
chakhssin: posts small blind 0.01
Thwingfish: posts big blind 0.02
*** HOLE CARDS ***
Dealt to kanococo [3c Jh]
kanococo: folds
yonmon: folds
KiMiPhantom: raises 0.02 to 0.04
JT0: folds
chakhssin: folds
Thwingfish: folds
KiMiPhantom collected 0.07 from pot
KiMiPhantom: doesn't show hand
*** SUMMARY ***
Total pot 0.07 | Rake 0.00
Board [ ]
Game ended: 2025/09/04 00:59:26 GMT
Seat 1: Thwingfish (big blind) folded before Flop
Seat 3: kanococo folded before Flop (didn't bet)
Seat 4: yonmon folded before Flop (didn't bet)
Seat 5: KiMiPhantom collected (0.07)
Seat 6: JT0 (button) folded before Flop (didn't bet)
Seat 7: chakhssin (small blind) folded before Flop

CoinPoker Hand #291765254: Hold'em No Limit (0.01/0.02 ) 2025/09/04 00:59:27 GMT
Table 'NL ₮2 IV' 7-max Seat #7 is the button
Seat 1: Thwingfish (0.89 in chips)
Seat 3: kanococo (2.28 in chips)
Seat 4: yonmon (1.97 in chips)
Seat 5: KiMiPhantom (2.38 in chips)
Seat 6: JT0 (2.00 in chips)
Seat 7: chakhssin (1.99 in chips)
Thwingfish: posts small blind 0.01
kanococo: posts big blind 0.02
*** HOLE CARDS ***
Dealt to kanococo [4d 2s]
yonmon: raises 0.02 to 0.04
KiMiPhantom: folds
JT0: folds
chakhssin: folds
Thwingfish: calls 0.03
kanococo: folds
*** FLOP *** [8s 5c 7c]
Thwingfish: checks
yonmon: checks
*** TURN *** [8s 5c 7c] [8d]
Thwingfish: checks
yonmon: bets 0.04
Thwingfish: folds
Uncalled bet (0.04) returned to yonmon
yonmon collected 0.09 from pot
yonmon: doesn't show hand
*** SUMMARY ***
Total pot 0.10 | Rake 0.01
Board [ 8s 5c 7c 8d ]
Game ended: 2025/09/04 01:00:19 GMT
Seat 1: Thwingfish (small blind) folded on the Turn
Seat 3: kanococo (big blind) folded before Flop
Seat 4: yonmon collected (0.09)
Seat 5: KiMiPhantom folded before Flop (didn't bet)
Seat 6: JT0 folded before Flop (didn't bet)
Seat 7: chakhssin (button) folded before Flop (didn't bet)

CoinPoker Hand #291765368: Hold'em No Limit (0.01/0.02 ) 2025/09/04 01:00:21 GMT
Table 'NL ₮2 IV' 7-max Seat #1 is the button
Seat 1: Thwingfish (0.85 in chips)
Seat 3: kanococo (2.26 in chips)
Seat 4: yonmon (2.02 in chips)
Seat 5: KiMiPhantom (2.38 in chips)
Seat 6: JT0 (2.00 in chips)
Seat 7: chakhssin (2.00 in chips)
kanococo: posts small blind 0.01
yonmon: posts big blind 0.02
*** HOLE CARDS ***
Dealt to kanococo [Tc 7h]
KiMiPhantom: folds
JT0: folds
chakhssin: raises 0.03 to 0.05
Thwingfish: calls 0.05
kanococo: folds
yonmon: folds
*** FLOP *** [9d 6h 8h]
chakhssin: bets 0.06
Thwingfish: folds
Uncalled bet (0.06) returned to chakhssin
chakhssin collected 0.12 from pot
chakhssin: doesn't show hand
*** SUMMARY ***
Total pot 0.13 | Rake 0.01
Board [ 9d 6h 8h ]
Game ended: 2025/09/04 01:01:04 GMT
Seat 1: Thwingfish (button) folded on the Flop
Seat 3: kanococo (small blind) folded before Flop
Seat 4: yonmon (big blind) folded before Flop
Seat 5: KiMiPhantom folded before Flop (didn't bet)
Seat 6: JT0 folded before Flop (didn't bet)
Seat 7: chakhssin collected (0.12)