CoinPoker Hand #290264569: Hold'em No Limit (0.01/0.02 ) 2025/08/31 19:01:00 GMT
Table 'NL ₮2 III' 7-max Seat #6 is the button
Seat 1: araivaivai (2.00 in chips)
Seat 2: Kelrax (2.66 in chips)
Seat 3: HoldBabyHold (2.40 in chips)
Seat 4: GrendelGreat (2.16 in chips)
Seat 5: kanococo (2.00 in chips)
Seat 6: Omt (1.87 in chips)
Seat 7: ceej (2.01 in chips)
ceej: posts small blind 0.01
araivaivai: posts big blind 0.02
kanococo: posts big blind 0.02
*** HOLE CARDS ***
Dealt to kanococo [Ad 4c]
Kelrax: folds
HoldBabyHold: folds
GrendelGreat: folds
kanococo: raises 0.02 to 0.04
Omt: folds
ceej: folds
araivaivai: folds
kanococo collected 0.07 from pot
kanococo: doesn't show hand
*** SUMMARY ***
Total pot 0.07 | Rake 0.00
Board [ ]
Game ended: 2025/08/31 19:01:22 GMT
Seat 1: araivaivai (big blind) folded before Flop
Seat 2: Kelrax folded before Flop (didn't bet)
Seat 3: HoldBabyHold folded before Flop (didn't bet)
Seat 4: GrendelGreat folded before Flop (didn't bet)
Seat 5: kanococo collected (0.07)
Seat 6: Omt (button) folded before Flop (didn't bet)
Seat 7: ceej (small blind) folded before Flop

CoinPoker Hand #290264693: Hold'em No Limit (0.01/0.02 ) 2025/08/31 19:01:23 GMT
Table 'NL ₮2 III' 7-max Seat #7 is the button
Seat 1: araivaivai (2.00 in chips)
Seat 2: Kelrax (2.66 in chips)
Seat 3: HoldBabyHold (2.40 in chips)
Seat 4: GrendelGreat (2.16 in chips)
Seat 5: kanococo (2.03 in chips)
Seat 6: Omt (1.87 in chips)
Seat 7: ceej (2.00 in chips)
araivaivai: posts small blind 0.01
Kelrax: posts big blind 0.02
*** HOLE CARDS ***
Dealt to kanococo [Kc 2d]
HoldBabyHold: folds
GrendelGreat: folds
kanococo: calls 0.02
Omt: calls 0.02
ceej: folds
araivaivai: folds
Kelrax: checks
*** FLOP *** [Kd 4h 8s]
Kelrax: checks
kanococo: bets 0.03
Omt: folds
Kelrax: folds
Uncalled bet (0.03) returned to kanococo
kanococo collected 0.07 from pot
kanococo: doesn't show hand
*** SUMMARY ***
Total pot 0.07 | Rake 0.00
Board [ Kd 4h 8s ]
Game ended: 2025/08/31 19:02:13 GMT
Seat 1: araivaivai (small blind) folded before Flop
Seat 2: Kelrax (big blind) folded on the Flop
Seat 3: HoldBabyHold folded before Flop (didn't bet)
Seat 4: GrendelGreat folded before Flop (didn't bet)
Seat 5: kanococo collected (0.07)
Seat 6: Omt folded on the Flop
Seat 7: ceej (button) folded before Flop (didn't bet)

CoinPoker Hand #290264954: Hold'em No Limit (0.01/0.02 ) 2025/08/31 19:02:15 GMT
Table 'NL ₮2 III' 7-max Seat #1 is the button
Seat 1: araivaivai (1.99 in chips)
Seat 2: Kelrax (2.64 in chips)
Seat 3: HoldBabyHold (2.40 in chips)
Seat 4: GrendelGreat (2.16 in chips)
Seat 5: kanococo (2.08 in chips)
Seat 6: Omt (1.85 in chips)
Seat 7: ceej (2.00 in chips)
Kelrax: posts small blind 0.01
HoldBabyHold: posts big blind 0.02
*** HOLE CARDS ***
Dealt to kanococo [Ks 8s]
GrendelGreat: folds
kanococo: raises 0.02 to 0.04
Omt has timed out
Omt activated time-bank (60 seconds)
Omt: calls 0.04
ceej: folds
araivaivai: folds
Kelrax: folds
HoldBabyHold: folds
*** FLOP *** [Ts 9c 4c]
kanococo: checks
Omt: checks
*** TURN *** [Ts 9c 4c] [Kh]
kanococo: checks
Omt: checks
*** RIVER *** [Ts 9c 4c Kh] [Qs]
kanococo: bets 0.05
Omt: folds
Uncalled bet (0.05) returned to kanococo
kanococo collected 0.10 from pot
kanococo: doesn't show hand
*** SUMMARY ***
Total pot 0.11 | Rake 0.01
Board [ Ts 9c 4c Kh Qs ]
Game ended: 2025/08/31 19:03:05 GMT
Seat 1: araivaivai (button) folded before Flop (didn't bet)
Seat 2: Kelrax (small blind) folded before Flop
Seat 3: HoldBabyHold (big blind) folded before Flop
Seat 4: GrendelGreat folded before Flop (didn't bet)
Seat 5: kanococo collected (0.10)
Seat 6: Omt folded on the River
Seat 7: ceej folded before Flop (didn't bet)

CoinPoker Hand #290265301: Hold'em No Limit (0.01/0.02 ) 2025/08/31 19:03:07 GMT
Table 'NL ₮2 III' 7-max Seat #2 is the button
Seat 1: araivaivai (2.00 in chips)
Seat 2: Kelrax (2.63 in chips)
Seat 3: HoldBabyHold (2.38 in chips)
Seat 4: GrendelGreat (2.16 in chips)
Seat 5: kanococo (2.14 in chips)
Seat 6: Omt (1.81 in chips)
Seat 7: ceej (2.00 in chips)
HoldBabyHold: posts small blind 0.01
GrendelGreat: posts big blind 0.02
*** HOLE CARDS ***
Dealt to kanococo [8s 7s]
kanococo: folds
Omt: calls 0.02
ceej: raises 0.04 to 0.06
araivaivai: raises 0.16 to 0.22
Kelrax: folds
HoldBabyHold: folds
GrendelGreat: folds
Omt: folds
ceej: calls 0.16
*** FLOP *** [8h Kc 8c]
ceej: checks
araivaivai: bets 0.28
ceej: calls 0.28
*** TURN *** [8h Kc 8c] [5d]
ceej: checks
araivaivai: bets 0.50
ceej has timed out
ceej activated time-bank (60 seconds)
ceej: folds
Uncalled bet (0.50) returned to araivaivai
araivaivai collected 1.00 from pot
araivaivai: doesn't show hand
*** SUMMARY ***
Total pot 1.05 | Rake 0.05
Board [ 8h Kc 8c 5d ]
Game ended: 2025/08/31 19:04:38 GMT
Seat 1: araivaivai collected (1.00)
Seat 2: Kelrax (button) folded before Flop (didn't bet)
Seat 3: HoldBabyHold (small blind) folded before Flop
Seat 4: GrendelGreat (big blind) folded before Flop
Seat 5: kanococo folded before Flop (didn't bet)
Seat 6: Omt folded before Flop
Seat 7: ceej folded on the Turn

CoinPoker Hand #290266331: Hold'em No Limit (0.01/0.02 ) 2025/08/31 19:04:40 GMT
Table 'NL ₮2 III' 7-max Seat #3 is the button
Seat 1: araivaivai (2.50 in chips)
Seat 2: Kelrax (2.63 in chips)
Seat 3: HoldBabyHold (2.37 in chips)
Seat 4: GrendelGreat (2.14 in chips)
Seat 5: kanococo (2.14 in chips)
Seat 6: Omt (1.79 in chips)
Seat 7: ceej (2.00 in chips)
GrendelGreat: posts small blind 0.01
kanococo: posts big blind 0.02
*** HOLE CARDS ***
Dealt to kanococo [7c 2d]
Omt: calls 0.02
ceej: folds
araivaivai: folds
Kelrax: folds
HoldBabyHold: raises 0.05 to 0.07
GrendelGreat: folds
kanococo: folds
Omt: calls 0.05
*** FLOP *** [6c Th As]
Omt has timed out
Omt activated time-bank (56 seconds)
Omt: checks
HoldBabyHold: bets 0.08
Omt: calls 0.08
*** TURN *** [6c Th As] [9s]
Omt: checks
HoldBabyHold has timed out
HoldBabyHold activated time-bank (60 seconds)
HoldBabyHold: bets 0.23
Omt: raises 0.23 to 0.46
HoldBabyHold: calls 0.23
*** RIVER *** [6c Th As 9s] [3h]
Omt: checks
HoldBabyHold: bets 1.48
Omt: calls 1.18 and is all-in
Uncalled bet (0.30) returned to HoldBabyHold
*** SHOW DOWN ***
HoldBabyHold: shows [Ac Tc] (two pairs, Aces and Tens)
Omt: shows [Ad Td] (two pairs, Aces and Tens)
HoldBabyHold collected 1.72 from pot
Omt collected 1.71 from pot
*** SUMMARY ***
Total pot 3.61 | Rake 0.18
Board [ 6c Th As 9s 3h ]
Game ended: 2025/08/31 19:06:40 GMT
Seat 1: araivaivai folded before Flop (didn't bet)
Seat 2: Kelrax folded before Flop (didn't bet)
Seat 3: HoldBabyHold (button) showed [Ac Tc] and won (1.72) with two pairs, Aces and Tens
Seat 4: GrendelGreat (small blind) folded before Flop
Seat 5: kanococo (big blind) folded before Flop
Seat 6: Omt showed [Ad Td] and won (1.71) with two pairs, Aces and Tens
Seat 7: ceej folded before Flop (didn't bet)

CoinPoker Hand #290267589: Hold'em No Limit (0.01/0.02 ) 2025/08/31 19:06:43 GMT
Table 'NL ₮2 III' 7-max Seat #4 is the button
Seat 1: araivaivai (2.50 in chips)
Seat 2: Kelrax (2.63 in chips)
Seat 3: HoldBabyHold (2.30 in chips)
Seat 4: GrendelGreat (2.13 in chips)
Seat 5: kanococo (2.12 in chips)
Seat 6: Omt (1.71 in chips)
Seat 7: ceej (2.00 in chips)
kanococo: posts small blind 0.01
Omt: posts big blind 0.02
*** HOLE CARDS ***
Dealt to kanococo [2s 5s]
ceej: folds
araivaivai: folds
Kelrax: folds
HoldBabyHold: folds
GrendelGreat: raises 0.02 to 0.04
kanococo: folds
Omt: folds
GrendelGreat collected 0.07 from pot
GrendelGreat: doesn't show hand
*** SUMMARY ***
Total pot 0.07 | Rake 0.00
Board [ ]
Game ended: 2025/08/31 19:07:35 GMT
Seat 1: araivaivai folded before Flop (didn't bet)
Seat 2: Kelrax folded before Flop (didn't bet)
Seat 3: HoldBabyHold folded before Flop (didn't bet)
Seat 4: GrendelGreat (button) collected (0.07)
Seat 5: kanococo (small blind) folded before Flop
Seat 6: Omt (big blind) folded before Flop
Seat 7: ceej folded before Flop (didn't bet)

CoinPoker Hand #290268506: Hold'em No Limit (0.01/0.02 ) 2025/08/31 19:07:38 GMT
Table 'NL ₮2 III' 7-max Seat #5 is the button
Seat 1: araivaivai (2.50 in chips)
Seat 2: Kelrax (2.63 in chips)
Seat 3: HoldBabyHold (2.30 in chips)
Seat 4: GrendelGreat (2.16 in chips)
Seat 5: kanococo (2.11 in chips)
Seat 6: Omt (1.69 in chips)
Seat 7: ceej (2.00 in chips)
Omt: posts small blind 0.01
ceej: posts big blind 0.02
*** HOLE CARDS ***
Dealt to kanococo [Qc Jc]
araivaivai: folds
Kelrax: folds
HoldBabyHold: folds
GrendelGreat: raises 0.03 to 0.05
kanococo: calls 0.05
Omt: calls 0.04
ceej: folds
*** FLOP *** [Jh 3d Ah]
Omt: checks
GrendelGreat: bets 0.05
kanococo: calls 0.05
Omt: calls 0.05
*** TURN *** [Jh 3d Ah] [Js]
Omt: checks
GrendelGreat: bets 0.10
kanococo: raises 0.10 to 0.20
Omt: calls 0.20
GrendelGreat: calls 0.10
*** RIVER *** [Jh 3d Ah Js] [Ts]
Omt: checks
GrendelGreat: checks
kanococo: bets 0.43
Omt: folds
GrendelGreat: folds
Uncalled bet (0.43) returned to kanococo
kanococo collected 0.87 from pot
kanococo: doesn't show hand
*** SUMMARY ***
Total pot 0.92 | Rake 0.05
Board [ Jh 3d Ah Js Ts ]
Game ended: 2025/08/31 19:09:37 GMT
Seat 1: araivaivai folded before Flop (didn't bet)
Seat 2: Kelrax folded before Flop (didn't bet)
Seat 3: HoldBabyHold folded before Flop (didn't bet)
Seat 4: GrendelGreat folded on the River
Seat 5: kanococo (button) collected (0.87)
Seat 6: Omt (small blind) folded on the River
Seat 7: ceej (big blind) folded before Flop

CoinPoker Hand #290269899: Hold'em No Limit (0.01/0.02 ) 2025/08/31 19:09:39 GMT
Table 'NL ₮2 III' 7-max Seat #6 is the button
Seat 1: araivaivai (2.50 in chips)
Seat 2: Kelrax (2.63 in chips)
Seat 3: HoldBabyHold (2.30 in chips)
Seat 4: GrendelGreat (2.00 in chips)
Seat 5: kanococo (2.68 in chips)
Seat 6: Omt (1.39 in chips)
Seat 7: ceej (2.00 in chips)
ceej: posts small blind 0.01
araivaivai: posts big blind 0.02
*** HOLE CARDS ***
Dealt to kanococo [Tc Jh]
Kelrax: folds
HoldBabyHold: folds
GrendelGreat: folds
kanococo: raises 0.02 to 0.04
Omt: calls 0.04
ceej: calls 0.03
araivaivai: folds
*** FLOP *** [Qs Ah Ac]
ceej: checks
kanococo: bets 0.04
Omt: folds
ceej: calls 0.04
*** TURN *** [Qs Ah Ac] [6c]
ceej: checks
kanococo: bets 0.04
ceej: calls 0.04
*** RIVER *** [Qs Ah Ac 6c] [6s]
ceej: bets 0.16
kanococo: calls 0.16
*** SHOW DOWN ***
ceej: shows [Ks Js] (two pairs, Aces and Sixes)
kanococo: mucks hand
ceej collected 0.59 from pot
*** SUMMARY ***
Total pot 0.62 | Rake 0.03
Board [ Qs Ah Ac 6c 6s ]
Game ended: 2025/08/31 19:10:47 GMT
Seat 1: araivaivai (big blind) folded before Flop
Seat 2: Kelrax folded before Flop (didn't bet)
Seat 3: HoldBabyHold folded before Flop (didn't bet)
Seat 4: GrendelGreat folded before Flop (didn't bet)
Seat 5: kanococo mucked
Seat 6: Omt (button) folded on the Flop
Seat 7: ceej (small blind) showed [Ks Js] and won (0.59) with two pairs, Aces and Sixes

CoinPoker Hand #290270616: Hold'em No Limit (0.01/0.02 ) 2025/08/31 19:10:49 GMT
Table 'NL ₮2 III' 7-max Seat #7 is the button
Seat 1: araivaivai (2.48 in chips)
Seat 2: Kelrax (2.63 in chips)
Seat 3: HoldBabyHold (2.30 in chips)
Seat 4: GrendelGreat (2.00 in chips)
Seat 5: kanococo (2.40 in chips)
Seat 6: Omt (1.35 in chips)
Seat 7: ceej (2.31 in chips)
araivaivai: posts small blind 0.01
Kelrax: posts big blind 0.02
*** HOLE CARDS ***
Dealt to kanococo [2s 6d]
HoldBabyHold: folds
GrendelGreat: raises 0.02 to 0.04
kanococo: folds
Omt: calls 0.04
ceej: folds
araivaivai: calls 0.03
Kelrax: calls 0.02
*** FLOP *** [Th 5h Jc]
araivaivai: checks
Kelrax: checks
GrendelGreat: checks
Omt: checks
*** TURN *** [Th 5h Jc] [9d]
araivaivai: checks
Kelrax: checks
GrendelGreat: checks
Omt: checks
*** RIVER *** [Th 5h Jc 9d] [6h]
araivaivai: bets 0.20
Kelrax: calls 0.20
GrendelGreat: folds
Omt: folds
*** SHOW DOWN ***
araivaivai: shows [7h Ah] (a flush, Ace high)
Kelrax: mucks hand
araivaivai collected 0.53 from pot
*** SUMMARY ***
Total pot 0.56 | Rake 0.03
Board [ Th 5h Jc 9d 6h ]
Game ended: 2025/08/31 19:12:02 GMT
Seat 1: araivaivai (small blind) showed [7h Ah] and won (0.53) with a flush, Ace high
Seat 2: Kelrax (big blind) mucked
Seat 3: HoldBabyHold folded before Flop (didn't bet)
Seat 4: GrendelGreat folded on the River
Seat 5: kanococo folded before Flop (didn't bet)
Seat 6: Omt folded on the River
Seat 7: ceej (button) folded before Flop (didn't bet)

CoinPoker Hand #290271542: Hold'em No Limit (0.01/0.02 ) 2025/08/31 19:12:03 GMT
Table 'NL ₮2 III' 7-max Seat #1 is the button
Seat 1: araivaivai (2.77 in chips)
Seat 2: Kelrax (2.39 in chips)
Seat 3: HoldBabyHold (2.30 in chips)
Seat 4: GrendelGreat (2.00 in chips)
Seat 5: kanococo (2.40 in chips)
Seat 6: Omt (1.31 in chips)
Seat 7: ceej (2.31 in chips)
Kelrax: posts small blind 0.01
HoldBabyHold: posts big blind 0.02
*** HOLE CARDS ***
Dealt to kanococo [5d 5h]
GrendelGreat: folds
kanococo: raises 0.02 to 0.04
Omt: folds
ceej: folds
araivaivai: calls 0.04
Kelrax: calls 0.03
HoldBabyHold: folds
*** FLOP *** [Ts Ah 2c]
Kelrax has timed out
Kelrax activated time-bank (56 seconds)
Kelrax: checks
kanococo: checks
araivaivai: checks
*** TURN *** [Ts Ah 2c] [3c]
Kelrax has timed out
Kelrax activated time-bank (54 seconds)
Kelrax: bets 0.06
kanococo: calls 0.06
araivaivai: calls 0.06
*** RIVER *** [Ts Ah 2c 3c] [2d]
Kelrax: checks
kanococo: checks
araivaivai: bets 0.36
Kelrax: folds
kanococo: calls 0.36
*** SHOW DOWN ***
araivaivai: shows [9c 8c] (a pair of Twos)
kanococo: shows [5d 5h] (two pairs, Fives and Twos)
kanococo collected 0.99 from pot
*** SUMMARY ***
Total pot 1.04 | Rake 0.05
Board [ Ts Ah 2c 3c 2d ]
Game ended: 2025/08/31 19:13:55 GMT
Seat 1: araivaivai (button) showed [9c 8c]
Seat 2: Kelrax (small blind) folded on the River
Seat 3: HoldBabyHold (big blind) folded before Flop
Seat 4: GrendelGreat folded before Flop (didn't bet)
Seat 5: kanococo showed [5d 5h] and won (0.99) with two pairs, Fives and Twos
Seat 6: Omt folded before Flop (didn't bet)
Seat 7: ceej folded before Flop (didn't bet)

CoinPoker Hand #290272837: Hold'em No Limit (0.01/0.02 ) 2025/08/31 19:13:57 GMT
Table 'NL ₮2 III' 7-max Seat #2 is the button
Seat 1: araivaivai (2.31 in chips)
Seat 2: Kelrax (2.29 in chips)
Seat 3: HoldBabyHold (2.28 in chips)
Seat 4: GrendelGreat (2.00 in chips)
Seat 5: kanococo (2.93 in chips)
Seat 6: Omt (1.31 in chips)
Seat 7: ceej (2.31 in chips)
HoldBabyHold: posts small blind 0.01
GrendelGreat: posts big blind 0.02
*** HOLE CARDS ***
Dealt to kanococo [Kc 3h]
kanococo: folds
Omt: folds
ceej: raises 0.04 to 0.06
araivaivai: folds
Kelrax: calls 0.06
HoldBabyHold: folds
GrendelGreat: folds
*** FLOP *** [Qd 8d Td]
ceej: checks
Kelrax: bets 0.08
ceej: calls 0.08
*** TURN *** [Qd 8d Td] [2s]
ceej: checks
Kelrax: bets 0.18
ceej: folds
Uncalled bet (0.18) returned to Kelrax
Kelrax collected 0.29 from pot
Kelrax: doesn't show hand
*** SUMMARY ***
Total pot 0.31 | Rake 0.02
Board [ Qd 8d Td 2s ]
Game ended: 2025/08/31 19:15:10 GMT
Seat 1: araivaivai folded before Flop (didn't bet)
Seat 2: Kelrax (button) collected (0.29)
Seat 3: HoldBabyHold (small blind) folded before Flop
Seat 4: GrendelGreat (big blind) folded before Flop
Seat 5: kanococo folded before Flop (didn't bet)
Seat 6: Omt folded before Flop (didn't bet)
Seat 7: ceej folded on the Turn

CoinPoker Hand #290273898: Hold'em No Limit (0.01/0.02 ) 2025/08/31 19:15:12 GMT
Table 'NL ₮2 III' 7-max Seat #3 is the button
Seat 1: araivaivai (2.31 in chips)
Seat 2: Kelrax (2.44 in chips)
Seat 3: HoldBabyHold (2.27 in chips)
Seat 4: GrendelGreat (2.00 in chips)
Seat 5: kanococo (2.93 in chips)
Seat 6: Omt (1.31 in chips)
Seat 7: ceej (2.17 in chips)
GrendelGreat: posts small blind 0.01
kanococo: posts big blind 0.02
*** HOLE CARDS ***
Dealt to kanococo [7s 6h]
Omt: calls 0.02
ceej: folds
araivaivai: folds
Kelrax: folds
HoldBabyHold: folds
GrendelGreat: folds
kanococo: raises 0.02 to 0.04
Omt: calls 0.02
*** FLOP *** [6s 5s 2d]
kanococo: checks
Omt has timed out
Omt activated time-bank (54 seconds)
Omt: checks
*** TURN *** [6s 5s 2d] [2s]
kanococo: bets 0.04
Omt: folds
Uncalled bet (0.04) returned to kanococo
kanococo collected 0.09 from pot
kanococo: doesn't show hand
*** SUMMARY ***
Total pot 0.09 | Rake 0.00
Board [ 6s 5s 2d 2s ]
Game ended: 2025/08/31 19:16:06 GMT
Seat 1: araivaivai folded before Flop (didn't bet)
Seat 2: Kelrax folded before Flop (didn't bet)
Seat 3: HoldBabyHold (button) folded before Flop (didn't bet)
Seat 4: GrendelGreat (small blind) folded before Flop
Seat 5: kanococo (big blind) collected (0.09)
Seat 6: Omt folded on the Turn
Seat 7: ceej folded before Flop (didn't bet)

CoinPoker Hand #290274339: Hold'em No Limit (0.01/0.02 ) 2025/08/31 19:16:08 GMT
Table 'NL ₮2 III' 7-max Seat #4 is the button
Seat 1: araivaivai (2.31 in chips)
Seat 2: Kelrax (2.44 in chips)
Seat 3: HoldBabyHold (2.27 in chips)
Seat 4: GrendelGreat (1.99 in chips)
Seat 5: kanococo (2.98 in chips)
Seat 6: Omt (1.27 in chips)
Seat 7: ceej (2.17 in chips)
kanococo: posts small blind 0.01
Omt: posts big blind 0.02
*** HOLE CARDS ***
Dealt to kanococo [8c 3c]
ceej: folds
araivaivai: folds
Kelrax: folds
HoldBabyHold: folds
GrendelGreat: raises 0.04 to 0.06
kanococo: folds
Omt: folds
GrendelGreat collected 0.09 from pot
GrendelGreat: doesn't show hand
*** SUMMARY ***
Total pot 0.09 | Rake 0.00
Board [ ]
Game ended: 2025/08/31 19:16:46 GMT
Seat 1: araivaivai folded before Flop (didn't bet)
Seat 2: Kelrax folded before Flop (didn't bet)
Seat 3: HoldBabyHold folded before Flop (didn't bet)
Seat 4: GrendelGreat (button) collected (0.09)
Seat 5: kanococo (small blind) folded before Flop
Seat 6: Omt (big blind) folded before Flop
Seat 7: ceej folded before Flop (didn't bet)

CoinPoker Hand #290274817: Hold'em No Limit (0.01/0.02 ) 2025/08/31 19:16:48 GMT
Table 'NL ₮2 III' 7-max Seat #5 is the button
Seat 1: araivaivai (2.31 in chips)
Seat 2: Kelrax (2.44 in chips)
Seat 3: HoldBabyHold (2.27 in chips)
Seat 4: GrendelGreat (2.02 in chips)
Seat 5: kanococo (2.97 in chips)
Seat 6: Omt (1.25 in chips)
Seat 7: ceej (2.17 in chips)
Omt: posts small blind 0.01
ceej: posts big blind 0.02
*** HOLE CARDS ***
Dealt to kanococo [5h 8h]
araivaivai: folds
Kelrax: folds
HoldBabyHold: folds
GrendelGreat: folds
kanococo: folds
Omt: calls 0.01
ceej: checks
*** FLOP *** [5s Td 4s]
Omt: checks
ceej has timed out
ceej activated time-bank (46 seconds)
ceej: checks
*** TURN *** [5s Td 4s] [6c]
Omt: checks
ceej has timed out
ceej activated time-bank (41 seconds)
ceej: checks
*** RIVER *** [5s Td 4s 6c] [Ah]
Omt: checks
ceej: checks
*** SHOW DOWN ***
Omt: shows [6s Qd] (a pair of Sixes)
ceej: shows [7d As] (a pair of Aces)
ceej collected 0.04 from pot
*** SUMMARY ***
Total pot 0.04 | Rake 0.00
Board [ 5s Td 4s 6c Ah ]
Game ended: 2025/08/31 19:18:31 GMT
Seat 1: araivaivai folded before Flop (didn't bet)
Seat 2: Kelrax folded before Flop (didn't bet)
Seat 3: HoldBabyHold folded before Flop (didn't bet)
Seat 4: GrendelGreat folded before Flop (didn't bet)
Seat 5: kanococo (button) folded before Flop (didn't bet)
Seat 6: Omt (small blind) showed [6s Qd]
Seat 7: ceej (big blind) showed [7d As] and won (0.04) with a pair of Aces

CoinPoker Hand #290276330: Hold'em No Limit (0.01/0.02 ) 2025/08/31 19:18:35 GMT
Table 'NL ₮2 III' 7-max Seat #6 is the button
Seat 1: araivaivai (2.31 in chips)
Seat 2: Kelrax (2.44 in chips) is sitting out
Seat 3: HoldBabyHold (2.27 in chips)
Seat 4: GrendelGreat (2.02 in chips)
Seat 5: kanococo (2.97 in chips)
Seat 6: Omt (1.23 in chips)
Seat 7: ceej (2.19 in chips)
ceej: posts small blind 0.01
araivaivai: posts big blind 0.02
*** HOLE CARDS ***
Dealt to kanococo [Qs Js]
HoldBabyHold: folds
GrendelGreat: folds
kanococo: raises 0.04 to 0.06
Omt: calls 0.06
ceej: folds
araivaivai: folds
*** FLOP *** [8c 5c 7c]
kanococo: checks
Omt: checks
*** TURN *** [8c 5c 7c] [As]
kanococo: bets 0.07
Omt: folds
Uncalled bet (0.07) returned to kanococo
kanococo collected 0.14 from pot
kanococo: doesn't show hand
*** SUMMARY ***
Total pot 0.15 | Rake 0.01
Board [ 8c 5c 7c As ]
Game ended: 2025/08/31 19:19:08 GMT
Seat 1: araivaivai (big blind) folded before Flop
Seat 2: Kelrax folded before Flop (didn't bet)
Seat 3: HoldBabyHold folded before Flop (didn't bet)
Seat 4: GrendelGreat folded before Flop (didn't bet)
Seat 5: kanococo collected (0.14)
Seat 6: Omt (button) folded on the Turn
Seat 7: ceej (small blind) folded before Flop

CoinPoker Hand #290276766: Hold'em No Limit (0.01/0.02 ) 2025/08/31 19:19:11 GMT
Table 'NL ₮2 III' 7-max Seat #7 is the button
Seat 1: araivaivai (2.29 in chips)
Seat 2: Kelrax (2.44 in chips) is sitting out
Seat 3: HoldBabyHold (2.27 in chips)
Seat 4: GrendelGreat (2.02 in chips)
Seat 5: kanococo (3.05 in chips)
Seat 6: Omt (1.17 in chips)
Seat 7: ceej (2.18 in chips)
araivaivai: posts small blind 0.01
HoldBabyHold: posts big blind 0.02
*** HOLE CARDS ***
Dealt to kanococo [Ks Ad]
GrendelGreat: raises 0.02 to 0.04
kanococo: calls 0.04
Omt: folds
ceej: folds
araivaivai: folds
HoldBabyHold: folds
*** FLOP *** [9d 9c Qh]
GrendelGreat: bets 0.05
kanococo: calls 0.05
*** TURN *** [9d 9c Qh] [8h]
GrendelGreat: bets 0.10
kanococo has timed out
kanococo: folds
Uncalled bet (0.10) returned to GrendelGreat
GrendelGreat collected 0.20 from pot
GrendelGreat: doesn't show hand
*** SUMMARY ***
Total pot 0.21 | Rake 0.01
Board [ 9d 9c Qh 8h ]
Game ended: 2025/08/31 19:20:14 GMT
Seat 1: araivaivai (small blind) folded before Flop
Seat 2: Kelrax folded before Flop (didn't bet)
Seat 3: HoldBabyHold (big blind) folded before Flop
Seat 4: GrendelGreat collected (0.20)
Seat 5: kanococo folded on the Turn
Seat 6: Omt folded before Flop (didn't bet)
Seat 7: ceej (button) folded before Flop (didn't bet)

CoinPoker Hand #290277521: Hold'em No Limit (0.01/0.02 ) 2025/08/31 19:20:16 GMT
Table 'NL ₮2 III' 7-max Seat #1 is the button
Seat 1: araivaivai (2.28 in chips)
Seat 2: Kelrax (2.44 in chips) is sitting out
Seat 3: HoldBabyHold (2.25 in chips)
Seat 4: GrendelGreat (2.13 in chips)
Seat 5: kanococo (2.96 in chips)
Seat 6: Omt (1.17 in chips)
Seat 7: ceej (2.18 in chips)
HoldBabyHold: posts small blind 0.01
GrendelGreat: posts big blind 0.02
*** HOLE CARDS ***
Dealt to kanococo [8h 2h]
kanococo: folds
Omt: calls 0.02
ceej: folds
araivaivai: folds
HoldBabyHold: calls 0.01
GrendelGreat: checks
*** FLOP *** [Td 3d 2s]
HoldBabyHold: bets 0.03
GrendelGreat: folds
Omt: calls 0.03
*** TURN *** [Td 3d 2s] [Kd]
HoldBabyHold: bets 0.04
Omt: folds
Uncalled bet (0.04) returned to HoldBabyHold
HoldBabyHold collected 0.11 from pot
HoldBabyHold: doesn't show hand
*** SUMMARY ***
Total pot 0.12 | Rake 0.01
Board [ Td 3d 2s Kd ]
Game ended: 2025/08/31 19:21:00 GMT
Seat 1: araivaivai (button) folded before Flop (didn't bet)
Seat 2: Kelrax folded before Flop (didn't bet)
Seat 3: HoldBabyHold (small blind) collected (0.11)
Seat 4: GrendelGreat (big blind) folded on the Flop
Seat 5: kanococo folded before Flop (didn't bet)
Seat 6: Omt folded on the Turn
Seat 7: ceej folded before Flop (didn't bet)

CoinPoker Hand #290334881: Tournament #1361819, ₮1 Mini Sunday Smash PKO Hold'em No Limit (50/100 ante 15 play) 2025/08/31 21:05:05 GMT
Table '1' 7-max Seat #7 is the button
Seat 1: Monzadrift (10000 in chips, 50 bounty)
Seat 3: kanococo (10000 in chips, 50 bounty)
Seat 4: MastaBeta (10000 in chips, 50 bounty)
Seat 5: sucio (10000 in chips, 50 bounty)
Seat 6: Nick272727 (10000 in chips, 50 bounty)
Seat 7: negozin (10000 in chips, 50 bounty)
Monzadrift: posts the ante 15
kanococo: posts the ante 15
MastaBeta: posts the ante 15
sucio: posts the ante 15
Nick272727: posts the ante 15
negozin: posts the ante 15
Monzadrift: posts small blind 50
kanococo: posts big blind 100
*** HOLE CARDS ***
Dealt to kanococo [Ks 7h]
MastaBeta: raises 100 to 200
sucio has timed out
sucio activated time-bank (30 seconds)
sucio: folds
Nick272727: calls 200
negozin: folds
Monzadrift: folds
kanococo: calls 100
*** FLOP *** [Kd Jd Tc]
kanococo: checks
MastaBeta: checks
Nick272727: checks
*** TURN *** [Kd Jd Tc] [4c]
kanococo: bets 740
MastaBeta: calls 740
Nick272727: folds
*** RIVER *** [Kd Jd Tc 4c] [3d]
kanococo: bets 2220
MastaBeta: folds
Uncalled bet (2220) returned to kanococo
kanococo collected 2220 from pot
kanococo: doesn't show hand
Knutss has reconnected
*** SUMMARY ***
Total pot 2220 | Rake 0
Board [ Kd Jd Tc 4c 3d ]
Game ended: 2025/08/31 21:06:18 GMT
Seat 1: Monzadrift (small blind) folded before Flop
Seat 3: kanococo (big blind) collected (2220)
Seat 4: MastaBeta folded on the River
Seat 5: sucio folded before Flop
Seat 6: Nick272727 folded on the Turn
Seat 7: negozin (button) folded before Flop

CoinPoker Hand #290335550: Tournament #1361819, ₮1 Mini Sunday Smash PKO Hold'em No Limit (50/100 ante 15 play) 2025/08/31 21:06:19 GMT
Table '1' 7-max Seat #1 is the button
Seat 1: Monzadrift (9935 in chips, 50 bounty)
Seat 2: Knutss (10000 in chips, 50 bounty) out of hand
Seat 3: kanococo (11265 in chips, 50 bounty)
Seat 4: MastaBeta (9045 in chips, 50 bounty)
Seat 5: sucio (9985 in chips, 50 bounty)
Seat 6: Nick272727 (9785 in chips, 50 bounty)
Seat 7: negozin (9985 in chips, 50 bounty)
Monzadrift: posts the ante 15
kanococo: posts the ante 15
MastaBeta: posts the ante 15
sucio: posts the ante 15
Nick272727: posts the ante 15
negozin: posts the ante 15
kanococo: posts small blind 50
MastaBeta: posts big blind 100
*** HOLE CARDS ***
Dealt to kanococo [Qh 3s]
sucio: folds
Nick272727: folds
negozin: folds
Monzadrift: raises 100 to 200
kanococo: folds
MastaBeta has timed out
MastaBeta activated time-bank (30 seconds)
MastaBeta: folds
Monzadrift collected 440 from pot
Monzadrift has timed out
Monzadrift: doesn't show hand
*** SUMMARY ***
Total pot 440 | Rake 0
Board [ ]
Game ended: 2025/08/31 21:06:57 GMT
Seat 1: Monzadrift (button) collected (440)
Seat 2: Knutss folded before Flop (didn't bet)
Seat 3: kanococo (small blind) folded before Flop
Seat 4: MastaBeta (big blind) folded before Flop
Seat 5: sucio folded before Flop
Seat 6: Nick272727 folded before Flop
Seat 7: negozin folded before Flop

CoinPoker Hand #290335822: Tournament #1361819, ₮1 Mini Sunday Smash PKO Hold'em No Limit (50/100 ante 15 play) 2025/08/31 21:06:58 GMT
Table '1' 7-max Seat #3 is the button
Seat 1: Monzadrift (10160 in chips, 50 bounty)
Seat 2: Knutss (10000 in chips, 50 bounty)
Seat 3: kanococo (11200 in chips, 50 bounty)
Seat 4: MastaBeta (8930 in chips, 50 bounty)
Seat 5: sucio (9970 in chips, 50 bounty)
Seat 6: Nick272727 (9770 in chips, 50 bounty)
Seat 7: negozin (9970 in chips, 50 bounty)
Monzadrift: posts the ante 15
Knutss: posts the ante 15
kanococo: posts the ante 15
MastaBeta: posts the ante 15
sucio: posts the ante 15
Nick272727: posts the ante 15
negozin: posts the ante 15
MastaBeta: posts small blind 50
sucio: posts big blind 100
*** HOLE CARDS ***
Dealt to kanococo [8d 8h]
Nick272727: folds
negozin: folds
Monzadrift: raises 100 to 200
Knutss: folds
kanococo: raises 200 to 400
MastaBeta: folds
sucio: raises 1155 to 1555
Monzadrift has timed out
Monzadrift activated time-bank (30 seconds)
Monzadrift: folds
kanococo: calls 1155
*** FLOP *** [3s Qd Jd]
sucio: bets 8400 and is all-in
kanococo: folds
Uncalled bet (8400) returned to sucio
sucio collected 3465 from pot
sucio: doesn't show hand
*** SUMMARY ***
Total pot 3465 | Rake 0
Board [ 3s Qd Jd ]
Game ended: 2025/08/31 21:08:28 GMT
Seat 1: Monzadrift folded before Flop
Seat 2: Knutss folded before Flop
Seat 3: kanococo (button) folded on the Flop
Seat 4: MastaBeta (small blind) folded before Flop
Seat 5: sucio (big blind) collected (3465)
Seat 6: Nick272727 folded before Flop
Seat 7: negozin folded before Flop

CoinPoker Hand #290336562: Tournament #1361819, ₮1 Mini Sunday Smash PKO Hold'em No Limit (50/100 ante 15 play) 2025/08/31 21:08:29 GMT
Table '1' 7-max Seat #4 is the button
Seat 1: Monzadrift (9945 in chips, 50 bounty)
Seat 2: Knutss (9985 in chips, 50 bounty)
Seat 3: kanococo (9630 in chips, 50 bounty)
Seat 4: MastaBeta (8865 in chips, 50 bounty)
Seat 5: sucio (11865 in chips, 50 bounty)
Seat 6: Nick272727 (9755 in chips, 50 bounty)
Seat 7: negozin (9955 in chips, 50 bounty)
Monzadrift: posts the ante 15
Knutss: posts the ante 15
kanococo: posts the ante 15
MastaBeta: posts the ante 15
sucio: posts the ante 15
Nick272727: posts the ante 15
negozin: posts the ante 15
sucio: posts small blind 50
Nick272727: posts big blind 100
*** HOLE CARDS ***
Dealt to kanococo [Jc 8c]
negozin: folds
Monzadrift: raises 100 to 200
Knutss: folds
kanococo: folds
MastaBeta: folds
sucio: folds
Nick272727: calls 100
*** FLOP *** [7h Kh Tc]
Nick272727 has timed out
Nick272727 activated time-bank (30 seconds)
Nick272727: bets 100
Monzadrift: raises 400 to 500
Nick272727: folds
Uncalled bet (400) returned to Monzadrift
Monzadrift collected 755 from pot
Monzadrift has timed out
Monzadrift: doesn't show hand
*** SUMMARY ***
Total pot 755 | Rake 0
Board [ 7h Kh Tc ]
Game ended: 2025/08/31 21:10:03 GMT
Seat 1: Monzadrift collected (755)
Seat 2: Knutss folded before Flop
Seat 3: kanococo folded before Flop
Seat 4: MastaBeta (button) folded before Flop
Seat 5: sucio (small blind) folded before Flop
Seat 6: Nick272727 (big blind) folded on the Flop
Seat 7: negozin folded before Flop

CoinPoker Hand #290337376: Tournament #1361819, ₮1 Mini Sunday Smash PKO Hold'em No Limit (50/100 ante 15 play) 2025/08/31 21:10:04 GMT
Table '1' 7-max Seat #5 is the button
Seat 1: Monzadrift (10385 in chips, 50 bounty)
Seat 2: Knutss (9970 in chips, 50 bounty)
Seat 3: kanococo (9615 in chips, 50 bounty)
Seat 4: MastaBeta (8850 in chips, 50 bounty)
Seat 5: sucio (11800 in chips, 50 bounty)
Seat 6: Nick272727 (9440 in chips, 50 bounty)
Seat 7: negozin (9940 in chips, 50 bounty)
Monzadrift: posts the ante 15
Knutss: posts the ante 15
kanococo: posts the ante 15
MastaBeta: posts the ante 15
sucio: posts the ante 15
Nick272727: posts the ante 15
negozin: posts the ante 15
Nick272727: posts small blind 50
negozin: posts big blind 100
*** HOLE CARDS ***
Dealt to kanococo [4c 9s]
Monzadrift: folds
Knutss: folds
kanococo: folds
MastaBeta: folds
sucio: folds
Nick272727: folds
negozin collected 255 from pot
negozin: doesn't show hand
*** SUMMARY ***
Total pot 255 | Rake 0
Board [ ]
Game ended: 2025/08/31 21:10:25 GMT
Seat 1: Monzadrift folded before Flop
Seat 2: Knutss folded before Flop
Seat 3: kanococo folded before Flop
Seat 4: MastaBeta folded before Flop
Seat 5: sucio (button) folded before Flop
Seat 6: Nick272727 (small blind) folded before Flop
Seat 7: negozin (big blind) collected (255)

CoinPoker Hand #290337551: Tournament #1361819, ₮1 Mini Sunday Smash PKO Hold'em No Limit (50/100 ante 15 play) 2025/08/31 21:10:26 GMT
Table '1' 7-max Seat #6 is the button
Seat 1: Monzadrift (10370 in chips, 50 bounty)
Seat 2: Knutss (9955 in chips, 50 bounty)
Seat 3: kanococo (9600 in chips, 50 bounty)
Seat 4: MastaBeta (8835 in chips, 50 bounty)
Seat 5: sucio (11785 in chips, 50 bounty)
Seat 6: Nick272727 (9375 in chips, 50 bounty)
Seat 7: negozin (10080 in chips, 50 bounty)
Monzadrift: posts the ante 15
Knutss: posts the ante 15
kanococo: posts the ante 15
MastaBeta: posts the ante 15
sucio: posts the ante 15
Nick272727: posts the ante 15
negozin: posts the ante 15
negozin: posts small blind 50
Monzadrift: posts big blind 100
*** HOLE CARDS ***
Dealt to kanococo [Qc 7h]
Knutss: folds
kanococo: folds
MastaBeta: folds
sucio: folds
Nick272727: folds
negozin has timed out
negozin activated time-bank (30 seconds)
negozin: folds
Monzadrift collected 255 from pot
Monzadrift has timed out
Monzadrift: doesn't show hand
*** SUMMARY ***
Total pot 255 | Rake 0
Board [ ]
Game ended: 2025/08/31 21:11:05 GMT
Seat 1: Monzadrift (big blind) collected (255)
Seat 2: Knutss folded before Flop
Seat 3: kanococo folded before Flop
Seat 4: MastaBeta folded before Flop
Seat 5: sucio folded before Flop
Seat 6: Nick272727 (button) folded before Flop
Seat 7: negozin (small blind) folded before Flop

CoinPoker Hand #290337955: Tournament #1361819, ₮1 Mini Sunday Smash PKO Hold'em No Limit (60/120 ante 18 play) 2025/08/31 21:11:10 GMT
Table '1' 7-max Seat #7 is the button
Seat 1: Monzadrift (10510 in chips, 50 bounty)
Seat 2: Knutss (9940 in chips, 50 bounty)
Seat 3: kanococo (9585 in chips, 50 bounty)
Seat 4: MastaBeta (8820 in chips, 50 bounty)
Seat 5: sucio (11770 in chips, 50 bounty)
Seat 6: Nick272727 (9360 in chips, 50 bounty)
Seat 7: negozin (10015 in chips, 50 bounty)
Monzadrift: posts the ante 18
Knutss: posts the ante 18
kanococo: posts the ante 18
MastaBeta: posts the ante 18
sucio: posts the ante 18
Nick272727: posts the ante 18
negozin: posts the ante 18
Monzadrift: posts small blind 60
Knutss: posts big blind 120
*** HOLE CARDS ***
Dealt to kanococo [7d Kd]
kanococo: raises 120 to 240
MastaBeta: raises 540 to 780
sucio: folds
Nick272727: folds
negozin: folds
Monzadrift: folds
Knutss: folds
kanococo: folds
MastaBeta collected 1326 from pot
MastaBeta: doesn't show hand
*** SUMMARY ***
Total pot 1326 | Rake 0
Board [ ]
Game ended: 2025/08/31 21:11:55 GMT
Seat 1: Monzadrift (small blind) folded before Flop
Seat 2: Knutss (big blind) folded before Flop
Seat 3: kanococo folded before Flop
Seat 4: MastaBeta collected (1326)
Seat 5: sucio folded before Flop
Seat 6: Nick272727 folded before Flop
Seat 7: negozin (button) folded before Flop

CoinPoker Hand #290338351: Tournament #1361819, ₮1 Mini Sunday Smash PKO Hold'em No Limit (60/120 ante 18 play) 2025/08/31 21:11:55 GMT
Table '1' 7-max Seat #1 is the button
Seat 1: Monzadrift (10432 in chips, 50 bounty)
Seat 2: Knutss (9802 in chips, 50 bounty)
Seat 3: kanococo (9327 in chips, 50 bounty)
Seat 4: MastaBeta (9348 in chips, 50 bounty)
Seat 5: sucio (11752 in chips, 50 bounty)
Seat 6: Nick272727 (9342 in chips, 50 bounty)
Seat 7: negozin (9997 in chips, 50 bounty)
Monzadrift: posts the ante 18
Knutss: posts the ante 18
kanococo: posts the ante 18
MastaBeta: posts the ante 18
sucio: posts the ante 18
Nick272727: posts the ante 18
negozin: posts the ante 18
Knutss: posts small blind 60
kanococo: posts big blind 120
*** HOLE CARDS ***
Dealt to kanococo [9h 7h]
MastaBeta: folds
sucio: folds
Nick272727: folds
negozin: folds
Monzadrift: folds
Knutss: calls 60
kanococo: raises 240 to 360
Knutss: calls 240
*** FLOP *** [9s Qd 8d]
Knutss: checks
kanococo: checks
*** TURN *** [9s Qd 8d] [9d]
Knutss: checks
kanococo: bets 846
Knutss: folds
Uncalled bet (846) returned to kanococo
kanococo collected 846 from pot
kanococo: doesn't show hand
*** SUMMARY ***
Total pot 846 | Rake 0
Board [ 9s Qd 8d 9d ]
Game ended: 2025/08/31 21:12:37 GMT
Seat 1: Monzadrift (button) folded before Flop
Seat 2: Knutss (small blind) folded on the Turn
Seat 3: kanococo (big blind) collected (846)
Seat 4: MastaBeta folded before Flop
Seat 5: sucio folded before Flop
Seat 6: Nick272727 folded before Flop
Seat 7: negozin folded before Flop

CoinPoker Hand #290338673: Tournament #1361819, ₮1 Mini Sunday Smash PKO Hold'em No Limit (60/120 ante 18 play) 2025/08/31 21:12:38 GMT
Table '1' 7-max Seat #2 is the button
Seat 1: Monzadrift (10414 in chips, 50 bounty)
Seat 2: Knutss (9424 in chips, 50 bounty)
Seat 3: kanococo (9795 in chips, 50 bounty)
Seat 4: MastaBeta (9330 in chips, 50 bounty)
Seat 5: sucio (11734 in chips, 50 bounty)
Seat 6: Nick272727 (9324 in chips, 50 bounty)
Seat 7: negozin (9979 in chips, 50 bounty)
Monzadrift: posts the ante 18
Knutss: posts the ante 18
kanococo: posts the ante 18
MastaBeta: posts the ante 18
sucio: posts the ante 18
Nick272727: posts the ante 18
negozin: posts the ante 18
kanococo: posts small blind 60
MastaBeta: posts big blind 120
*** HOLE CARDS ***
Dealt to kanococo [9s 2h]
sucio: folds
Nick272727: folds
negozin has timed out
negozin activated time-bank (27 seconds)
negozin: folds
Monzadrift: raises 120 to 240
Knutss: folds
kanococo: folds
MastaBeta: calls 120
*** FLOP *** [3d 7c 8c]
MastaBeta: checks
Monzadrift: checks
*** TURN *** [3d 7c 8c] [Td]
MastaBeta: bets 120
Monzadrift: calls 120
*** RIVER *** [3d 7c 8c Td] [Qh]
MastaBeta: bets 300
Monzadrift: folds
Uncalled bet (300) returned to MastaBeta
MastaBeta collected 906 from pot
MastaBeta: doesn't show hand
*** SUMMARY ***
Total pot 906 | Rake 0
Board [ 3d 7c 8c Td Qh ]
Game ended: 2025/08/31 21:14:16 GMT
Seat 1: Monzadrift folded on the River
Seat 2: Knutss (button) folded before Flop
Seat 3: kanococo (small blind) folded before Flop
Seat 4: MastaBeta (big blind) collected (906)
Seat 5: sucio folded before Flop
Seat 6: Nick272727 folded before Flop
Seat 7: negozin folded before Flop

CoinPoker Hand #290339420: Tournament #1361819, ₮1 Mini Sunday Smash PKO Hold'em No Limit (60/120 ante 18 play) 2025/08/31 21:14:17 GMT
Table '1' 7-max Seat #3 is the button
Seat 1: Monzadrift (10036 in chips, 50 bounty)
Seat 2: Knutss (9406 in chips, 50 bounty)
Seat 3: kanococo (9717 in chips, 50 bounty)
Seat 4: MastaBeta (9858 in chips, 50 bounty)
Seat 5: sucio (11716 in chips, 50 bounty)
Seat 6: Nick272727 (9306 in chips, 50 bounty)
Seat 7: negozin (9961 in chips, 50 bounty)
Monzadrift: posts the ante 18
Knutss: posts the ante 18
kanococo: posts the ante 18
MastaBeta: posts the ante 18
sucio: posts the ante 18
Nick272727: posts the ante 18
negozin: posts the ante 18
MastaBeta: posts small blind 60
sucio: posts big blind 120
*** HOLE CARDS ***
Dealt to kanococo [4h 2h]
Nick272727: raises 180 to 300
negozin: folds
Monzadrift: raises 10018 and is all-in
Knutss: folds
kanococo: folds
MastaBeta: folds
sucio: folds
Nick272727: folds
Monzadrift collected 10624 from pot
Monzadrift has timed out
Monzadrift: doesn't show hand
*** SUMMARY ***
Total pot 10624 | Rake 0
Board [ ]
Game ended: 2025/08/31 21:14:55 GMT
Seat 1: Monzadrift collected (10624)
Seat 2: Knutss folded before Flop
Seat 3: kanococo (button) folded before Flop
Seat 4: MastaBeta (small blind) folded before Flop
Seat 5: sucio (big blind) folded before Flop
Seat 6: Nick272727 folded before Flop
Seat 7: negozin folded before Flop

CoinPoker Hand #290339679: Tournament #1361819, ₮1 Mini Sunday Smash PKO Hold'em No Limit (60/120 ante 18 play) 2025/08/31 21:14:56 GMT
Table '1' 7-max Seat #4 is the button
Seat 1: Monzadrift (10624 in chips, 50 bounty)
Seat 2: Knutss (9388 in chips, 50 bounty)
Seat 3: kanococo (9699 in chips, 50 bounty)
Seat 4: MastaBeta (9780 in chips, 50 bounty)
Seat 5: sucio (11578 in chips, 50 bounty)
Seat 6: Nick272727 (8988 in chips, 50 bounty)
Seat 7: negozin (9943 in chips, 50 bounty)
Monzadrift: posts the ante 18
Knutss: posts the ante 18
kanococo: posts the ante 18
MastaBeta: posts the ante 18
sucio: posts the ante 18
Nick272727: posts the ante 18
negozin: posts the ante 18
sucio: posts small blind 60
Nick272727: posts big blind 120
*** HOLE CARDS ***
Dealt to kanococo [7d 4c]
negozin: folds
Monzadrift: raises 120 to 240
Knutss: raises 600 to 840
kanococo: folds
MastaBeta: folds
sucio: folds
Nick272727: folds
Monzadrift: folds
Knutss collected 1386 from pot
Knutss: doesn't show hand
*** SUMMARY ***
Total pot 1386 | Rake 0
Board [ ]
Game ended: 2025/08/31 21:15:35 GMT
Seat 1: Monzadrift folded before Flop
Seat 2: Knutss collected (1386)
Seat 3: kanococo folded before Flop
Seat 4: MastaBeta (button) folded before Flop
Seat 5: sucio (small blind) folded before Flop
Seat 6: Nick272727 (big blind) folded before Flop
Seat 7: negozin folded before Flop

CoinPoker Hand #290339979: Tournament #1361819, ₮1 Mini Sunday Smash PKO Hold'em No Limit (60/120 ante 18 play) 2025/08/31 21:15:37 GMT
Table '1' 7-max Seat #5 is the button
Seat 1: Monzadrift (10366 in chips, 50 bounty)
Seat 2: Knutss (9916 in chips, 50 bounty)
Seat 3: kanococo (9681 in chips, 50 bounty)
Seat 5: sucio (11500 in chips, 50 bounty)
Seat 6: Nick272727 (8850 in chips, 50 bounty)
Seat 7: negozin (9925 in chips, 50 bounty)
Monzadrift: posts the ante 18
Knutss: posts the ante 18
kanococo: posts the ante 18
sucio: posts the ante 18
Nick272727: posts the ante 18
negozin: posts the ante 18
Nick272727: posts small blind 60
negozin: posts big blind 120
*** HOLE CARDS ***
Dealt to kanococo [4d 9d]
Monzadrift: raises 120 to 240
Knutss: calls 240
kanococo: calls 240
sucio: folds
Nick272727: calls 180
negozin: calls 120
*** FLOP *** [5c 8d 2c]
Nick272727: checks
negozin: checks
Monzadrift: bets 457
Knutss: raises 2116 to 2573
kanococo: folds
Nick272727 has timed out
Nick272727 activated time-bank (1 seconds)
Nick272727 has timed out
Nick272727: folds
negozin: folds
Monzadrift: folds
Uncalled bet (2116) returned to Knutss
Knutss collected 2222 from pot
Knutss: doesn't show hand
*** SUMMARY ***
Total pot 2222 | Rake 0
Board [ 5c 8d 2c ]
Game ended: 2025/08/31 21:16:51 GMT
Seat 1: Monzadrift folded on the Flop
Seat 2: Knutss collected (2222)
Seat 3: kanococo folded on the Flop
Seat 5: sucio (button) folded before Flop
Seat 6: Nick272727 (small blind) folded on the Flop
Seat 7: negozin (big blind) folded on the Flop

CoinPoker Hand #290340578: Tournament #1361819, ₮1 Mini Sunday Smash PKO Hold'em No Limit (60/120 ante 18 play) 2025/08/31 21:16:52 GMT
Table '1' 7-max Seat #6 is the button
Seat 1: Monzadrift (9651 in chips, 50 bounty)
Seat 2: Knutss (11423 in chips, 50 bounty)
Seat 3: kanococo (9423 in chips, 50 bounty)
Seat 5: sucio (11482 in chips, 50 bounty)
Seat 6: Nick272727 (8592 in chips, 50 bounty)
Seat 7: negozin (9667 in chips, 50 bounty)
Monzadrift: posts the ante 18
Knutss: posts the ante 18
kanococo: posts the ante 18
sucio: posts the ante 18
Nick272727: posts the ante 18
negozin: posts the ante 18
negozin: posts small blind 60
Monzadrift: posts big blind 120
*** HOLE CARDS ***
Dealt to kanococo [7s Qh]
Knutss: folds
kanococo: raises 120 to 240
sucio: folds
Nick272727: calls 240
negozin: calls 180
Monzadrift: calls 120
*** FLOP *** [2d Ks 4s]
negozin has timed out
negozin activated time-bank (22 seconds)
negozin: checks
Monzadrift: checks
kanococo: bets 240
Nick272727: raises 660 to 900
negozin: folds
Monzadrift: folds
kanococo: folds
Uncalled bet (660) returned to Nick272727
Nick272727 collected 1548 from pot
Nick272727: doesn't show hand
*** SUMMARY ***
Total pot 1548 | Rake 0
Board [ 2d Ks 4s ]
Game ended: 2025/08/31 21:18:01 GMT
Seat 1: Monzadrift (big blind) folded on the Flop
Seat 2: Knutss folded before Flop
Seat 3: kanococo folded on the Flop
Seat 5: sucio folded before Flop
Seat 6: Nick272727 (button) collected (1548)
Seat 7: negozin (small blind) folded on the Flop

CoinPoker Hand #290341217: Tournament #1361819, ₮1 Mini Sunday Smash PKO Hold'em No Limit (70/140 ante 21 play) 2025/08/31 21:18:06 GMT
Table '1' 7-max Seat #7 is the button
Seat 1: Monzadrift (9393 in chips, 50 bounty)
Seat 2: Knutss (11405 in chips, 50 bounty)
Seat 3: kanococo (8925 in chips, 50 bounty)
Seat 5: sucio (11464 in chips, 50 bounty)
Seat 6: Nick272727 (9642 in chips, 50 bounty)
Seat 7: negozin (9409 in chips, 50 bounty)
Monzadrift: posts the ante 21
Knutss: posts the ante 21
kanococo: posts the ante 21
sucio: posts the ante 21
Nick272727: posts the ante 21
negozin: posts the ante 21
Monzadrift: posts small blind 70
Knutss: posts big blind 140
*** HOLE CARDS ***
Dealt to kanococo [5d 7d]
kanococo: folds
sucio: raises 140 to 280
Nick272727: folds
negozin: raises 700 to 980
Monzadrift: folds
Knutss: folds
sucio: calls 700
*** FLOP *** [7c 2s Kh]
sucio: checks
negozin: bets 757
sucio: folds
Uncalled bet (757) returned to negozin
negozin collected 2296 from pot
negozin has timed out
negozin: doesn't show hand
*** SUMMARY ***
Total pot 2296 | Rake 0
Board [ 7c 2s Kh ]
Game ended: 2025/08/31 21:18:54 GMT
Seat 1: Monzadrift (small blind) folded before Flop
Seat 2: Knutss (big blind) folded before Flop
Seat 3: kanococo folded before Flop
Seat 5: sucio folded on the Flop
Seat 6: Nick272727 folded before Flop
Seat 7: negozin (button) collected (2296)

CoinPoker Hand #290341595: Tournament #1361819, ₮1 Mini Sunday Smash PKO Hold'em No Limit (70/140 ante 21 play) 2025/08/31 21:18:55 GMT
Table '1' 7-max Seat #1 is the button
Seat 1: Monzadrift (9302 in chips, 50 bounty)
Seat 2: Knutss (11244 in chips, 50 bounty)
Seat 3: kanococo (8904 in chips, 50 bounty)
Seat 5: sucio (10463 in chips, 50 bounty)
Seat 6: Nick272727 (9621 in chips, 50 bounty)
Seat 7: negozin (10704 in chips, 50 bounty)
Monzadrift: posts the ante 21
Knutss: posts the ante 21
kanococo: posts the ante 21
sucio: posts the ante 21
Nick272727: posts the ante 21
negozin: posts the ante 21
Knutss: posts small blind 70
kanococo: posts big blind 140
*** HOLE CARDS ***
Dealt to kanococo [3d 7c]
sucio: folds
Nick272727: folds
negozin has timed out
negozin activated time-bank (21 seconds)
negozin: raises 140 to 280
Monzadrift: folds
Knutss: calls 210
Deuce27Low has reconnected
kanococo: folds
*** FLOP *** [7d Kd 8h]
Knutss: checks
negozin: checks
*** TURN *** [7d Kd 8h] [6h]
Knutss: bets 413
negozin: calls 413
*** RIVER *** [7d Kd 8h 6h] [8c]
Knutss has timed out
Knutss activated time-bank (30 seconds)
Knutss: bets 1652
negozin: folds
Uncalled bet (1652) returned to Knutss
Knutss collected 1652 from pot
Knutss: doesn't show hand
*** SUMMARY ***
Total pot 1652 | Rake 0
Board [ 7d Kd 8h 6h 8c ]
Game ended: 2025/08/31 21:20:26 GMT
Seat 1: Monzadrift (button) folded before Flop
Seat 2: Knutss (small blind) collected (1652)
Seat 3: kanococo (big blind) folded before Flop
Seat 5: sucio folded before Flop
Seat 6: Nick272727 folded before Flop
Seat 7: negozin folded on the River

CoinPoker Hand #290342249: Tournament #1361819, ₮1 Mini Sunday Smash PKO Hold'em No Limit (70/140 ante 21 play) 2025/08/31 21:20:26 GMT
Table '1' 7-max Seat #2 is the button
Seat 1: Monzadrift (9281 in chips, 50 bounty)
Seat 2: Knutss (12182 in chips, 50 bounty)
Seat 3: kanococo (8743 in chips, 50 bounty)
Seat 4: Deuce27Low (10000 in chips, 50 bounty)
Seat 5: sucio (10442 in chips, 50 bounty)
Seat 6: Nick272727 (9600 in chips, 50 bounty)
Seat 7: negozin (9990 in chips, 50 bounty)
Monzadrift: posts the ante 21
Knutss: posts the ante 21
kanococo: posts the ante 21
Deuce27Low: posts the ante 21
sucio: posts the ante 21
Nick272727: posts the ante 21
negozin: posts the ante 21
kanococo: posts small blind 70
Deuce27Low: posts big blind 140
*** HOLE CARDS ***
Dealt to kanococo [4h Qc]
sucio: raises 140 to 280
Nick272727: raises 490 to 770
negozin: folds
Monzadrift: folds
Knutss: folds
kanococo: folds
Deuce27Low: folds
sucio: calls 490
*** FLOP *** [Ts 2h Jd]
sucio: checks
Nick272727: bets 1897
sucio: raises 9651 and is all-in
Nick272727: calls 6912 and is all-in
Uncalled bet (842) returned to sucio
*** TURN *** [Ts 2h Jd] [8s]
*** RIVER *** [Ts 2h Jd 8s] [5d]
*** SHOW DOWN ***
sucio: shows [Qs Jh] (a pair of Jacks)
Nick272727: shows [Kd Ac] (Ace high)
sucio collected 19515 from pot
*** SUMMARY ***
Total pot 19515 | Rake 0
Board [ Ts 2h Jd 8s 5d ]
Game ended: 2025/08/31 21:21:26 GMT
Seat 1: Monzadrift folded before Flop
Seat 2: Knutss (button) folded before Flop
Seat 3: kanococo (small blind) folded before Flop
Seat 4: Deuce27Low (big blind) folded before Flop
Seat 5: sucio showed [Qs Jh] and won (19515) with a pair of Jacks
Seat 6: Nick272727 showed [Kd Ac]
Seat 7: negozin folded before Flop

CoinPoker Hand #290342671: Tournament #1361819, ₮1 Mini Sunday Smash PKO Hold'em No Limit (70/140 ante 21 play) 2025/08/31 21:21:27 GMT
Table '1' 7-max Seat #3 is the button
Seat 1: Monzadrift (9260 in chips, 50 bounty)
Seat 2: Knutss (12161 in chips, 50 bounty)
Seat 3: kanococo (8652 in chips, 50 bounty)
Seat 4: Deuce27Low (9839 in chips, 50 bounty)
Seat 5: sucio (20357 in chips, 75 bounty)
Seat 7: negozin (9969 in chips, 50 bounty)
Monzadrift: posts the ante 21
Knutss: posts the ante 21
kanococo: posts the ante 21
Deuce27Low: posts the ante 21
sucio: posts the ante 21
negozin: posts the ante 21
Deuce27Low: posts small blind 70
sucio: posts big blind 140
*** HOLE CARDS ***
Dealt to kanococo [Ad Kc]
negozin: folds
Monzadrift: folds
Knutss: folds
kanococo: raises 280 to 420
Deuce27Low: folds
sucio: folds
kanococo collected 756 from pot
kanococo: doesn't show hand
*** SUMMARY ***
Total pot 756 | Rake 0
Board [ ]
Game ended: 2025/08/31 21:21:49 GMT
Seat 1: Monzadrift folded before Flop
Seat 2: Knutss folded before Flop
Seat 3: kanococo (button) collected (756)
Seat 4: Deuce27Low (small blind) folded before Flop
Seat 5: sucio (big blind) folded before Flop
Seat 7: negozin folded before Flop

CoinPoker Hand #290342773: Tournament #1361819, ₮1 Mini Sunday Smash PKO Hold'em No Limit (70/140 ante 21 play) 2025/08/31 21:21:51 GMT
Table '1' 7-max Seat #4 is the button
Seat 1: Monzadrift (9239 in chips, 50 bounty)
Seat 2: Knutss (12140 in chips, 50 bounty)
Seat 3: kanococo (8967 in chips, 50 bounty)
Seat 4: Deuce27Low (9748 in chips, 50 bounty)
Seat 5: sucio (20196 in chips, 75 bounty)
Seat 7: negozin (9948 in chips, 50 bounty)
Monzadrift: posts the ante 21
Knutss: posts the ante 21
kanococo: posts the ante 21
Deuce27Low: posts the ante 21
sucio: posts the ante 21
negozin: posts the ante 21
sucio: posts small blind 70
negozin: posts big blind 140
*** HOLE CARDS ***
Dealt to kanococo [Ad 6s]
Monzadrift: folds
Knutss: folds
kanococo: raises 140 to 280
Deuce27Low: calls 280
sucio: folds
negozin has timed out
negozin activated time-bank (20 seconds)
negozin: folds
*** FLOP *** [As 3d 4s]
kanococo: checks
Deuce27Low: bets 728
kanococo: calls 728
*** TURN *** [As 3d 4s] [7c]
kanococo: bets 2352
Deuce27Low: folds
Uncalled bet (2352) returned to kanococo
kanococo collected 2352 from pot
kanococo: doesn't show hand
*** SUMMARY ***
Total pot 2352 | Rake 0
Board [ As 3d 4s 7c ]
Game ended: 2025/08/31 21:23:00 GMT
Seat 1: Monzadrift folded before Flop
Seat 2: Knutss folded before Flop
Seat 3: kanococo collected (2352)
Seat 4: Deuce27Low (button) folded on the Turn
Seat 5: sucio (small blind) folded before Flop
Seat 7: negozin (big blind) folded before Flop

CoinPoker Hand #290343413: Tournament #1361819, ₮1 Mini Sunday Smash PKO Hold'em No Limit (80/160 ante 24 play) 2025/08/31 21:23:05 GMT
Table '1' 7-max Seat #5 is the button
Seat 1: Monzadrift (9218 in chips, 50 bounty)
Seat 2: Knutss (12119 in chips, 50 bounty)
Seat 3: kanococo (10290 in chips, 50 bounty)
Seat 4: Deuce27Low (8719 in chips, 50 bounty)
Seat 5: sucio (20105 in chips, 75 bounty)
Seat 7: negozin (9787 in chips, 50 bounty)
Monzadrift: posts the ante 24
Knutss: posts the ante 24
kanococo: posts the ante 24
Deuce27Low: posts the ante 24
sucio: posts the ante 24
negozin: posts the ante 24
negozin: posts small blind 80
Monzadrift: posts big blind 160
*** HOLE CARDS ***
Dealt to kanococo [3c Th]
Knutss: folds
kanococo: folds
Deuce27Low: folds
sucio: raises 160 to 320
negozin: calls 240
Monzadrift: calls 160
*** FLOP *** [2h 7h 5s]
negozin has timed out
negozin activated time-bank (18 seconds)
negozin: checks
Monzadrift: checks
sucio: checks
*** TURN *** [2h 7h 5s] [Jd]
negozin: checks
Monzadrift: bets 386
sucio: folds
negozin: folds
Uncalled bet (386) returned to Monzadrift
Monzadrift collected 1104 from pot
Monzadrift has timed out
Monzadrift: doesn't show hand
*** SUMMARY ***
Total pot 1104 | Rake 0
Board [ 2h 7h 5s Jd ]
Game ended: 2025/08/31 21:24:40 GMT
Seat 1: Monzadrift (big blind) collected (1104)
Seat 2: Knutss folded before Flop
Seat 3: kanococo folded before Flop
Seat 4: Deuce27Low folded before Flop
Seat 5: sucio (button) folded on the Turn
Seat 7: negozin (small blind) folded on the Turn

CoinPoker Hand #290344244: Tournament #1361819, ₮1 Mini Sunday Smash PKO Hold'em No Limit (80/160 ante 24 play) 2025/08/31 21:24:41 GMT
Table '1' 7-max Seat #7 is the button
Seat 1: Monzadrift (9978 in chips, 50 bounty)
Seat 2: Knutss (12095 in chips, 50 bounty)
Seat 3: kanococo (10266 in chips, 50 bounty)
Seat 4: Deuce27Low (8695 in chips, 50 bounty)
Seat 5: sucio (19761 in chips, 75 bounty)
Seat 7: negozin (9443 in chips, 50 bounty)
Monzadrift: posts the ante 24
Knutss: posts the ante 24
kanococo: posts the ante 24
Deuce27Low: posts the ante 24
sucio: posts the ante 24
negozin: posts the ante 24
Monzadrift: posts small blind 80
Knutss: posts big blind 160
*** HOLE CARDS ***
Dealt to kanococo [9h 7s]
kanococo: folds
Deuce27Low: folds
sucio: folds
negozin: raises 240 to 400
Monzadrift: raises 1104 to 1504
Knutss: folds
negozin: folds
Monzadrift collected 2208 from pot
Monzadrift has timed out
Monzadrift: doesn't show hand
*** SUMMARY ***
Total pot 2208 | Rake 0
Board [ ]
Game ended: 2025/08/31 21:25:20 GMT
Seat 1: Monzadrift (small blind) collected (2208)
Seat 2: Knutss (big blind) folded before Flop
Seat 3: kanococo folded before Flop
Seat 4: Deuce27Low folded before Flop
Seat 5: sucio folded before Flop
Seat 7: negozin (button) folded before Flop

CoinPoker Hand #290344636: Tournament #1361819, ₮1 Mini Sunday Smash PKO Hold'em No Limit (80/160 ante 24 play) 2025/08/31 21:25:21 GMT
Table '1' 7-max Seat #1 is the button
Seat 1: Monzadrift (10658 in chips, 50 bounty)
Seat 2: Knutss (11911 in chips, 50 bounty)
Seat 3: kanococo (10242 in chips, 50 bounty)
Seat 4: Deuce27Low (8671 in chips, 50 bounty)
Seat 5: sucio (19737 in chips, 75 bounty)
Seat 7: negozin (9019 in chips, 50 bounty)
Monzadrift: posts the ante 24
Knutss: posts the ante 24
kanococo: posts the ante 24
Deuce27Low: posts the ante 24
sucio: posts the ante 24
negozin: posts the ante 24
Knutss: posts small blind 80
kanococo: posts big blind 160
*** HOLE CARDS ***
Dealt to kanococo [7c 4h]
Deuce27Low: folds
sucio: folds
negozin: raises 160 to 320
Monzadrift: folds
Knutss: raises 1040 to 1360
kanococo: folds
negozin: raises 2640 to 4000
Knutss: folds
negozin collected 5664 from pot
negozin: doesn't show hand
*** SUMMARY ***
Total pot 5664 | Rake 0
Board [ ]
Game ended: 2025/08/31 21:26:07 GMT
Seat 1: Monzadrift (button) folded before Flop
Seat 2: Knutss (small blind) folded before Flop
Seat 3: kanococo (big blind) folded before Flop
Seat 4: Deuce27Low folded before Flop
Seat 5: sucio folded before Flop
Seat 7: negozin collected (5664)

CoinPoker Hand #290344996: Tournament #1361819, ₮1 Mini Sunday Smash PKO Hold'em No Limit (80/160 ante 24 play) 2025/08/31 21:26:08 GMT
Table '1' 7-max Seat #2 is the button
Seat 1: Monzadrift (10634 in chips, 50 bounty)
Seat 2: Knutss (10527 in chips, 50 bounty)
Seat 3: kanococo (10058 in chips, 50 bounty)
Seat 4: Deuce27Low (8647 in chips, 50 bounty)
Seat 5: sucio (19713 in chips, 75 bounty)
Seat 7: negozin (10659 in chips, 50 bounty)
Monzadrift: posts the ante 24
Knutss: posts the ante 24
kanococo: posts the ante 24
Deuce27Low: posts the ante 24
sucio: posts the ante 24
negozin: posts the ante 24
kanococo: posts small blind 80
Deuce27Low: posts big blind 160
*** HOLE CARDS ***
Dealt to kanococo [3h 8c]
sucio: folds
negozin: folds
Monzadrift: folds
Knutss: raises 160 to 320
kanococo: folds
Deuce27Low: folds
Knutss collected 704 from pot
Knutss: doesn't show hand
*** SUMMARY ***
Total pot 704 | Rake 0
Board [ ]
Game ended: 2025/08/31 21:26:24 GMT
Seat 1: Monzadrift folded before Flop
Seat 2: Knutss (button) collected (704)
Seat 3: kanococo (small blind) folded before Flop
Seat 4: Deuce27Low (big blind) folded before Flop
Seat 5: sucio folded before Flop
Seat 7: negozin folded before Flop

CoinPoker Hand #290345081: Tournament #1361819, ₮1 Mini Sunday Smash PKO Hold'em No Limit (80/160 ante 24 play) 2025/08/31 21:26:26 GMT
Table '1' 7-max Seat #3 is the button
Seat 1: Monzadrift (10610 in chips, 50 bounty)
Seat 2: Knutss (10887 in chips, 50 bounty)
Seat 3: kanococo (9954 in chips, 50 bounty)
Seat 4: Deuce27Low (8463 in chips, 50 bounty)
Seat 5: sucio (19689 in chips, 75 bounty)
Seat 7: negozin (10635 in chips, 50 bounty)
Monzadrift: posts the ante 24
Knutss: posts the ante 24
kanococo: posts the ante 24
Deuce27Low: posts the ante 24
sucio: posts the ante 24
negozin: posts the ante 24
Deuce27Low: posts small blind 80
sucio: posts big blind 160
*** HOLE CARDS ***
Dealt to kanococo [Jh 2d]
Zhrveil has reconnected
negozin: folds
Monzadrift: folds
Knutss: folds
kanococo: raises 160 to 320
Deuce27Low: folds
sucio: calls 160
*** FLOP *** [Kd Ah 7s]
sucio: checks
kanococo: checks
*** TURN *** [Kd Ah 7s] [Js]
sucio: bets 272
kanococo: raises 704 to 976
sucio: raises 976 to 1952
kanococo: calls 976
*** RIVER *** [Kd Ah 7s Js] [9c]
sucio: bets 17393 and is all-in
kanococo: calls 7658 and is all-in
Uncalled bet (9735) returned to sucio
*** SHOW DOWN ***
sucio: shows [Tc Qd] (a straight, Ace high)
kanococo: shows [Jh 2d] (a pair of Jacks)
sucio collected 20084 from pot
*** SUMMARY ***
Total pot 20084 | Rake 0
Board [ Kd Ah 7s Js 9c ]
Game ended: 2025/08/31 21:27:22 GMT
Seat 1: Monzadrift folded before Flop
Seat 2: Knutss folded before Flop
Seat 3: kanococo (button) showed [Jh 2d]
Seat 4: Deuce27Low (small blind) folded before Flop
Seat 5: sucio (big blind) showed [Tc Qd] and won (20084) with a straight, Ace high
Seat 7: negozin folded before Flop

CoinPoker Hand #290345861: Tournament #1361819, ₮1 Mini Sunday Smash PKO Hold'em No Limit (80/160 ante 24 play) 2025/08/31 21:28:15 GMT
Table '1' 7-max Seat #5 is the button
Seat 1: Monzadrift (10242 in chips, 50 bounty)
Seat 2: Knutss (10839 in chips, 50 bounty)
Seat 3: kanococo (10000 in chips, 50 bounty)
Seat 4: Deuce27Low (9039 in chips, 50 bounty)
Seat 5: sucio (29715 in chips, 100 bounty)
Seat 6: Zhrveil (9816 in chips, 50 bounty)
Seat 7: negozin (10587 in chips, 50 bounty)
Monzadrift: posts the ante 24
Knutss: posts the ante 24
kanococo: posts the ante 24
Deuce27Low: posts the ante 24
sucio: posts the ante 24
Zhrveil: posts the ante 24
negozin: posts the ante 24
Zhrveil: posts small blind 80
negozin: posts big blind 160
*** HOLE CARDS ***
Dealt to kanococo [Kh 9h]
Monzadrift: folds
Knutss: folds
kanococo: raises 320 to 480
Deuce27Low: calls 480
sucio: folds
Zhrveil: folds
negozin: folds
*** FLOP *** [Ac 6h 5s]
kanococo: bets 684
Deuce27Low: folds
Uncalled bet (684) returned to kanococo
kanococo collected 1368 from pot
kanococo: doesn't show hand
*** SUMMARY ***
Total pot 1368 | Rake 0
Board [ Ac 6h 5s ]
Game ended: 2025/08/31 21:28:51 GMT
Seat 1: Monzadrift folded before Flop
Seat 2: Knutss folded before Flop
Seat 3: kanococo collected (1368)
Seat 4: Deuce27Low folded on the Flop
Seat 5: sucio (button) folded before Flop
Seat 6: Zhrveil (small blind) folded before Flop
Seat 7: negozin (big blind) folded before Flop

CoinPoker Hand #290346186: Tournament #1361819, ₮1 Mini Sunday Smash PKO Hold'em No Limit (80/160 ante 24 play) 2025/08/31 21:28:53 GMT
Table '1' 7-max Seat #6 is the button
Seat 1: Monzadrift (10218 in chips, 50 bounty)
Seat 2: Knutss (10815 in chips, 50 bounty)
Seat 3: kanococo (10864 in chips, 50 bounty)
Seat 4: Deuce27Low (8535 in chips, 50 bounty)
Seat 5: sucio (29691 in chips, 100 bounty)
Seat 6: Zhrveil (9712 in chips, 50 bounty)
Seat 7: negozin (10403 in chips, 50 bounty)
Monzadrift: posts the ante 24
Knutss: posts the ante 24
kanococo: posts the ante 24
Deuce27Low: posts the ante 24
sucio: posts the ante 24
Zhrveil: posts the ante 24
negozin: posts the ante 24
negozin: posts small blind 80
Monzadrift: posts big blind 160
*** HOLE CARDS ***
Dealt to kanococo [Tc 9h]
Knutss: raises 160 to 320
kanococo: folds
Deuce27Low: folds
sucio: folds
Zhrveil: folds
negozin: folds
Monzadrift: calls 160
*** FLOP *** [6c 8h 4c]
Monzadrift: checks
Knutss: checks
*** TURN *** [6c 8h 4c] [7h]
Monzadrift: checks
Knutss: checks
*** RIVER *** [6c 8h 4c 7h] [Ks]
Monzadrift: bets 666
Knutss: folds
Uncalled bet (666) returned to Monzadrift
Monzadrift collected 888 from pot
Monzadrift has timed out
Monzadrift: doesn't show hand
*** SUMMARY ***
Total pot 888 | Rake 0
Board [ 6c 8h 4c 7h Ks ]
Game ended: 2025/08/31 21:29:49 GMT
Seat 1: Monzadrift (big blind) collected (888)
Seat 2: Knutss folded on the River
Seat 3: kanococo folded before Flop
Seat 4: Deuce27Low folded before Flop
Seat 5: sucio folded before Flop
Seat 6: Zhrveil (button) folded before Flop
Seat 7: negozin (small blind) folded before Flop

CoinPoker Hand #290346508: Tournament #1361819, ₮1 Mini Sunday Smash PKO Hold'em No Limit (100/200 ante 30 play) 2025/08/31 21:29:55 GMT
Table '1' 7-max Seat #7 is the button
Seat 1: Monzadrift (10762 in chips, 50 bounty)
Seat 2: Knutss (10471 in chips, 50 bounty)
Seat 3: kanococo (10840 in chips, 50 bounty)
Seat 4: Deuce27Low (8511 in chips, 50 bounty)
Seat 5: sucio (29667 in chips, 100 bounty)
Seat 6: Zhrveil (9688 in chips, 50 bounty)
Seat 7: negozin (10299 in chips, 50 bounty)
Monzadrift: posts the ante 30
Knutss: posts the ante 30
kanococo: posts the ante 30
Deuce27Low: posts the ante 30
sucio: posts the ante 30
Zhrveil: posts the ante 30
negozin: posts the ante 30
Monzadrift: posts small blind 100
Knutss: posts big blind 200
*** HOLE CARDS ***
Dealt to kanococo [Ah Tc]
kanococo: calls 200
Deuce27Low: folds
sucio: folds
Zhrveil: folds
negozin: folds
Monzadrift: calls 100
Knutss: checks
*** FLOP *** [9s 7c As]
Monzadrift: checks
Knutss: checks
kanococo: bets 200
Monzadrift: calls 200
Knutss: folds
*** TURN *** [9s 7c As] [8c]
Monzadrift: checks
kanococo: bets 605
Monzadrift: raises 1395 to 2000
kanococo: raises 9805 and is all-in
Monzadrift: calls 8332 and is all-in
Uncalled bet (78) returned to kanococo
*** RIVER *** [9s 7c As 8c] [3d]
*** SHOW DOWN ***
kanococo: shows [Ah Tc] (a pair of Aces)
Monzadrift: shows [Ts Jh] (a straight, Jack high)
Monzadrift collected 21874 from pot
*** SUMMARY ***
Total pot 21874 | Rake 0
Board [ 9s 7c As 8c 3d ]
Game ended: 2025/08/31 21:30:54 GMT
Seat 1: Monzadrift (small blind) showed [Ts Jh] and won (21874) with a straight, Jack high
Seat 2: Knutss (big blind) folded on the Flop
Seat 3: kanococo showed [Ah Tc]
Seat 4: Deuce27Low folded before Flop
Seat 5: sucio folded before Flop
Seat 6: Zhrveil folded before Flop
Seat 7: negozin (button) folded before Flop

CoinPoker Hand #290346930: Tournament #1361819, ₮1 Mini Sunday Smash PKO Hold'em No Limit (100/200 ante 30 play) 2025/08/31 21:30:55 GMT
Table '1' 7-max Seat #1 is the button
Seat 1: Monzadrift (21874 in chips, 50 bounty)
Seat 2: Knutss (10241 in chips, 50 bounty)
Seat 3: kanococo (78 in chips, 50 bounty)
Seat 4: Deuce27Low (8481 in chips, 50 bounty)
Seat 5: sucio (29637 in chips, 100 bounty)
Seat 6: Zhrveil (9658 in chips, 50 bounty)
Seat 7: negozin (10269 in chips, 50 bounty)
Monzadrift: posts the ante 30
Knutss: posts the ante 30
kanococo: posts the ante 30
Deuce27Low: posts the ante 30
sucio: posts the ante 30
Zhrveil: posts the ante 30
negozin: posts the ante 30
Knutss: posts small blind 100
kanococo: posts big blind 48 and is all-in
*** HOLE CARDS ***
Dealt to kanococo [5s 3h]
Deuce27Low: folds
sucio: folds
Zhrveil: raises 300 to 500
negozin: folds
Monzadrift: calls 500
Knutss: calls 400
*** FLOP *** [5h 3c 2d]
Knutss: checks
Zhrveil: checks
Monzadrift: bets 879
Knutss: folds
Zhrveil: folds
Uncalled bet (879) returned to Monzadrift
Monzadrift collected 1356 from side-pot 1
*** TURN *** [5h 3c 2d] [4s]
*** RIVER *** [5h 3c 2d 4s] [3d]
*** SHOW DOWN ***
kanococo: shows [5s 3h] (a full house, Threes over Fives)
kanococo collected 402 from pot
*** SUMMARY ***
Total pot 1758 | Rake 0
Board [ 5h 3c 2d 4s 3d ]
Game ended: 2025/08/31 21:31:49 GMT
Seat 1: Monzadrift (button) showed [9h Ah] and won (1356) with a straight, Five high
Seat 2: Knutss (small blind) folded on the Flop
Seat 3: kanococo (big blind) showed [5s 3h] and won (402) with a full house, Threes over Fives
Seat 4: Deuce27Low folded before Flop
Seat 5: sucio folded before Flop
Seat 6: Zhrveil folded on the Flop
Seat 7: negozin folded before Flop

CoinPoker Hand #290348562: Hold'em No Limit (0.01/0.02 ) 2025/08/31 21:31:49 GMT
Table 'NL ₮2 VI' 7-max Seat #2 is the button
Seat 1: zuzi777 (1.96 in chips)
Seat 2: TriangleHowl (2.14 in chips)
Seat 3: mitzaro (1.85 in chips)
Seat 4: ale12GM (1.64 in chips)
Seat 5: araivaivai (8.05 in chips)
Seat 6: Japay (2.00 in chips)
Seat 7: kanococo (2.00 in chips)
mitzaro: posts small blind 0.01
ale12GM: posts big blind 0.02
Japay: posts big blind 0.02
kanococo: posts big blind 0.02
*** HOLE CARDS ***
Dealt to kanococo [Qc 2s]
araivaivai: raises 0.08 to 0.10
Japay: folds
kanococo: folds
zuzi777: folds
TriangleHowl: folds
mitzaro: folds
ale12GM: folds
araivaivai collected 0.17 from pot
araivaivai: doesn't show hand
*** SUMMARY ***
Total pot 0.17 | Rake 0.00
Board [ ]
Game ended: 2025/08/31 21:32:15 GMT
Seat 1: zuzi777 folded before Flop (didn't bet)
Seat 2: TriangleHowl (button) folded before Flop (didn't bet)
Seat 3: mitzaro (small blind) folded before Flop
Seat 4: ale12GM (big blind) folded before Flop
Seat 5: araivaivai collected (0.17)
Seat 6: Japay folded before Flop
Seat 7: kanococo folded before Flop

CoinPoker Hand #290347281: Tournament #1361819, ₮1 Mini Sunday Smash PKO Hold'em No Limit (100/200 ante 30 play) 2025/08/31 21:31:50 GMT
Table '1' 7-max Seat #2 is the button
Seat 1: Monzadrift (22700 in chips, 50 bounty)
Seat 2: Knutss (9711 in chips, 50 bounty)
Seat 3: kanococo (402 in chips, 50 bounty)
Seat 4: Deuce27Low (8451 in chips, 50 bounty)
Seat 5: sucio (29607 in chips, 100 bounty)
Seat 6: Zhrveil (9128 in chips, 50 bounty)
Seat 7: negozin (10239 in chips, 50 bounty)
Monzadrift: posts the ante 30
Knutss: posts the ante 30
kanococo: posts the ante 30
Deuce27Low: posts the ante 30
sucio: posts the ante 30
Zhrveil: posts the ante 30
negozin: posts the ante 30
kanococo: posts small blind 100
Deuce27Low: posts big blind 200
*** HOLE CARDS ***
Dealt to kanococo [6d Qd]
sucio: folds
Zhrveil: raises 300 to 500
negozin: folds
Monzadrift: calls 500
Knutss: folds
kanococo has timed out wile being disconnected
kanococo activated time-bank (30 seconds)
kanococo has timed out wile being disconnected
kanococo: folds
Deuce27Low: calls 300
*** FLOP *** [8c 5d Js]
Deuce27Low: checks
Zhrveil: checks
Monzadrift: bets 633
Deuce27Low: calls 633
Zhrveil: folds
*** TURN *** [8c 5d Js] [5c]
Deuce27Low: checks
Monzadrift: checks
*** RIVER *** [8c 5d Js 5c] [9c]
Deuce27Low has timed out
Deuce27Low activated time-bank (30 seconds)
Deuce27Low: bets 7288 and is all-in
Monzadrift: folds
Uncalled bet (7288) returned to Deuce27Low
Deuce27Low collected 3076 from pot
Deuce27Low: doesn't show hand
*** SUMMARY ***
Total pot 3076 | Rake 0
Board [ 8c 5d Js 5c 9c ]
Game ended: 2025/08/31 21:34:44 GMT
Seat 1: Monzadrift folded on the River
Seat 2: Knutss (button) folded before Flop
Seat 3: kanococo (small blind) folded before Flop
Seat 4: Deuce27Low (big blind) collected (3076)
Seat 5: sucio folded before Flop
Seat 6: Zhrveil folded on the Flop
Seat 7: negozin folded before Flop

CoinPoker Hand #290348792: Hold'em No Limit (0.01/0.02 ) 2025/08/31 21:32:17 GMT
Table 'NL ₮2 VI' 7-max Seat #3 is the button
Seat 1: zuzi777 (1.96 in chips)
Seat 2: TriangleHowl (2.14 in chips)
Seat 3: mitzaro (1.84 in chips)
Seat 4: ale12GM (1.62 in chips)
Seat 5: araivaivai (8.12 in chips)
Seat 6: Japay (1.98 in chips)
Seat 7: kanococo (1.98 in chips)
ale12GM: posts small blind 0.01
araivaivai: posts big blind 0.02
*** HOLE CARDS ***
Dealt to kanococo [8h 8s]
Japay: folds
kanococo: raises 0.02 to 0.04
zuzi777: folds
TriangleHowl: folds
mitzaro: folds
ale12GM: folds
araivaivai: raises 0.06 to 0.10
kanococo: calls 0.06
*** FLOP *** [2s 7h Ts]
araivaivai: checks
kanococo: checks
*** TURN *** [2s 7h Ts] [7c]
araivaivai: checks
kanococo: bets 0.10
araivaivai: folds
Uncalled bet (0.10) returned to kanococo
kanococo collected 0.20 from pot
kanococo: doesn't show hand
*** SUMMARY ***
Total pot 0.21 | Rake 0.01
Board [ 2s 7h Ts 7c ]
Game ended: 2025/08/31 21:33:18 GMT
Seat 1: zuzi777 folded before Flop (didn't bet)
Seat 2: TriangleHowl folded before Flop (didn't bet)
Seat 3: mitzaro (button) folded before Flop (didn't bet)
Seat 4: ale12GM (small blind) folded before Flop
Seat 5: araivaivai (big blind) folded on the Turn
Seat 6: Japay folded before Flop (didn't bet)
Seat 7: kanococo collected (0.20)

CoinPoker Hand #290349321: Hold'em No Limit (0.01/0.02 ) 2025/08/31 21:33:20 GMT
Table 'NL ₮2 VI' 7-max Seat #4 is the button
Seat 1: zuzi777 (1.96 in chips)
Seat 2: TriangleHowl (2.14 in chips)
Seat 3: mitzaro (1.84 in chips)
Seat 4: ale12GM (1.61 in chips)
Seat 5: araivaivai (8.02 in chips)
Seat 6: Japay (2.00 in chips)
Seat 7: kanococo (2.08 in chips)
araivaivai: posts small blind 0.01
Japay: posts big blind 0.02
*** HOLE CARDS ***
Dealt to kanococo [9s 3d]
kanococo: folds
zuzi777: folds
TriangleHowl: folds
mitzaro: folds
ale12GM: raises 0.03 to 0.05
araivaivai: folds
Japay: folds
ale12GM collected 0.08 from pot
ale12GM: doesn't show hand
*** SUMMARY ***
Total pot 0.08 | Rake 0.00
Board [ ]
Game ended: 2025/08/31 21:34:00 GMT
Seat 1: zuzi777 folded before Flop (didn't bet)
Seat 2: TriangleHowl folded before Flop (didn't bet)
Seat 3: mitzaro folded before Flop (didn't bet)
Seat 4: ale12GM (button) collected (0.08)
Seat 5: araivaivai (small blind) folded before Flop
Seat 6: Japay (big blind) folded before Flop
Seat 7: kanococo folded before Flop (didn't bet)

CoinPoker Hand #290349688: Hold'em No Limit (0.01/0.02 ) 2025/08/31 21:34:02 GMT
Table 'NL ₮2 VI' 7-max Seat #5 is the button
Seat 1: zuzi777 (1.96 in chips)
Seat 2: TriangleHowl (2.14 in chips)
Seat 3: mitzaro (1.84 in chips)
Seat 4: ale12GM (1.64 in chips)
Seat 5: araivaivai (8.01 in chips)
Seat 6: Japay (2.00 in chips)
Seat 7: kanococo (2.08 in chips)
Japay: posts small blind 0.01
kanococo: posts big blind 0.02
*** HOLE CARDS ***
Dealt to kanococo [Js Ah]
zuzi777: folds
TriangleHowl: raises 0.04 to 0.06
mitzaro: folds
ale12GM: folds
araivaivai: folds
Japay: folds
kanococo: calls 0.04
*** FLOP *** [9c 6c Jh]
kanococo: bets 0.06
TriangleHowl: calls 0.06
*** TURN *** [9c 6c Jh] [7d]
kanococo: bets 0.24
TriangleHowl: calls 0.24
*** RIVER *** [9c 6c Jh 7d] [9d]
kanococo: bets 0.34
TriangleHowl: raises 1.78 and is all-in
kanococo: calls 1.38 and is all-in
Uncalled bet (0.06) returned to TriangleHowl
*** SHOW DOWN ***
TriangleHowl: shows [Qs Kh] (a pair of Nines)
kanococo: shows [Js Ah] (two pairs, Jacks and Nines)
kanococo collected 3.97 from pot
*** SUMMARY ***
Total pot 4.17 | Rake 0.20
Board [ 9c 6c Jh 7d 9d ]
Game ended: 2025/08/31 21:35:02 GMT
Seat 1: zuzi777 folded before Flop (didn't bet)
Seat 2: TriangleHowl showed [Qs Kh]
Seat 3: mitzaro folded before Flop (didn't bet)
Seat 4: ale12GM folded before Flop (didn't bet)
Seat 5: araivaivai (button) folded before Flop (didn't bet)
Seat 6: Japay (small blind) folded before Flop
Seat 7: kanococo (big blind) showed [Js Ah] and won (3.97) with two pairs, Jacks and Nines

CoinPoker Hand #290348826: Tournament #1361819, ₮1 Mini Sunday Smash PKO Hold'em No Limit (100/200 ante 30 play) 2025/08/31 21:34:46 GMT
Table '1' 7-max Seat #3 is the button
Seat 1: Monzadrift (21537 in chips, 50 bounty)
Seat 2: Knutss (9681 in chips, 50 bounty)
Seat 3: kanococo (272 in chips, 50 bounty) is sitting out
Seat 4: Deuce27Low (10364 in chips, 50 bounty)
Seat 5: sucio (29577 in chips, 100 bounty)
Seat 6: Zhrveil (8598 in chips, 50 bounty)
Seat 7: negozin (10209 in chips, 50 bounty)
Monzadrift: posts the ante 30
Knutss: posts the ante 30
kanococo: posts the ante 30
Deuce27Low: posts the ante 30
sucio: posts the ante 30
Zhrveil: posts the ante 30
negozin: posts the ante 30
Deuce27Low: posts small blind 100
sucio: posts big blind 200
*** HOLE CARDS ***
Dealt to kanococo [4s 8c]
Zhrveil: folds
negozin: folds
Monzadrift: raises 200 to 400
Knutss: folds
kanococo: folds
Deuce27Low: folds
sucio: calls 200
*** FLOP *** [Ah Js 3d]
sucio: checks
Monzadrift: bets 388
sucio: folds
Uncalled bet (388) returned to Monzadrift
Monzadrift collected 1110 from pot
Monzadrift has timed out
Monzadrift: doesn't show hand
*** SUMMARY ***
Total pot 1110 | Rake 0
Board [ Ah Js 3d ]
Game ended: 2025/08/31 21:35:21 GMT
Seat 1: Monzadrift collected (1110)
Seat 2: Knutss folded before Flop
Seat 3: kanococo (button) folded before Flop
Seat 4: Deuce27Low (small blind) folded before Flop
Seat 5: sucio (big blind) folded on the Flop
Seat 6: Zhrveil folded before Flop
Seat 7: negozin folded before Flop

CoinPoker Hand #290350292: Hold'em No Limit (0.01/0.02 ) 2025/08/31 21:35:04 GMT
Table 'NL ₮2 VI' 7-max Seat #6 is the button
Seat 1: zuzi777 (1.96 in chips)
Seat 2: TriangleHowl (0.06 in chips)
Seat 3: mitzaro (1.84 in chips)
Seat 4: ale12GM (1.64 in chips)
Seat 5: araivaivai (8.01 in chips)
Seat 6: Japay (1.99 in chips)
Seat 7: kanococo (3.97 in chips)
kanococo: posts small blind 0.01
zuzi777: posts big blind 0.02
*** HOLE CARDS ***
Dealt to kanococo [Jc 8s]
TriangleHowl: folds
mitzaro: folds
ale12GM: folds
araivaivai: folds
Japay: raises 0.04 to 0.06
kanococo: calls 0.05
zuzi777: calls 0.04
*** FLOP *** [6c Ts 6s]
kanococo: bets 0.04
zuzi777: calls 0.04
Japay: folds
*** TURN *** [6c Ts 6s] [8d]
kanococo: bets 0.12
zuzi777: raises 0.24 to 0.36
kanococo: calls 0.24
*** RIVER *** [6c Ts 6s 8d] [Ad]
kanococo: bets 0.46
zuzi777 has timed out
zuzi777 activated time-bank (60 seconds)
zuzi777: folds
Uncalled bet (0.46) returned to kanococo
kanococo collected 0.93 from pot
kanococo: doesn't show hand
*** SUMMARY ***
Total pot 0.98 | Rake 0.05
Board [ 6c Ts 6s 8d Ad ]
Game ended: 2025/08/31 21:37:00 GMT
Seat 1: zuzi777 (big blind) folded on the River
Seat 2: TriangleHowl folded before Flop (didn't bet)
Seat 3: mitzaro folded before Flop (didn't bet)
Seat 4: ale12GM folded before Flop (didn't bet)
Seat 5: araivaivai folded before Flop (didn't bet)
Seat 6: Japay (button) folded on the Flop
Seat 7: kanococo (small blind) collected (0.93)

CoinPoker Hand #290349169: Tournament #1361819, ₮1 Mini Sunday Smash PKO Hold'em No Limit (125/250 ante 38 play) 2025/08/31 21:35:26 GMT
Table '1' 7-max Seat #4 is the button
Seat 1: Monzadrift (22217 in chips, 50 bounty)
Seat 2: Knutss (9651 in chips, 50 bounty)
Seat 3: kanococo (242 in chips, 50 bounty) is sitting out
Seat 4: Deuce27Low (10234 in chips, 50 bounty)
Seat 5: sucio (29147 in chips, 100 bounty)
Seat 6: Zhrveil (8568 in chips, 50 bounty)
Seat 7: negozin (10179 in chips, 50 bounty)
Monzadrift: posts the ante 38
Knutss: posts the ante 38
kanococo: posts the ante 38
Deuce27Low: posts the ante 38
sucio: posts the ante 38
Zhrveil: posts the ante 38
negozin: posts the ante 38
sucio: posts small blind 125
Zhrveil: posts big blind 250
*** HOLE CARDS ***
Dealt to kanococo [Jc Ad]
negozin: folds
Monzadrift has timed out
Monzadrift activated time-bank (30 seconds)
Monzadrift: folds
Knutss: folds
kanococo: folds
Deuce27Low: folds
sucio: raises 250 to 500
Zhrveil: calls 250
*** FLOP *** [Jh 6s Ah]
sucio: checks
Zhrveil: checks
*** TURN *** [Jh 6s Ah] [Td]
sucio: bets 250
Zhrveil: folds
Uncalled bet (250) returned to sucio
sucio collected 1266 from pot
sucio: doesn't show hand
*** SUMMARY ***
Total pot 1266 | Rake 0
Board [ Jh 6s Ah Td ]
Game ended: 2025/08/31 21:36:31 GMT
Seat 1: Monzadrift folded before Flop
Seat 2: Knutss folded before Flop
Seat 3: kanococo folded before Flop
Seat 4: Deuce27Low (button) folded before Flop
Seat 5: sucio (small blind) collected (1266)
Seat 6: Zhrveil (big blind) folded on the Turn
Seat 7: negozin folded before Flop

CoinPoker Hand #290349703: Tournament #1361819, ₮1 Mini Sunday Smash PKO Hold'em No Limit (125/250 ante 38 play) 2025/08/31 21:36:32 GMT
Table '1' 7-max Seat #5 is the button
Seat 1: Monzadrift (22179 in chips, 50 bounty)
Seat 2: Knutss (9613 in chips, 50 bounty)
Seat 3: kanococo (204 in chips, 50 bounty) is sitting out
Seat 4: Deuce27Low (10196 in chips, 50 bounty)
Seat 5: sucio (29875 in chips, 100 bounty)
Seat 6: Zhrveil (8030 in chips, 50 bounty)
Seat 7: negozin (10141 in chips, 50 bounty)
Monzadrift: posts the ante 38
Knutss: posts the ante 38
kanococo: posts the ante 38
Deuce27Low: posts the ante 38
sucio: posts the ante 38
Zhrveil: posts the ante 38
negozin: posts the ante 38
Zhrveil: posts small blind 125
negozin: posts big blind 250
*** HOLE CARDS ***
Dealt to kanococo [8h Kh]
Monzadrift: folds
Knutss: folds
kanococo: folds
Deuce27Low: folds
sucio: folds
Zhrveil: folds
negozin collected 641 from pot
negozin has timed out
negozin: doesn't show hand
*** SUMMARY ***
Total pot 641 | Rake 0
Board [ ]
Game ended: 2025/08/31 21:36:54 GMT
Seat 1: Monzadrift folded before Flop
Seat 2: Knutss folded before Flop
Seat 3: kanococo folded before Flop
Seat 4: Deuce27Low folded before Flop
Seat 5: sucio (button) folded before Flop
Seat 6: Zhrveil (small blind) folded before Flop
Seat 7: negozin (big blind) collected (641)

CoinPoker Hand #290349830: Tournament #1361819, ₮1 Mini Sunday Smash PKO Hold'em No Limit (125/250 ante 38 play) 2025/08/31 21:36:54 GMT
Table '1' 7-max Seat #6 is the button
Seat 1: Monzadrift (22141 in chips, 50 bounty)
Seat 2: Knutss (9575 in chips, 50 bounty)
Seat 3: kanococo (166 in chips, 50 bounty) is sitting out
Seat 4: Deuce27Low (10158 in chips, 50 bounty)
Seat 5: sucio (29837 in chips, 100 bounty)
Seat 6: Zhrveil (7867 in chips, 50 bounty)
Seat 7: negozin (10494 in chips, 50 bounty)
Monzadrift: posts the ante 38
Knutss: posts the ante 38
kanococo: posts the ante 38
Deuce27Low: posts the ante 38
sucio: posts the ante 38
Zhrveil: posts the ante 38
negozin: posts the ante 38
negozin: posts small blind 125
Monzadrift: posts big blind 250
*** HOLE CARDS ***
Dealt to kanococo [Qc As]
Knutss: folds
kanococo: folds
Deuce27Low: folds
sucio: folds
Zhrveil: folds
negozin: folds
Monzadrift collected 641 from pot
Monzadrift has timed out
Monzadrift: doesn't show hand
*** SUMMARY ***
Total pot 641 | Rake 0
Board [ ]
Game ended: 2025/08/31 21:37:19 GMT
Seat 1: Monzadrift (big blind) collected (641)
Seat 2: Knutss folded before Flop
Seat 3: kanococo folded before Flop
Seat 4: Deuce27Low folded before Flop
Seat 5: sucio folded before Flop
Seat 6: Zhrveil (button) folded before Flop
Seat 7: negozin (small blind) folded before Flop

CoinPoker Hand #290351407: Hold'em No Limit (0.01/0.02 ) 2025/08/31 21:37:02 GMT
Table 'NL ₮2 VI' 7-max Seat #7 is the button
Seat 1: zuzi777 (1.50 in chips)
Seat 2: TriangleHowl (2.00 in chips)
Seat 3: mitzaro (1.84 in chips)
Seat 4: ale12GM (1.64 in chips)
Seat 5: araivaivai (8.01 in chips)
Seat 6: Japay (2.00 in chips)
Seat 7: kanococo (4.44 in chips)
zuzi777: posts small blind 0.01
TriangleHowl: posts big blind 0.02
*** HOLE CARDS ***
Dealt to kanococo [2c 7d]
mitzaro: folds
ale12GM: raises 0.02 to 0.04
araivaivai: folds
Japay: calls 0.04
kanococo: folds
zuzi777: folds
TriangleHowl: raises 1.98 and is all-in
ale12GM: folds
Japay has timed out
Japay activated time-bank (60 seconds)
Japay: folds
TriangleHowl collected 2.09 from pot
TriangleHowl: shows [7h 4h]
*** SUMMARY ***
Total pot 2.09 | Rake 0.00
Board [ ]
Game ended: 2025/08/31 21:38:24 GMT
Seat 1: zuzi777 (small blind) folded before Flop
Seat 2: TriangleHowl (big blind) showed [7h 4h] and won (2.09) with 
Seat 3: mitzaro folded before Flop (didn't bet)
Seat 4: ale12GM folded before Flop
Seat 5: araivaivai folded before Flop (didn't bet)
Seat 6: Japay folded before Flop
Seat 7: kanococo (button) folded before Flop (didn't bet)

CoinPoker Hand #290350046: Tournament #1361819, ₮1 Mini Sunday Smash PKO Hold'em No Limit (125/250 ante 38 play) 2025/08/31 21:37:20 GMT
Table '1' 7-max Seat #7 is the button
Seat 1: Monzadrift (22494 in chips, 50 bounty)
Seat 2: Knutss (9537 in chips, 50 bounty)
Seat 3: kanococo (128 in chips, 50 bounty) is sitting out
Seat 4: Deuce27Low (10120 in chips, 50 bounty)
Seat 5: sucio (29799 in chips, 100 bounty)
Seat 6: Zhrveil (7829 in chips, 50 bounty)
Seat 7: negozin (10331 in chips, 50 bounty)
Monzadrift: posts the ante 38
Knutss: posts the ante 38
kanococo: posts the ante 38
Deuce27Low: posts the ante 38
sucio: posts the ante 38
Zhrveil: posts the ante 38
negozin: posts the ante 38
Monzadrift: posts small blind 125
Knutss: posts big blind 250
*** HOLE CARDS ***
Dealt to kanococo [5s 9d]
kanococo: folds
Deuce27Low: folds
sucio: folds
Zhrveil: folds
negozin: folds
Monzadrift: folds
Knutss collected 641 from pot
Knutss: doesn't show hand
*** SUMMARY ***
Total pot 641 | Rake 0
Board [ ]
Game ended: 2025/08/31 21:37:48 GMT
Seat 1: Monzadrift (small blind) folded before Flop
Seat 2: Knutss (big blind) collected (641)
Seat 3: kanococo folded before Flop
Seat 4: Deuce27Low folded before Flop
Seat 5: sucio folded before Flop
Seat 6: Zhrveil folded before Flop
Seat 7: negozin (button) folded before Flop

CoinPoker Hand #290350379: Tournament #1361819, ₮1 Mini Sunday Smash PKO Hold'em No Limit (125/250 ante 38 play) 2025/08/31 21:37:49 GMT
Table '1' 7-max Seat #1 is the button
Seat 1: Monzadrift (22331 in chips, 50 bounty)
Seat 2: Knutss (9890 in chips, 50 bounty)
Seat 3: kanococo (90 in chips, 50 bounty) is sitting out
Seat 4: Deuce27Low (10082 in chips, 50 bounty)
Seat 5: sucio (29761 in chips, 100 bounty)
Seat 6: Zhrveil (7791 in chips, 50 bounty)
Seat 7: negozin (10293 in chips, 50 bounty)
Monzadrift: posts the ante 38
Knutss: posts the ante 38
kanococo: posts the ante 38
Deuce27Low: posts the ante 38
sucio: posts the ante 38
Zhrveil: posts the ante 38
negozin: posts the ante 38
Knutss: posts small blind 125
kanococo: posts big blind 52 and is all-in
*** HOLE CARDS ***
Dealt to kanococo [Js 6c]
Deuce27Low: folds
sucio: folds
Zhrveil: folds
negozin: folds
Monzadrift: folds
Knutss: calls 125
Uncalled bet (198) returned to Knutss
*** FLOP *** [Jh 5s As]
*** TURN *** [Jh 5s As] [Qd]
*** RIVER *** [Jh 5s As Qd] [2h]
*** SHOW DOWN ***
kanococo: shows [Js 6c] (a pair of Jacks)
Knutss: shows [8d 8h] (a pair of Eights)
kanococo collected 370 from pot
*** SUMMARY ***
Total pot 370 | Rake 0
Board [ Jh 5s As Qd 2h ]
Game ended: 2025/08/31 21:38:27 GMT
Seat 1: Monzadrift (button) folded before Flop
Seat 2: Knutss (small blind) showed [8d 8h]
Seat 3: kanococo (big blind) showed [Js 6c] and won (370) with a pair of Jacks
Seat 4: Deuce27Low folded before Flop
Seat 5: sucio folded before Flop
Seat 6: Zhrveil folded before Flop
Seat 7: negozin folded before Flop

CoinPoker Hand #290352072: Hold'em No Limit (0.01/0.02 ) 2025/08/31 21:38:26 GMT
Table 'NL ₮2 VI' 7-max Seat #1 is the button
Seat 1: zuzi777 (1.49 in chips)
Seat 2: TriangleHowl (2.09 in chips)
Seat 3: mitzaro (1.84 in chips)
Seat 4: ale12GM (1.60 in chips)
Seat 5: araivaivai (8.01 in chips)
Seat 6: Japay (2.00 in chips)
Seat 7: kanococo (4.44 in chips)
TriangleHowl: posts small blind 0.01
mitzaro: didn't post big blind
ale12GM: posts big blind 0.02
*** HOLE CARDS ***
Dealt to kanococo [As 2h]
araivaivai: folds
Japay: folds
kanococo: raises 0.02 to 0.04
zuzi777: folds
TriangleHowl: folds
ale12GM: folds
kanococo collected 0.07 from pot
kanococo: doesn't show hand
*** SUMMARY ***
Total pot 0.07 | Rake 0.00
Board [ ]
Game ended: 2025/08/31 21:38:43 GMT
Seat 1: zuzi777 (button) folded before Flop (didn't bet)
Seat 2: TriangleHowl (small blind) folded before Flop
Seat 3: mitzaro folded before Flop (didn't bet)
Seat 4: ale12GM (big blind) folded before Flop
Seat 5: araivaivai folded before Flop (didn't bet)
Seat 6: Japay folded before Flop (didn't bet)
Seat 7: kanococo collected (0.07)

CoinPoker Hand #290350711: Tournament #1361819, ₮1 Mini Sunday Smash PKO Hold'em No Limit (125/250 ante 38 play) 2025/08/31 21:38:28 GMT
Table '1' 7-max Seat #2 is the button
Seat 2: Knutss (9800 in chips, 50 bounty)
Seat 3: kanococo (370 in chips, 50 bounty) is sitting out
Seat 4: Deuce27Low (10044 in chips, 50 bounty)
Seat 5: sucio (29723 in chips, 100 bounty)
Seat 6: Zhrveil (7753 in chips, 50 bounty)
Seat 7: negozin (10255 in chips, 50 bounty)
Knutss: posts the ante 38
kanococo: posts the ante 38
Deuce27Low: posts the ante 38
sucio: posts the ante 38
Zhrveil: posts the ante 38
negozin: posts the ante 38
kanococo: posts small blind 125
Deuce27Low: posts big blind 250
*** HOLE CARDS ***
Dealt to kanococo [3h 7s]
sucio: folds
Zhrveil: folds
negozin has timed out
negozin activated time-bank (30 seconds)
negozin has timed out
negozin: folds
Knutss: raises 325 to 575
kanococo: folds
Deuce27Low: calls 325
*** FLOP *** [9d 3s 9s]
Deuce27Low: checks
Knutss: checks
*** TURN *** [9d 3s 9s] [8d]
Deuce27Low: bets 626
Knutss: calls 626
*** RIVER *** [9d 3s 9s 8d] [2h]
Deuce27Low has timed out
Deuce27Low activated time-bank (28 seconds)
Deuce27Low: checks
Knutss: checks
*** SHOW DOWN ***
Deuce27Low: shows [6h 7h] (a pair of Nines)
Knutss: shows [Kc Ah] (a pair of Nines)
Knutss collected 2755 from pot
*** SUMMARY ***
Total pot 2755 | Rake 0
Board [ 9d 3s 9s 8d 2h ]
Game ended: 2025/08/31 21:40:22 GMT
Seat 2: Knutss (button) showed [Kc Ah] and won (2755) with a pair of Nines
Seat 3: kanococo (small blind) folded before Flop
Seat 4: Deuce27Low (big blind) showed [6h 7h]
Seat 5: sucio folded before Flop
Seat 6: Zhrveil folded before Flop
Seat 7: negozin folded before Flop

CoinPoker Hand #290352262: Hold'em No Limit (0.01/0.02 ) 2025/08/31 21:38:45 GMT
Table 'NL ₮2 VI' 7-max Seat #2 is the button
Seat 1: zuzi777 (1.49 in chips)
Seat 2: TriangleHowl (2.08 in chips)
Seat 4: ale12GM (1.58 in chips)
Seat 5: araivaivai (8.01 in chips)
Seat 6: Japay (2.00 in chips)
Seat 7: kanococo (4.47 in chips)
ale12GM: posts small blind 0.01
araivaivai: posts big blind 0.02
*** HOLE CARDS ***
Dealt to kanococo [9d 6h]
Japay: raises 0.02 to 0.04
kanococo: folds
zuzi777: folds
TriangleHowl: raises 2.08 and is all-in
ale12GM: calls 1.57 and is all-in
araivaivai: folds
Japay has timed out
Japay activated time-bank (33 seconds)
Japay: folds
Uncalled bet (0.50) returned to TriangleHowl
*** FLOP *** [Kh Ad 3d]
*** TURN *** [Kh Ad 3d] [Js]
*** RIVER *** [Kh Ad 3d Js] [2s]
*** SHOW DOWN ***
TriangleHowl: shows [9h Ac] (a pair of Aces)
ale12GM: shows [As Jc] (two pairs, Aces and Jacks)
ale12GM collected 3.06 from pot
*** SUMMARY ***
Total pot 3.22 | Rake 0.16
Board [ Kh Ad 3d Js 2s ]
Game ended: 2025/08/31 21:39:47 GMT
Seat 1: zuzi777 folded before Flop (didn't bet)
Seat 2: TriangleHowl (button) showed [9h Ac]
Seat 4: ale12GM (small blind) showed [As Jc] and won (3.06) with two pairs, Aces and Jacks
Seat 5: araivaivai (big blind) folded before Flop
Seat 6: Japay folded before Flop
Seat 7: kanococo folded before Flop (didn't bet)

CoinPoker Hand #290352800: Hold'em No Limit (0.01/0.02 ) 2025/08/31 21:39:49 GMT
Table 'NL ₮2 VI' 7-max Seat #4 is the button
Seat 2: TriangleHowl (0.50 in chips)
Seat 3: domvik (2.00 in chips)
Seat 4: ale12GM (3.06 in chips)
Seat 5: araivaivai (7.99 in chips)
Seat 6: Japay (2.00 in chips)
Seat 7: kanococo (4.47 in chips)
araivaivai: posts small blind 0.01
Japay: posts big blind 0.02
domvik: posts big blind 0.02
*** HOLE CARDS ***
Dealt to kanococo [7h Td]
ale12GM said, "jajajaja"
kanococo: folds
TriangleHowl: raises 0.50 and is all-in
kanococo said, "all in"
domvik: folds
ale12GM: folds
araivaivai: folds
Japay: folds
TriangleHowl collected 0.55 from pot
TriangleHowl has timed out
TriangleHowl: doesn't show hand
*** SUMMARY ***
Total pot 0.55 | Rake 0.00
Board [ ]
Game ended: 2025/08/31 21:40:28 GMT
Seat 2: TriangleHowl collected (0.55)
Seat 3: domvik folded before Flop
Seat 4: ale12GM (button) folded before Flop (didn't bet)
Seat 5: araivaivai (small blind) folded before Flop
Seat 6: Japay (big blind) folded before Flop
Seat 7: kanococo folded before Flop (didn't bet)

CoinPoker Hand #290351972: Tournament #1361819, ₮1 Mini Sunday Smash PKO Hold'em No Limit (125/250 ante 38 play) 2025/08/31 21:40:23 GMT
Table '1' 7-max Seat #3 is the button
Seat 1: anteeater1 (15134 in chips, 50 bounty)
Seat 2: Knutss (11316 in chips, 50 bounty)
Seat 3: kanococo (207 in chips, 50 bounty) is sitting out
Seat 4: Deuce27Low (8805 in chips, 50 bounty)
Seat 5: sucio (29685 in chips, 100 bounty)
Seat 6: Zhrveil (7715 in chips, 50 bounty)
Seat 7: negozin (10217 in chips, 50 bounty)
anteeater1: posts the ante 38
Knutss: posts the ante 38
kanococo: posts the ante 38
Deuce27Low: posts the ante 38
sucio: posts the ante 38
Zhrveil: posts the ante 38
negozin: posts the ante 38
Deuce27Low: posts small blind 125
sucio: posts big blind 250
*** HOLE CARDS ***
Dealt to kanococo [Jd 2c]
Zhrveil: folds
kanococo has reconnected
negozin: folds
Zhrveil is disconnected
Zhrveil has reconnected
anteeater1: raises 250 to 500
Knutss: raises 1125 to 1625
kanococo: calls 169 and is all-in
Deuce27Low: folds
sucio: folds
anteeater1 has timed out
anteeater1 activated time-bank (30 seconds)
anteeater1: calls 1125
*** FLOP *** [2d 9c As]
anteeater1: checks
Knutss: checks
*** TURN *** [2d 9c As] [Qs]
anteeater1: checks
Knutss: bets 2679
anteeater1: folds
Uncalled bet (2679) returned to Knutss
Knutss collected 2993 from side-pot 1
*** RIVER *** [2d 9c As Qs] [2h]
*** SHOW DOWN ***
kanococo: shows [Jd 2c] (three of kind, Twos)
kanococo collected 1067 from pot
*** SUMMARY ***
Total pot 4060 | Rake 0
Board [ 2d 9c As Qs 2h ]
Game ended: 2025/08/31 21:41:56 GMT
Seat 1: anteeater1 folded on the Turn
Seat 2: Knutss showed [Jc Kd] and won (2993) with a pair of Twos
Seat 3: kanococo (button) showed [Jd 2c] and won (1067) with three of kind, Twos
Seat 4: Deuce27Low (small blind) folded before Flop
Seat 5: sucio (big blind) folded before Flop
Seat 6: Zhrveil folded before Flop
Seat 7: negozin folded before Flop

CoinPoker Hand #290352716: Tournament #1361819, ₮1 Mini Sunday Smash PKO Hold'em No Limit (150/300 ante 45 play) 2025/08/31 21:42:01 GMT
Table '1' 7-max Seat #4 is the button
Seat 1: anteeater1 (13471 in chips, 50 bounty)
Seat 2: Knutss (12646 in chips, 50 bounty)
Seat 3: kanococo (1067 in chips, 50 bounty)
Seat 4: Deuce27Low (8642 in chips, 50 bounty)
Seat 5: sucio (29397 in chips, 100 bounty)
Seat 6: Zhrveil (7677 in chips, 50 bounty)
Seat 7: negozin (10179 in chips, 50 bounty)
anteeater1: posts the ante 45
Knutss: posts the ante 45
kanococo: posts the ante 45
Deuce27Low: posts the ante 45
sucio: posts the ante 45
Zhrveil: posts the ante 45
negozin: posts the ante 45
sucio: posts small blind 150
Zhrveil: posts big blind 300
*** HOLE CARDS ***
Dealt to kanococo [3c Ac]
negozin: folds
anteeater1: raises 300 to 600
Knutss: folds
kanococo: raises 1022 and is all-in
Deuce27Low: calls 1022
sucio: folds
Zhrveil has timed out
Zhrveil activated time-bank (30 seconds)
Zhrveil: folds
anteeater1: calls 422
*** FLOP *** [7d Jh 7h]
anteeater1: checks
Deuce27Low: checks
*** TURN *** [7d Jh 7h] [8s]
anteeater1: checks
Deuce27Low: checks
*** RIVER *** [7d Jh 7h 8s] [8h]
anteeater1: checks
Deuce27Low: checks
*** SHOW DOWN ***
anteeater1: shows [As 4s] (two pairs, Eights and Sevens)
kanococo: shows [3c Ac] (two pairs, Eights and Sevens)
Deuce27Low: mucks hand
anteeater1 collected 1916 from pot
kanococo collected 1915 from pot
*** SUMMARY ***
Total pot 3831 | Rake 0
Board [ 7d Jh 7h 8s 8h ]
Game ended: 2025/08/31 21:43:30 GMT
Seat 1: anteeater1 showed [As 4s] and won (1916) with two pairs, Eights and Sevens
Seat 2: Knutss folded before Flop
Seat 3: kanococo showed [3c Ac] and won (1915) with two pairs, Eights and Sevens
Seat 4: Deuce27Low (button) mucked
Seat 5: sucio (small blind) folded before Flop
Seat 6: Zhrveil (big blind) folded before Flop
Seat 7: negozin folded before Flop

CoinPoker Hand #290353364: Tournament #1361819, ₮1 Mini Sunday Smash PKO Hold'em No Limit (150/300 ante 45 play) 2025/08/31 21:43:31 GMT
Table '1' 7-max Seat #5 is the button
Seat 1: anteeater1 (14320 in chips, 50 bounty)
Seat 2: Knutss (12601 in chips, 50 bounty)
Seat 3: kanococo (1915 in chips, 50 bounty)
Seat 4: Deuce27Low (7575 in chips, 50 bounty)
Seat 5: sucio (29202 in chips, 100 bounty)
Seat 6: Zhrveil (7332 in chips, 50 bounty)
Seat 7: negozin (10134 in chips, 50 bounty)
anteeater1: posts the ante 45
Knutss: posts the ante 45
kanococo: posts the ante 45
Deuce27Low: posts the ante 45
sucio: posts the ante 45
Zhrveil: posts the ante 45
negozin: posts the ante 45
Zhrveil: posts small blind 150
negozin: posts big blind 300
*** HOLE CARDS ***
Dealt to kanococo [5h 9d]
anteeater1: raises 600 to 900
Knutss: folds
kanococo: folds
Deuce27Low: folds
sucio: folds
Zhrveil: calls 750
negozin: folds
*** FLOP *** [As 4s 8s]
Zhrveil: checks
anteeater1: bets 2415
Zhrveil: raises 6387 and is all-in
anteeater1: calls 3972
*** TURN *** [As 4s 8s] [4d]
*** RIVER *** [As 4s 8s 4d] [3c]
*** SHOW DOWN ***
Zhrveil: shows [Js Qs] (a flush, Ace high)
anteeater1: shows [5d Ad] (two pairs, Aces and Fours)
Zhrveil collected 15189 from pot
*** SUMMARY ***
Total pot 15189 | Rake 0
Board [ As 4s 8s 4d 3c ]
Game ended: 2025/08/31 21:44:24 GMT
Seat 1: anteeater1 showed [5d Ad]
Seat 2: Knutss folded before Flop
Seat 3: kanococo folded before Flop
Seat 4: Deuce27Low folded before Flop
Seat 5: sucio (button) folded before Flop
Seat 6: Zhrveil (small blind) showed [Js Qs] and won (15189) with a flush, Ace high
Seat 7: negozin (big blind) folded before Flop

CoinPoker Hand #290353888: Tournament #1361819, ₮1 Mini Sunday Smash PKO Hold'em No Limit (150/300 ante 45 play) 2025/08/31 21:44:28 GMT
Table '1' 7-max Seat #6 is the button
Seat 1: anteeater1 (6988 in chips, 50 bounty)
Seat 2: Knutss (12556 in chips, 50 bounty)
Seat 3: kanococo (1870 in chips, 50 bounty)
Seat 4: Deuce27Low (7530 in chips, 50 bounty)
Seat 5: sucio (29157 in chips, 100 bounty)
Seat 6: Zhrveil (15189 in chips, 50 bounty)
Seat 7: negozin (9789 in chips, 50 bounty)
anteeater1: posts the ante 45
Knutss: posts the ante 45
kanococo: posts the ante 45
Deuce27Low: posts the ante 45
sucio: posts the ante 45
Zhrveil: posts the ante 45
negozin: posts the ante 45
negozin: posts small blind 150
anteeater1: posts big blind 300
*** HOLE CARDS ***
Dealt to kanococo [6c Qd]
Knutss: folds
kanococo has timed out
kanococo: folds
Deuce27Low: folds
sucio: folds
Zhrveil: raises 300 to 600
negozin: folds
anteeater1 has timed out wile being disconnected
anteeater1 activated time-bank (28 seconds)
negozin has reconnected
anteeater1 has timed out wile being disconnected
anteeater1: folds
Zhrveil collected 1365 from pot
Zhrveil: doesn't show hand
*** SUMMARY ***
Total pot 1365 | Rake 0
Board [ ]
Game ended: 2025/08/31 21:46:37 GMT
Seat 1: anteeater1 (big blind) folded before Flop
Seat 2: Knutss folded before Flop
Seat 3: kanococo folded before Flop
Seat 4: Deuce27Low folded before Flop
Seat 5: sucio folded before Flop
Seat 6: Zhrveil (button) collected (1365)
Seat 7: negozin (small blind) folded before Flop

CoinPoker Hand #290354994: Tournament #1361819, ₮1 Mini Sunday Smash PKO Hold'em No Limit (150/300 ante 45 play) 2025/08/31 21:46:41 GMT
Table '1' 7-max Seat #7 is the button
Seat 1: anteeater1 (6643 in chips, 50 bounty) is sitting out
Seat 2: Knutss (12511 in chips, 50 bounty)
Seat 3: kanococo (1825 in chips, 50 bounty)
Seat 4: Deuce27Low (7485 in chips, 50 bounty)
Seat 5: sucio (29112 in chips, 100 bounty)
Seat 6: Zhrveil (15909 in chips, 50 bounty)
Seat 7: negozin (9594 in chips, 50 bounty)
anteeater1: posts the ante 45
Knutss: posts the ante 45
kanococo: posts the ante 45
Deuce27Low: posts the ante 45
sucio: posts the ante 45
Zhrveil: posts the ante 45
negozin: posts the ante 45
anteeater1: posts small blind 150
Knutss: posts big blind 300
*** HOLE CARDS ***
Dealt to kanococo [Jc Ts]
kanococo: raises 1780 and is all-in
Deuce27Low: folds
sucio: folds
Zhrveil: folds
negozin: folds
anteeater1: folds
Knutss: folds
kanococo collected 2545 from pot
kanococo: doesn't show hand
*** SUMMARY ***
Total pot 2545 | Rake 0
Board [ ]
Game ended: 2025/08/31 21:46:58 GMT
Seat 1: anteeater1 (small blind) folded before Flop
Seat 2: Knutss (big blind) folded before Flop
Seat 3: kanococo collected (2545)
Seat 4: Deuce27Low folded before Flop
Seat 5: sucio folded before Flop
Seat 6: Zhrveil folded before Flop
Seat 7: negozin (button) folded before Flop

CoinPoker Hand #290355182: Tournament #1361819, ₮1 Mini Sunday Smash PKO Hold'em No Limit (150/300 ante 45 play) 2025/08/31 21:47:01 GMT
Table '1' 7-max Seat #1 is the button
Seat 1: anteeater1 (6448 in chips, 50 bounty) is sitting out
Seat 2: Knutss (12166 in chips, 50 bounty)
Seat 3: kanococo (2545 in chips, 50 bounty)
Seat 4: Deuce27Low (7440 in chips, 50 bounty)
Seat 5: sucio (29067 in chips, 100 bounty)
Seat 6: Zhrveil (15864 in chips, 50 bounty)
Seat 7: negozin (9549 in chips, 50 bounty)
anteeater1: posts the ante 45
Knutss: posts the ante 45
kanococo: posts the ante 45
Deuce27Low: posts the ante 45
sucio: posts the ante 45
Zhrveil: posts the ante 45
negozin: posts the ante 45
Knutss: posts small blind 150
kanococo: posts big blind 300
*** HOLE CARDS ***
Dealt to kanococo [Ks 3h]
Deuce27Low: folds
sucio: folds
Zhrveil: folds
negozin: folds
anteeater1: folds
Knutss: calls 150
kanococo: raises 2200 and is all-in
Knutss: calls 2200
*** FLOP *** [Qc Tc Ac]
*** TURN *** [Qc Tc Ac] [Jh]
*** RIVER *** [Qc Tc Ac Jh] [4s]
*** SHOW DOWN ***
kanococo: shows [Ks 3h] (a straight, Ace high)
Knutss: shows [As 2h] (a pair of Aces)
kanococo collected 5315 from pot
*** SUMMARY ***
Total pot 5315 | Rake 0
Board [ Qc Tc Ac Jh 4s ]
Game ended: 2025/08/31 21:47:45 GMT
Seat 1: anteeater1 (button) folded before Flop
Seat 2: Knutss (small blind) showed [As 2h]
Seat 3: kanococo (big blind) showed [Ks 3h] and won (5315) with a straight, Ace high
Seat 4: Deuce27Low folded before Flop
Seat 5: sucio folded before Flop
Seat 6: Zhrveil folded before Flop
Seat 7: negozin folded before Flop

CoinPoker Hand #290355698: Tournament #1361819, ₮1 Mini Sunday Smash PKO Hold'em No Limit (175/350 ante 53 play) 2025/08/31 21:47:53 GMT
Table '1' 7-max Seat #2 is the button
Seat 1: anteeater1 (6403 in chips, 50 bounty) is sitting out
Seat 3: kanococo (5315 in chips, 50 bounty)
Seat 4: Deuce27Low (7395 in chips, 50 bounty)
Seat 5: sucio (29022 in chips, 100 bounty)
Seat 6: Zhrveil (15819 in chips, 50 bounty)
Seat 7: negozin (9504 in chips, 50 bounty)
anteeater1: posts the ante 53
kanococo: posts the ante 53
Deuce27Low: posts the ante 53
sucio: posts the ante 53
Zhrveil: posts the ante 53
negozin: posts the ante 53
kanococo: posts small blind 175
Deuce27Low: posts big blind 350
*** HOLE CARDS ***
Dealt to kanococo [Ts 8h]
sucio: folds
Zhrveil: folds
negozin: folds
anteeater1: folds
kanococo: raises 350 to 700
Deuce27Low: folds
kanococo collected 1368 from pot
kanococo: doesn't show hand
*** SUMMARY ***
Total pot 1368 | Rake 0
Board [ ]
Game ended: 2025/08/31 21:48:23 GMT
Seat 1: anteeater1 folded before Flop
Seat 3: kanococo (small blind) collected (1368)
Seat 4: Deuce27Low (big blind) folded before Flop
Seat 5: sucio folded before Flop
Seat 6: Zhrveil folded before Flop
Seat 7: negozin folded before Flop

CoinPoker Hand #290356092: Tournament #1361819, ₮1 Mini Sunday Smash PKO Hold'em No Limit (175/350 ante 53 play) 2025/08/31 21:48:26 GMT
Table '1' 7-max Seat #3 is the button
Seat 1: anteeater1 (6350 in chips, 50 bounty) is sitting out
Seat 3: kanococo (5930 in chips, 50 bounty)
Seat 4: Deuce27Low (6992 in chips, 50 bounty)
Seat 5: sucio (28969 in chips, 100 bounty)
Seat 6: Zhrveil (15766 in chips, 50 bounty)
Seat 7: negozin (9451 in chips, 50 bounty)
anteeater1: posts the ante 53
kanococo: posts the ante 53
Deuce27Low: posts the ante 53
sucio: posts the ante 53
Zhrveil: posts the ante 53
negozin: posts the ante 53
Deuce27Low: posts small blind 175
sucio: posts big blind 350
*** HOLE CARDS ***
Dealt to kanococo [Ac 5s]
Zhrveil: folds
negozin: folds
anteeater1: folds
kanococo: raises 5877 and is all-in
Deuce27Low: raises 6764 and is all-in
sucio: folds
Uncalled bet (1062) returned to Deuce27Low
*** FLOP *** [2d 7s Kd]
*** TURN *** [2d 7s Kd] [4c]
*** RIVER *** [2d 7s Kd 4c] [Qc]
*** SHOW DOWN ***
Deuce27Low: shows [Ah Ad] (a pair of Aces)
kanococo: shows [Ac 5s] (Ace high)
Deuce27Low collected 12422 from pot
*** SUMMARY ***
Total pot 12422 | Rake 0
Board [ 2d 7s Kd 4c Qc ]
Game ended: 2025/08/31 21:48:57 GMT
Seat 1: anteeater1 folded before Flop
Seat 3: kanococo (button) showed [Ac 5s]
Seat 4: Deuce27Low (small blind) showed [Ah Ad] and won (12422) with a pair of Aces
Seat 5: sucio (big blind) folded before Flop
Seat 6: Zhrveil folded before Flop
Seat 7: negozin folded before Flop

CoinPoker Hand #290356715: Tournament #1361819, ₮1 Mini Sunday Smash PKO Hold'em No Limit (175/350 ante 53 play) 2025/08/31 21:49:52 GMT
Table '4' 7-max Seat #2 is the button
Seat 2: EDG (24536 in chips, 75 bounty)
Seat 3: Smokyy (5601 in chips, 50 bounty)
Seat 4: BPavel261284 (34137 in chips, 87 bounty)
Seat 5: Delavar (7444 in chips, 50 bounty)
Seat 6: BeppeLC (17388 in chips, 50 bounty)
Seat 7: kanococo (10000 in chips, 50 bounty)
EDG: posts the ante 53
Smokyy: posts the ante 53
BPavel261284: posts the ante 53
Delavar: posts the ante 53
BeppeLC: posts the ante 53
kanococo: posts the ante 53
Smokyy: posts small blind 175
BPavel261284: posts big blind 350
*** HOLE CARDS ***
Dealt to kanococo [3c Ah]
Delavar: calls 350
BeppeLC: calls 350
kanococo: raises 350 to 700
Legi has reconnected
EDG: folds
Smokyy: folds
BPavel261284: folds
Delavar: calls 350
BeppeLC: calls 350
*** FLOP *** [7c 7d Td]
Delavar: checks
BeppeLC: checks
kanococo: checks
*** TURN *** [7c 7d Td] [4s]
Delavar: bets 1471
BeppeLC: calls 1471
kanococo: folds
*** RIVER *** [7c 7d Td 4s] [9c]
Delavar: checks
BeppeLC: checks
*** SHOW DOWN ***
Delavar: shows [Kd 9s] (two pairs, Nines and Sevens)
BeppeLC: shows [Ks Ts] (two pairs, Tens and Sevens)
BeppeLC collected 5885 from pot
*** SUMMARY ***
Total pot 5885 | Rake 0
Board [ 7c 7d Td 4s 9c ]
Game ended: 2025/08/31 21:51:04 GMT
Seat 2: EDG (button) folded before Flop
Seat 3: Smokyy (small blind) folded before Flop
Seat 4: BPavel261284 (big blind) folded before Flop
Seat 5: Delavar showed [Kd 9s]
Seat 6: BeppeLC showed [Ks Ts] and won (5885) with two pairs, Tens and Sevens
Seat 7: kanococo folded on the Turn

CoinPoker Hand #290357421: Tournament #1361819, ₮1 Mini Sunday Smash PKO Hold'em No Limit (175/350 ante 53 play) 2025/08/31 21:51:05 GMT
Table '4' 7-max Seat #3 is the button
Seat 1: Legi (10000 in chips, 50 bounty)
Seat 2: EDG (24483 in chips, 75 bounty)
Seat 3: Smokyy (5373 in chips, 50 bounty)
Seat 4: BPavel261284 (33734 in chips, 87 bounty)
Seat 5: Delavar (5220 in chips, 50 bounty)
Seat 6: BeppeLC (21049 in chips, 50 bounty)
Seat 7: kanococo (9247 in chips, 50 bounty)
Legi: posts the ante 53
EDG: posts the ante 53
Smokyy: posts the ante 53
BPavel261284: posts the ante 53
Delavar: posts the ante 53
BeppeLC: posts the ante 53
kanococo: posts the ante 53
BPavel261284: posts small blind 175
Delavar: posts big blind 350
*** HOLE CARDS ***
Dealt to kanococo [5h 7d]
BeppeLC: raises 350 to 700
kanococo: folds
Legi: folds
EDG: raises 1400 to 2100
Smokyy: folds
BPavel261284: folds
Delavar: folds
BeppeLC: folds
EDG collected 3696 from pot
EDG: doesn't show hand
*** SUMMARY ***
Total pot 3696 | Rake 0
Board [ ]
Game ended: 2025/08/31 21:51:36 GMT
Seat 1: Legi folded before Flop
Seat 2: EDG collected (3696)
Seat 3: Smokyy (button) folded before Flop
Seat 4: BPavel261284 (small blind) folded before Flop
Seat 5: Delavar (big blind) folded before Flop
Seat 6: BeppeLC folded before Flop
Seat 7: kanococo folded before Flop

CoinPoker Hand #290357606: Tournament #1361819, ₮1 Mini Sunday Smash PKO Hold'em No Limit (175/350 ante 53 play) 2025/08/31 21:51:37 GMT
Table '4' 7-max Seat #4 is the button
Seat 1: Legi (9947 in chips, 50 bounty)
Seat 2: EDG (26026 in chips, 75 bounty)
Seat 3: Smokyy (5320 in chips, 50 bounty)
Seat 4: BPavel261284 (33506 in chips, 87 bounty)
Seat 5: Delavar (4817 in chips, 50 bounty)
Seat 6: BeppeLC (20296 in chips, 50 bounty)
Seat 7: kanococo (9194 in chips, 50 bounty)
Legi: posts the ante 53
EDG: posts the ante 53
Smokyy: posts the ante 53
BPavel261284: posts the ante 53
Delavar: posts the ante 53
BeppeLC: posts the ante 53
kanococo: posts the ante 53
Delavar: posts small blind 175
BeppeLC: posts big blind 350
*** HOLE CARDS ***
Dealt to kanococo [Ks Ac]
kanococo: raises 700 to 1050
Legi: folds
EDG: folds
Smokyy: calls 1050
BPavel261284: folds
Delavar: folds
BeppeLC: calls 700
*** FLOP *** [9c Kd Jc]
BeppeLC: checks
kanococo: bets 8091 and is all-in
Smokyy: folds
BeppeLC: folds
Uncalled bet (8091) returned to kanococo
kanococo collected 3696 from pot
kanococo: doesn't show hand
*** SUMMARY ***
Total pot 3696 | Rake 0
Board [ 9c Kd Jc ]
Game ended: 2025/08/31 21:52:14 GMT
Seat 1: Legi folded before Flop
Seat 2: EDG folded before Flop
Seat 3: Smokyy folded on the Flop
Seat 4: BPavel261284 (button) folded before Flop
Seat 5: Delavar (small blind) folded before Flop
Seat 6: BeppeLC (big blind) folded on the Flop
Seat 7: kanococo collected (3696)

CoinPoker Hand #290357882: Tournament #1361819, ₮1 Mini Sunday Smash PKO Hold'em No Limit (175/350 ante 53 play) 2025/08/31 21:52:15 GMT
Table '4' 7-max Seat #5 is the button
Seat 1: Legi (9894 in chips, 50 bounty)
Seat 2: EDG (25973 in chips, 75 bounty)
Seat 3: Smokyy (4217 in chips, 50 bounty)
Seat 4: BPavel261284 (33453 in chips, 87 bounty)
Seat 5: Delavar (4589 in chips, 50 bounty)
Seat 6: BeppeLC (19193 in chips, 50 bounty)
Seat 7: kanococo (11787 in chips, 50 bounty)
Legi: posts the ante 53
EDG: posts the ante 53
Smokyy: posts the ante 53
BPavel261284: posts the ante 53
Delavar: posts the ante 53
BeppeLC: posts the ante 53
kanococo: posts the ante 53
BeppeLC: posts small blind 175
kanococo: posts big blind 350
*** HOLE CARDS ***
Dealt to kanococo [3c Jd]
Legi: folds
EDG: folds
Smokyy: folds
BPavel261284: folds
Delavar: calls 350
BeppeLC: calls 175
kanococo: checks
*** FLOP *** [6d 2h Qs]
BeppeLC: checks
kanococo: checks
Delavar: bets 1421
BeppeLC: folds
kanococo: folds
Uncalled bet (1421) returned to Delavar
Delavar collected 1421 from pot
Delavar: doesn't show hand
*** SUMMARY ***
Total pot 1421 | Rake 0
Board [ 6d 2h Qs ]
Game ended: 2025/08/31 21:53:14 GMT
Seat 1: Legi folded before Flop
Seat 2: EDG folded before Flop
Seat 3: Smokyy folded before Flop
Seat 4: BPavel261284 folded before Flop
Seat 5: Delavar (button) collected (1421)
Seat 6: BeppeLC (small blind) folded on the Flop
Seat 7: kanococo (big blind) folded on the Flop

CoinPoker Hand #290358268: Tournament #1361819, ₮1 Mini Sunday Smash PKO Hold'em No Limit (200/400 ante 60 play) 2025/08/31 21:53:19 GMT
Table '4' 7-max Seat #6 is the button
Seat 1: Legi (9841 in chips, 50 bounty)
Seat 2: EDG (25920 in chips, 75 bounty)
Seat 3: Smokyy (4164 in chips, 50 bounty)
Seat 4: BPavel261284 (33400 in chips, 87 bounty)
Seat 5: Delavar (5607 in chips, 50 bounty)
Seat 6: BeppeLC (18790 in chips, 50 bounty)
Seat 7: kanococo (11384 in chips, 50 bounty)
Legi: posts the ante 60
EDG: posts the ante 60
Smokyy: posts the ante 60
BPavel261284: posts the ante 60
Delavar: posts the ante 60
BeppeLC: posts the ante 60
kanococo: posts the ante 60
kanococo: posts small blind 200
Legi: posts big blind 400
*** HOLE CARDS ***
Dealt to kanococo [Jh Ad]
EDG: folds
Smokyy: folds
BPavel261284: raises 400 to 800
Delavar: folds
BeppeLC: folds
kanococo: raises 800 to 1600
Legi: calls 1200
BPavel261284: calls 800
*** FLOP *** [Ks 6d 5s]
kanococo: bets 400
Legi: calls 400
BPavel261284: calls 400
*** TURN *** [Ks 6d 5s] [3c]
kanococo: checks
Legi: checks
BPavel261284: checks
*** RIVER *** [Ks 6d 5s 3c] [4s]
kanococo: bets 929
Legi: calls 929
BPavel261284: folds
*** SHOW DOWN ***
kanococo: shows [Jh Ad] (Ace high)
Legi: shows [Ac 6s] (a pair of Sixes)
Legi collected 8278 from pot
*** SUMMARY ***
Total pot 8278 | Rake 0
Board [ Ks 6d 5s 3c 4s ]
Game ended: 2025/08/31 21:54:19 GMT
Seat 1: Legi (big blind) showed [Ac 6s] and won (8278) with a pair of Sixes
Seat 2: EDG folded before Flop
Seat 3: Smokyy folded before Flop
Seat 4: BPavel261284 folded on the River
Seat 5: Delavar folded before Flop
Seat 6: BeppeLC (button) folded before Flop
Seat 7: kanococo (small blind) showed [Jh Ad]

CoinPoker Hand #290358711: Tournament #1361819, ₮1 Mini Sunday Smash PKO Hold'em No Limit (200/400 ante 60 play) 2025/08/31 21:54:20 GMT
Table '4' 7-max Seat #7 is the button
Seat 1: Legi (15130 in chips, 50 bounty)
Seat 2: EDG (25860 in chips, 75 bounty)
Seat 3: Smokyy (4104 in chips, 50 bounty)
Seat 4: BPavel261284 (31340 in chips, 87 bounty)
Seat 5: Delavar (5547 in chips, 50 bounty)
Seat 6: BeppeLC (18730 in chips, 50 bounty)
Seat 7: kanococo (8395 in chips, 50 bounty)
Legi: posts the ante 60
EDG: posts the ante 60
Smokyy: posts the ante 60
BPavel261284: posts the ante 60
Delavar: posts the ante 60
BeppeLC: posts the ante 60
kanococo: posts the ante 60
Legi: posts small blind 200
EDG: posts big blind 400
*** HOLE CARDS ***
Dealt to kanococo [Jh Kd]
Smokyy: folds
BPavel261284: raises 400 to 800
Delavar: calls 800
BeppeLC: folds
kanococo: calls 800
Legi: calls 600
EDG: folds
*** FLOP *** [Qs 3c Jd]
Legi: checks
BPavel261284: checks
Delavar: bets 2010
kanococo: raises 2010 to 4020
Legi: folds
BPavel261284: folds
Delavar: raises 2677 and is all-in
kanococo: calls 667
*** TURN *** [Qs 3c Jd] [7c]
*** RIVER *** [Qs 3c Jd 7c] [Tc]
*** SHOW DOWN ***
Delavar: shows [Th Qd] (two pairs, Queens and Tens)
kanococo: shows [Jh Kd] (a pair of Jacks)
Delavar collected 13394 from pot
*** SUMMARY ***
Total pot 13394 | Rake 0
Board [ Qs 3c Jd 7c Tc ]
Game ended: 2025/08/31 21:55:26 GMT
Seat 1: Legi (small blind) folded on the Flop
Seat 2: EDG (big blind) folded before Flop
Seat 3: Smokyy folded before Flop
Seat 4: BPavel261284 folded on the Flop
Seat 5: Delavar showed [Th Qd] and won (13394) with two pairs, Queens and Tens
Seat 6: BeppeLC folded before Flop
Seat 7: kanococo (button) showed [Jh Kd]

CoinPoker Hand #290359216: Tournament #1361819, ₮1 Mini Sunday Smash PKO Hold'em No Limit (200/400 ante 60 play) 2025/08/31 22:01:46 GMT
Table '4' 7-max Seat #1 is the button
Seat 1: Legi (14270 in chips, 50 bounty)
Seat 2: EDG (25400 in chips, 75 bounty)
Seat 3: Smokyy (4044 in chips, 50 bounty)
Seat 4: BPavel261284 (30480 in chips, 87 bounty)
Seat 5: Delavar (13394 in chips, 50 bounty)
Seat 6: BeppeLC (18670 in chips, 50 bounty)
Seat 7: kanococo (2848 in chips, 50 bounty)
Legi: posts the ante 60
EDG: posts the ante 60
Smokyy: posts the ante 60
BPavel261284: posts the ante 60
Delavar: posts the ante 60
BeppeLC: posts the ante 60
kanococo: posts the ante 60
EDG: posts small blind 200
Smokyy: posts big blind 400
*** HOLE CARDS ***
Dealt to kanococo [7d Td]
BPavel261284: folds
Delavar: calls 400
BeppeLC: calls 400
kanococo: raises 2788 and is all-in
Legi: folds
EDG: folds
Smokyy: folds
Delavar: calls 2388
BeppeLC: calls 2388
*** FLOP *** [Ks 4d Js]
Delavar: checks
BeppeLC: checks
*** TURN *** [Ks 4d Js] [8h]
Delavar: checks
BeppeLC: checks
*** RIVER *** [Ks 4d Js 8h] [Jd]
Delavar: checks
BeppeLC: checks
*** SHOW DOWN ***
Delavar: shows [9s 8d] (two pairs, Jacks and Eights)
BeppeLC: mucks hand
kanococo: mucks hand
Delavar collected 9384 from pot
*** SUMMARY ***
Total pot 9384 | Rake 0
Board [ Ks 4d Js 8h Jd ]
Game ended: 2025/08/31 22:02:51 GMT
Seat 1: Legi (button) folded before Flop
Seat 2: EDG (small blind) folded before Flop
Seat 3: Smokyy (big blind) folded before Flop
Seat 4: BPavel261284 folded before Flop
Seat 5: Delavar showed [9s 8d] and won (9384) with two pairs, Jacks and Eights
Seat 6: BeppeLC mucked
Seat 7: kanococo mucked

CoinPoker Hand #290364643: Tournament #1361905, ₮0.20 Mega Sat to ₮2 Sunday Lil' Kahuna, 8 Seats GTD Hold'em No Limit (50/100 ante 13 play) 2025/08/31 22:10:05 GMT
Table '3' 7-max Seat #5 is the button
Seat 1: jafarbw (5000 in chips)
Seat 2: Bigmonic (5000 in chips)
Seat 3: BobTheOG (5000 in chips)
Seat 4: irobot (5000 in chips)
Seat 6: JoeyNoodles (5000 in chips)
Seat 7: kanococo (5000 in chips)
jafarbw: posts the ante 13
Bigmonic: posts the ante 13
BobTheOG: posts the ante 13
irobot: posts the ante 13
JoeyNoodles: posts the ante 13
kanococo: posts the ante 13
JoeyNoodles: posts small blind 50
kanococo: posts big blind 100
*** HOLE CARDS ***
Dealt to kanococo [8s 7s]
jafarbw: folds
Bigmonic: raises 100 to 200
BobTheOG: folds
funtik1 has reconnected
irobot: calls 200
JoeyNoodles: calls 150
kanococo: calls 100
*** FLOP *** [2d 8h 6c]
JoeyNoodles: bets 350
kanococo: calls 350
Bigmonic: folds
irobot: calls 350
*** TURN *** [2d 8h 6c] [9h]
JoeyNoodles: checks
kanococo: checks
irobot: checks
*** RIVER *** [2d 8h 6c 9h] [Qh]
JoeyNoodles: bets 550
kanococo: raises 4437 and is all-in
irobot: folds
JoeyNoodles: calls 3887 and is all-in
*** SHOW DOWN ***
kanococo: shows [8s 7s] (a pair of Eights)
JoeyNoodles: shows [5h 2h] (a flush, Queen high)
JoeyNoodles collected 10802 from pot
*** SUMMARY ***
Total pot 10802 | Rake 0
Board [ 2d 8h 6c 9h Qh ]
Game ended: 2025/08/31 22:11:29 GMT
Seat 1: jafarbw folded before Flop
Seat 2: Bigmonic folded on the Flop
Seat 3: BobTheOG folded before Flop
Seat 4: irobot folded on the River
Seat 6: JoeyNoodles (small blind) showed [5h 2h] and won (10802) with a flush, Queen high
Seat 7: kanococo (big blind) showed [8s 7s]

CoinPoker Hand #290364683: Tournament #1361819, ₮1 Mini Sunday Smash PKO Hold'em No Limit (300/600 ante 90 play) 2025/08/31 22:12:01 GMT
Table '1' 7-max Seat #6 is the button
Seat 1: anteeater1 (3932 in chips, 50 bounty) is sitting out
Seat 2: ololoyez (18125 in chips, 50 bounty)
Seat 3: FckGermanRegulation (10340 in chips, 50 bounty)
Seat 4: kanococo (10000 in chips, 50 bounty)
Seat 5: sucio (27538 in chips, 100 bounty)
Seat 6: Zhrveil (10814 in chips, 75 bounty)
Seat 7: negozin (17566 in chips, 50 bounty)
anteeater1: posts the ante 90
ololoyez: posts the ante 90
FckGermanRegulation: posts the ante 90
kanococo: posts the ante 90
sucio: posts the ante 90
Zhrveil: posts the ante 90
negozin: posts the ante 90
negozin: posts small blind 300
anteeater1: posts big blind 600
*** HOLE CARDS ***
Dealt to kanococo [8s Th]
ololoyez: folds
FckGermanRegulation: raises 600 to 1200
kanococo: folds
sucio: folds
Zhrveil: folds
negozin: folds
anteeater1: folds
FckGermanRegulation collected 2730 from pot
FckGermanRegulation: doesn't show hand
*** SUMMARY ***
Total pot 2730 | Rake 0
Board [ ]
Game ended: 2025/08/31 22:12:26 GMT
Seat 1: anteeater1 (big blind) folded before Flop
Seat 2: ololoyez folded before Flop
Seat 3: FckGermanRegulation collected (2730)
Seat 4: kanococo folded before Flop
Seat 5: sucio folded before Flop
Seat 6: Zhrveil (button) folded before Flop
Seat 7: negozin (small blind) folded before Flop

CoinPoker Hand #290364877: Tournament #1361819, ₮1 Mini Sunday Smash PKO Hold'em No Limit (300/600 ante 90 play) 2025/08/31 22:12:29 GMT
Table '1' 7-max Seat #7 is the button
Seat 1: anteeater1 (3242 in chips, 50 bounty) is sitting out
Seat 2: ololoyez (18035 in chips, 50 bounty)
Seat 3: FckGermanRegulation (11780 in chips, 50 bounty)
Seat 4: kanococo (9910 in chips, 50 bounty)
Seat 5: sucio (27448 in chips, 100 bounty)
Seat 6: Zhrveil (10724 in chips, 75 bounty)
Seat 7: negozin (17176 in chips, 50 bounty)
anteeater1: posts the ante 90
ololoyez: posts the ante 90
FckGermanRegulation: posts the ante 90
kanococo: posts the ante 90
sucio: posts the ante 90
Zhrveil: posts the ante 90
negozin: posts the ante 90
anteeater1: posts small blind 300
ololoyez: posts big blind 600
*** HOLE CARDS ***
Dealt to kanococo [9s Ts]
FckGermanRegulation: raises 600 to 1200
kanococo: folds
sucio: calls 1200
Zhrveil: folds
negozin: folds
anteeater1: folds
ololoyez: calls 600
*** FLOP *** [2h 6d 4c]
ololoyez: checks
FckGermanRegulation: checks
sucio: checks
*** TURN *** [2h 6d 4c] [Ah]
ololoyez: checks
FckGermanRegulation: bets 1800
sucio: calls 1800
ololoyez: folds
*** RIVER *** [2h 6d 4c Ah] [2d]
FckGermanRegulation: bets 8690 and is all-in
sucio: calls 8690
*** SHOW DOWN ***
FckGermanRegulation: shows [Ks Ac] (two pairs, Aces and Twos)
sucio: shows [Jh As] (two pairs, Aces and Twos)
FckGermanRegulation collected 25510 from pot
*** SUMMARY ***
Total pot 25510 | Rake 0
Board [ 2h 6d 4c Ah 2d ]
Game ended: 2025/08/31 22:13:28 GMT
Seat 1: anteeater1 (small blind) folded before Flop
Seat 2: ololoyez (big blind) folded on the Turn
Seat 3: FckGermanRegulation showed [Ks Ac] and won (25510) with two pairs, Aces and Twos
Seat 4: kanococo folded before Flop
Seat 5: sucio showed [Jh As]
Seat 6: Zhrveil folded before Flop
Seat 7: negozin (button) folded before Flop

CoinPoker Hand #290365228: Tournament #1361819, ₮1 Mini Sunday Smash PKO Hold'em No Limit (300/600 ante 90 play) 2025/08/31 22:13:29 GMT
Table '1' 7-max Seat #1 is the button
Seat 2: ololoyez (16745 in chips, 50 bounty)
Seat 3: FckGermanRegulation (25510 in chips, 50 bounty)
Seat 4: kanococo (9820 in chips, 50 bounty) is sitting out
Seat 5: sucio (15668 in chips, 100 bounty)
Seat 6: Zhrveil (10634 in chips, 75 bounty)
ololoyez: posts the ante 90
FckGermanRegulation: posts the ante 90
kanococo: posts the ante 90
sucio: posts the ante 90
Zhrveil: posts the ante 90
ololoyez: posts small blind 300
FckGermanRegulation: posts big blind 600
*** HOLE CARDS ***
Dealt to kanococo [Ad Td]
kanococo: folds
sucio: folds
Zhrveil: folds
ololoyez: raises 600 to 1200
FckGermanRegulation: folds
ololoyez collected 2250 from pot
ololoyez: doesn't show hand
*** SUMMARY ***
Total pot 2250 | Rake 0
Board [ ]
Game ended: 2025/08/31 22:13:44 GMT
Seat 2: ololoyez (small blind) collected (2250)
Seat 3: FckGermanRegulation (big blind) folded before Flop
Seat 4: kanococo folded before Flop
Seat 5: sucio folded before Flop
Seat 6: Zhrveil folded before Flop

CoinPoker Hand #290365310: Tournament #1361819, ₮1 Mini Sunday Smash PKO Hold'em No Limit (300/600 ante 90 play) 2025/08/31 22:13:45 GMT
Table '1' 7-max Seat #2 is the button
Seat 2: ololoyez (17705 in chips, 50 bounty)
Seat 3: FckGermanRegulation (24820 in chips, 50 bounty)
Seat 4: kanococo (9730 in chips, 50 bounty) is sitting out
Seat 5: sucio (15578 in chips, 100 bounty)
Seat 6: Zhrveil (10544 in chips, 75 bounty)
ololoyez: posts the ante 90
FckGermanRegulation: posts the ante 90
kanococo: posts the ante 90
sucio: posts the ante 90
Zhrveil: posts the ante 90
FckGermanRegulation: posts small blind 300
kanococo: posts big blind 600
*** HOLE CARDS ***
Dealt to kanococo [4s 9c]
sucio: folds
Zhrveil: folds
ololoyez: raises 600 to 1200
FckGermanRegulation: folds
kanococo: folds
ololoyez collected 2550 from pot
ololoyez: doesn't show hand
*** SUMMARY ***
Total pot 2550 | Rake 0
Board [ ]
Game ended: 2025/08/31 22:14:09 GMT
Seat 2: ololoyez (button) collected (2550)
Seat 3: FckGermanRegulation (small blind) folded before Flop
Seat 4: kanococo (big blind) folded before Flop
Seat 5: sucio folded before Flop
Seat 6: Zhrveil folded before Flop

CoinPoker Hand #290365562: Tournament #1361819, ₮1 Mini Sunday Smash PKO Hold'em No Limit (300/600 ante 90 play) 2025/08/31 22:14:11 GMT
Table '1' 7-max Seat #3 is the button
Seat 1: BPavel261284 (9395 in chips, 87 bounty)
Seat 2: ololoyez (18965 in chips, 50 bounty)
Seat 3: FckGermanRegulation (24430 in chips, 50 bounty)
Seat 4: kanococo (9040 in chips, 50 bounty) is sitting out
Seat 5: sucio (15488 in chips, 100 bounty)
Seat 6: Zhrveil (10454 in chips, 75 bounty)
Seat 7: menfiss19 (25698 in chips, 50 bounty)
BPavel261284: posts the ante 90
ololoyez: posts the ante 90
FckGermanRegulation: posts the ante 90
kanococo: posts the ante 90
sucio: posts the ante 90
Zhrveil: posts the ante 90
menfiss19: posts the ante 90
kanococo: posts small blind 300
sucio: posts big blind 600
*** HOLE CARDS ***
Dealt to kanococo [9d 4d]
Zhrveil: folds
menfiss19: raises 600 to 1200
BPavel261284: folds
ololoyez: calls 1200
FckGermanRegulation: folds
kanococo: folds
sucio: folds
*** FLOP *** [2c 2h Ts]
menfiss19: checks
ololoyez: bets 1965
menfiss19: calls 1965
*** TURN *** [2c 2h Ts] [Jd]
menfiss19: checks
ololoyez: checks
*** RIVER *** [2c 2h Ts Jd] [5d]
menfiss19: bets 5502
ololoyez: folds
Uncalled bet (5502) returned to menfiss19
menfiss19 collected 7860 from pot
menfiss19: doesn't show hand
*** SUMMARY ***
Total pot 7860 | Rake 0
Board [ 2c 2h Ts Jd 5d ]
Game ended: 2025/08/31 22:15:09 GMT
Seat 1: BPavel261284 folded before Flop
Seat 2: ololoyez folded on the River
Seat 3: FckGermanRegulation (button) folded before Flop
Seat 4: kanococo (small blind) folded before Flop
Seat 5: sucio (big blind) folded before Flop
Seat 6: Zhrveil folded before Flop
Seat 7: menfiss19 collected (7860)

CoinPoker Hand #290365910: Tournament #1361819, ₮1 Mini Sunday Smash PKO Hold'em No Limit (300/600 ante 90 play) 2025/08/31 22:15:10 GMT
Table '1' 7-max Seat #4 is the button
Seat 1: BPavel261284 (9305 in chips, 87 bounty)
Seat 2: ololoyez (15710 in chips, 50 bounty)
Seat 3: FckGermanRegulation (24340 in chips, 50 bounty)
Seat 4: kanococo (8650 in chips, 50 bounty) is sitting out
Seat 5: sucio (14798 in chips, 100 bounty)
Seat 6: Zhrveil (10364 in chips, 75 bounty)
Seat 7: menfiss19 (30303 in chips, 50 bounty)
BPavel261284: posts the ante 90
ololoyez: posts the ante 90
FckGermanRegulation: posts the ante 90
kanococo: posts the ante 90
sucio: posts the ante 90
Zhrveil: posts the ante 90
menfiss19: posts the ante 90
sucio: posts small blind 300
Zhrveil: posts big blind 600
*** HOLE CARDS ***
Dealt to kanococo [Js 2h]
menfiss19: folds
BPavel261284: folds
ololoyez: folds
FckGermanRegulation: folds
kanococo: folds
sucio: folds
Zhrveil collected 1530 from pot
Zhrveil: doesn't show hand
*** SUMMARY ***
Total pot 1530 | Rake 0
Board [ ]
Game ended: 2025/08/31 22:15:30 GMT
Seat 1: BPavel261284 folded before Flop
Seat 2: ololoyez folded before Flop
Seat 3: FckGermanRegulation folded before Flop
Seat 4: kanococo (button) folded before Flop
Seat 5: sucio (small blind) folded before Flop
Seat 6: Zhrveil (big blind) collected (1530)
Seat 7: menfiss19 folded before Flop

CoinPoker Hand #290366039: Tournament #1361819, ₮1 Mini Sunday Smash PKO Hold'em No Limit (300/600 ante 90 play) 2025/08/31 22:15:31 GMT
Table '1' 7-max Seat #5 is the button
Seat 1: BPavel261284 (9215 in chips, 87 bounty)
Seat 2: ololoyez (15620 in chips, 50 bounty)
Seat 3: FckGermanRegulation (24250 in chips, 50 bounty)
Seat 4: kanococo (8560 in chips, 50 bounty) is sitting out
Seat 5: sucio (14408 in chips, 100 bounty)
Seat 6: Zhrveil (11204 in chips, 75 bounty)
Seat 7: menfiss19 (30213 in chips, 50 bounty)
BPavel261284: posts the ante 90
ololoyez: posts the ante 90
FckGermanRegulation: posts the ante 90
kanococo: posts the ante 90
sucio: posts the ante 90
Zhrveil: posts the ante 90
menfiss19: posts the ante 90
Zhrveil: posts small blind 300
menfiss19: posts big blind 600
*** HOLE CARDS ***
Dealt to kanococo [3h Kc]
BPavel261284: folds
ololoyez: folds
FckGermanRegulation: folds
kanococo: folds
sucio: folds
Zhrveil: folds
menfiss19 collected 1530 from pot
menfiss19: doesn't show hand
*** SUMMARY ***
Total pot 1530 | Rake 0
Board [ ]
Game ended: 2025/08/31 22:15:51 GMT
Seat 1: BPavel261284 folded before Flop
Seat 2: ololoyez folded before Flop
Seat 3: FckGermanRegulation folded before Flop
Seat 4: kanococo folded before Flop
Seat 5: sucio (button) folded before Flop
Seat 6: Zhrveil (small blind) folded before Flop
Seat 7: menfiss19 (big blind) collected (1530)

CoinPoker Hand #290366181: Tournament #1361819, ₮1 Mini Sunday Smash PKO Hold'em No Limit (300/600 ante 90 play) 2025/08/31 22:15:52 GMT
Table '1' 7-max Seat #6 is the button
Seat 1: BPavel261284 (9125 in chips, 87 bounty)
Seat 2: ololoyez (15530 in chips, 50 bounty)
Seat 3: FckGermanRegulation (24160 in chips, 50 bounty)
Seat 4: kanococo (8470 in chips, 50 bounty) is sitting out
Seat 5: sucio (14318 in chips, 100 bounty)
Seat 6: Zhrveil (10814 in chips, 75 bounty)
Seat 7: menfiss19 (31053 in chips, 50 bounty)
BPavel261284: posts the ante 90
ololoyez: posts the ante 90
FckGermanRegulation: posts the ante 90
kanococo: posts the ante 90
sucio: posts the ante 90
Zhrveil: posts the ante 90
menfiss19: posts the ante 90
menfiss19: posts small blind 300
BPavel261284: posts big blind 600
*** HOLE CARDS ***
Dealt to kanococo [6s 4s]
ololoyez: folds
FckGermanRegulation: folds
kanococo: folds
sucio: folds
Zhrveil: raises 600 to 1200
menfiss19: raises 30663 and is all-in
BPavel261284: folds
Zhrveil: folds
menfiss19 collected 33393 from pot
menfiss19: doesn't show hand
*** SUMMARY ***
Total pot 33393 | Rake 0
Board [ ]
Game ended: 2025/08/31 22:16:35 GMT
Seat 1: BPavel261284 (big blind) folded before Flop
Seat 2: ololoyez folded before Flop
Seat 3: FckGermanRegulation folded before Flop
Seat 4: kanococo folded before Flop
Seat 5: sucio folded before Flop
Seat 6: Zhrveil (button) folded before Flop
Seat 7: menfiss19 (small blind) collected (33393)

CoinPoker Hand #290366471: Tournament #1361819, ₮1 Mini Sunday Smash PKO Hold'em No Limit (350/700 ante 105 play) 2025/08/31 22:16:40 GMT
Table '1' 7-max Seat #7 is the button
Seat 1: BPavel261284 (8435 in chips, 87 bounty)
Seat 2: ololoyez (15440 in chips, 50 bounty)
Seat 3: FckGermanRegulation (24070 in chips, 50 bounty)
Seat 4: kanococo (8380 in chips, 50 bounty) is sitting out
Seat 5: sucio (14228 in chips, 100 bounty)
Seat 6: Zhrveil (9524 in chips, 75 bounty)
Seat 7: menfiss19 (33393 in chips, 50 bounty)
BPavel261284: posts the ante 105
ololoyez: posts the ante 105
FckGermanRegulation: posts the ante 105
kanococo: posts the ante 105
sucio: posts the ante 105
Zhrveil: posts the ante 105
menfiss19: posts the ante 105
BPavel261284: posts small blind 350
ololoyez: posts big blind 700
*** HOLE CARDS ***
Dealt to kanococo [Td 9h]
FckGermanRegulation: folds
kanococo: folds
sucio: raises 700 to 1400
Zhrveil: folds
menfiss19: folds
BPavel261284: folds
ololoyez: calls 700
*** FLOP *** [Ah 7c Kc]
ololoyez: checks
sucio: bets 12723 and is all-in
ololoyez: folds
Uncalled bet (12723) returned to sucio
sucio collected 3885 from pot
sucio: doesn't show hand
*** SUMMARY ***
Total pot 3885 | Rake 0
Board [ Ah 7c Kc ]
Game ended: 2025/08/31 22:17:16 GMT
Seat 1: BPavel261284 (small blind) folded before Flop
Seat 2: ololoyez (big blind) folded on the Flop
Seat 3: FckGermanRegulation folded before Flop
Seat 4: kanococo folded before Flop
Seat 5: sucio collected (3885)
Seat 6: Zhrveil folded before Flop
Seat 7: menfiss19 (button) folded before Flop

CoinPoker Hand #290366688: Tournament #1361819, ₮1 Mini Sunday Smash PKO Hold'em No Limit (350/700 ante 105 play) 2025/08/31 22:17:17 GMT
Table '1' 7-max Seat #1 is the button
Seat 1: BPavel261284 (7980 in chips, 87 bounty)
Seat 2: ololoyez (13935 in chips, 50 bounty)
Seat 3: FckGermanRegulation (23965 in chips, 50 bounty)
Seat 4: kanococo (8275 in chips, 50 bounty) is sitting out
Seat 5: sucio (16608 in chips, 100 bounty)
Seat 6: Zhrveil (9419 in chips, 75 bounty)
Seat 7: menfiss19 (33288 in chips, 50 bounty)
BPavel261284: posts the ante 105
ololoyez: posts the ante 105
FckGermanRegulation: posts the ante 105
kanococo: posts the ante 105
sucio: posts the ante 105
Zhrveil: posts the ante 105
menfiss19: posts the ante 105
ololoyez: posts small blind 350
FckGermanRegulation: posts big blind 700
*** HOLE CARDS ***
Dealt to kanococo [Qc Qd]
kanococo: folds
sucio: raises 700 to 1400
Zhrveil: folds
menfiss19: folds
BPavel261284: folds
ololoyez: calls 1050
FckGermanRegulation: raises 23160 and is all-in
sucio: folds
ololoyez: folds
FckGermanRegulation collected 27395 from pot
FckGermanRegulation: doesn't show hand
*** SUMMARY ***
Total pot 27395 | Rake 0
Board [ ]
Game ended: 2025/08/31 22:18:04 GMT
Seat 1: BPavel261284 (button) folded before Flop
Seat 2: ololoyez (small blind) folded before Flop
Seat 3: FckGermanRegulation (big blind) collected (27395)
Seat 4: kanococo folded before Flop
Seat 5: sucio folded before Flop
Seat 6: Zhrveil folded before Flop
Seat 7: menfiss19 folded before Flop

CoinPoker Hand #290367150: Tournament #1361819, ₮1 Mini Sunday Smash PKO Hold'em No Limit (350/700 ante 105 play) 2025/08/31 22:18:05 GMT
Table '1' 7-max Seat #2 is the button
Seat 1: BPavel261284 (7875 in chips, 87 bounty)
Seat 2: ololoyez (12430 in chips, 50 bounty)
Seat 3: FckGermanRegulation (27395 in chips, 50 bounty)
Seat 4: kanococo (8170 in chips, 50 bounty)
Seat 5: sucio (15103 in chips, 100 bounty)
Seat 6: Zhrveil (9314 in chips, 75 bounty)
Seat 7: menfiss19 (33183 in chips, 50 bounty)
BPavel261284: posts the ante 105
ololoyez: posts the ante 105
FckGermanRegulation: posts the ante 105
kanococo: posts the ante 105
sucio: posts the ante 105
Zhrveil: posts the ante 105
menfiss19: posts the ante 105
FckGermanRegulation: posts small blind 350
kanococo: posts big blind 700
*** HOLE CARDS ***
Dealt to kanococo [Kd Ah]
sucio: folds
Zhrveil: folds
menfiss19: folds
BPavel261284: folds
ololoyez: raises 700 to 1400
FckGermanRegulation: folds
kanococo: raises 1400 to 2800
ololoyez: calls 1400
*** FLOP *** [7s 2c 5d]
kanococo: checks
ololoyez: bets 3342
kanococo: calls 3342
*** TURN *** [7s 2c 5d] [Ts]
kanococo: bets 1923 and is all-in
ololoyez: folds
Uncalled bet (1923) returned to kanococo
kanococo collected 13369 from pot
kanococo: doesn't show hand
*** SUMMARY ***
Total pot 13369 | Rake 0
Board [ 7s 2c 5d Ts ]
Game ended: 2025/08/31 22:19:43 GMT
Seat 1: BPavel261284 folded before Flop
Seat 2: ololoyez (button) folded on the Turn
Seat 3: FckGermanRegulation (small blind) folded before Flop
Seat 4: kanococo (big blind) collected (13369)
Seat 5: sucio folded before Flop
Seat 6: Zhrveil folded before Flop
Seat 7: menfiss19 folded before Flop

CoinPoker Hand #290367765: Tournament #1361819, ₮1 Mini Sunday Smash PKO Hold'em No Limit (350/700 ante 105 play) 2025/08/31 22:19:44 GMT
Table '1' 7-max Seat #3 is the button
Seat 1: BPavel261284 (7770 in chips, 87 bounty)
Seat 3: FckGermanRegulation (26940 in chips, 50 bounty)
Seat 4: kanococo (15292 in chips, 50 bounty)
Seat 5: sucio (14998 in chips, 100 bounty)
Seat 6: Zhrveil (9209 in chips, 75 bounty)
Seat 7: menfiss19 (33078 in chips, 50 bounty)
BPavel261284: posts the ante 105
FckGermanRegulation: posts the ante 105
kanococo: posts the ante 105
sucio: posts the ante 105
Zhrveil: posts the ante 105
menfiss19: posts the ante 105
kanococo: posts small blind 350
sucio: posts big blind 700
*** HOLE CARDS ***
Dealt to kanococo [Kh 2c]
kanococo said, "wow"
Zhrveil: folds
menfiss19: folds
BPavel261284: calls 700
FckGermanRegulation: folds
kanococo: raises 700 to 1400
sucio: raises 2800 to 4200
BPavel261284: folds
kanococo: folds
sucio collected 6930 from pot
sucio: doesn't show hand
*** SUMMARY ***
Total pot 6930 | Rake 0
Board [ ]
Game ended: 2025/08/31 22:20:23 GMT
Seat 1: BPavel261284 folded before Flop
Seat 3: FckGermanRegulation (button) folded before Flop
Seat 4: kanococo (small blind) folded before Flop
Seat 5: sucio (big blind) collected (6930)
Seat 6: Zhrveil folded before Flop
Seat 7: menfiss19 folded before Flop

CoinPoker Hand #290368017: Tournament #1361819, ₮1 Mini Sunday Smash PKO Hold'em No Limit (350/700 ante 105 play) 2025/08/31 22:20:24 GMT
Table '1' 7-max Seat #4 is the button
Seat 1: BPavel261284 (6965 in chips, 87 bounty)
Seat 3: FckGermanRegulation (26835 in chips, 50 bounty)
Seat 4: kanococo (13787 in chips, 50 bounty)
Seat 5: sucio (17623 in chips, 100 bounty)
Seat 6: Zhrveil (9104 in chips, 75 bounty)
Seat 7: menfiss19 (32973 in chips, 50 bounty)
BPavel261284: posts the ante 105
FckGermanRegulation: posts the ante 105
kanococo: posts the ante 105
sucio: posts the ante 105
Zhrveil: posts the ante 105
menfiss19: posts the ante 105
sucio: posts small blind 350
Zhrveil: posts big blind 700
*** HOLE CARDS ***
Dealt to kanococo [9h 8c]
menfiss19: folds
BPavel261284: folds
FckGermanRegulation: folds
kanococo: folds
sucio: folds
Zhrveil collected 1680 from pot
Zhrveil: doesn't show hand
*** SUMMARY ***
Total pot 1680 | Rake 0
Board [ ]
Game ended: 2025/08/31 22:20:38 GMT
Seat 1: BPavel261284 folded before Flop
Seat 3: FckGermanRegulation folded before Flop
Seat 4: kanococo (button) folded before Flop
Seat 5: sucio (small blind) folded before Flop
Seat 6: Zhrveil (big blind) collected (1680)
Seat 7: menfiss19 folded before Flop

CoinPoker Hand #290368132: Tournament #1361819, ₮1 Mini Sunday Smash PKO Hold'em No Limit (350/700 ante 105 play) 2025/08/31 22:20:39 GMT
Table '1' 7-max Seat #5 is the button
Seat 1: BPavel261284 (6860 in chips, 87 bounty)
Seat 3: FckGermanRegulation (26730 in chips, 50 bounty)
Seat 4: kanococo (13682 in chips, 50 bounty)
Seat 5: sucio (17168 in chips, 100 bounty)
Seat 6: Zhrveil (9979 in chips, 75 bounty)
Seat 7: menfiss19 (32868 in chips, 50 bounty)
BPavel261284: posts the ante 105
FckGermanRegulation: posts the ante 105
kanococo: posts the ante 105
sucio: posts the ante 105
Zhrveil: posts the ante 105
menfiss19: posts the ante 105
Zhrveil: posts small blind 350
menfiss19: posts big blind 700
*** HOLE CARDS ***
Dealt to kanococo [7c 6d]
BPavel261284: raises 6755 and is all-in
FckGermanRegulation: folds
kanococo: folds
sucio: folds
Zhrveil: folds
menfiss19: calls 6055
*** FLOP *** [4h 3h Th]
*** TURN *** [4h 3h Th] [Ks]
*** RIVER *** [4h 3h Th Ks] [9s]
*** SHOW DOWN ***
BPavel261284: shows [9d Ah] (a pair of Nines)
menfiss19: shows [9h Tc] (two pairs, Tens and Nines)
menfiss19 collected 14490 from pot
*** SUMMARY ***
Total pot 14490 | Rake 0
Board [ 4h 3h Th Ks 9s ]
Game ended: 2025/08/31 22:21:25 GMT
Seat 1: BPavel261284 showed [9d Ah]
Seat 3: FckGermanRegulation folded before Flop
Seat 4: kanococo folded before Flop
Seat 5: sucio (button) folded before Flop
Seat 6: Zhrveil (small blind) folded before Flop
Seat 7: menfiss19 (big blind) showed [9h Tc] and won (14490) with two pairs, Tens and Nines

CoinPoker Hand #290368603: Tournament #1361819, ₮1 Mini Sunday Smash PKO Hold'em No Limit (350/700 ante 105 play) 2025/08/31 22:21:56 GMT
Table '19' 7-max Seat #2 is the button
Seat 1: pokadokapoka (14769 in chips, 88 bounty)
Seat 2: MastaBeta (3165 in chips, 50 bounty)
Seat 3: Buman96 (12190 in chips, 50 bounty)
Seat 4: MagicMushroom (23446 in chips, 100 bounty)
Seat 5: kanococo (13577 in chips, 50 bounty)
Seat 6: VollenAce (28485 in chips, 50 bounty)
Seat 7: zX9 (28305 in chips, 100 bounty)
pokadokapoka: posts the ante 105
MastaBeta: posts the ante 105
Buman96: posts the ante 105
MagicMushroom: posts the ante 105
kanococo: posts the ante 105
VollenAce: posts the ante 105
zX9: posts the ante 105
Buman96: posts small blind 350
MagicMushroom: posts big blind 700
*** HOLE CARDS ***
Dealt to kanococo [6s Kd]
kanococo: folds
VollenAce: folds
zX9: raises 700 to 1400
pokadokapoka: folds
MastaBeta: folds
Buman96: folds
MagicMushroom: folds
zX9 collected 3185 from pot
zX9: doesn't show hand
*** SUMMARY ***
Total pot 3185 | Rake 0
Board [ ]
Game ended: 2025/08/31 22:22:25 GMT
Seat 1: pokadokapoka folded before Flop
Seat 2: MastaBeta (button) folded before Flop
Seat 3: Buman96 (small blind) folded before Flop
Seat 4: MagicMushroom (big blind) folded before Flop
Seat 5: kanococo folded before Flop
Seat 6: VollenAce folded before Flop
Seat 7: zX9 collected (3185)

CoinPoker Hand #290368741: Tournament #1361819, ₮1 Mini Sunday Smash PKO Hold'em No Limit (400/800 ante 120 play) 2025/08/31 22:22:31 GMT
Table '19' 7-max Seat #3 is the button
Seat 1: pokadokapoka (14664 in chips, 88 bounty)
Seat 2: MastaBeta (3060 in chips, 50 bounty)
Seat 3: Buman96 (11735 in chips, 50 bounty)
Seat 4: MagicMushroom (22641 in chips, 100 bounty)
Seat 5: kanococo (13472 in chips, 50 bounty)
Seat 6: VollenAce (28380 in chips, 50 bounty)
Seat 7: zX9 (29985 in chips, 100 bounty)
pokadokapoka: posts the ante 120
MastaBeta: posts the ante 120
Buman96: posts the ante 120
MagicMushroom: posts the ante 120
kanococo: posts the ante 120
VollenAce: posts the ante 120
zX9: posts the ante 120
MagicMushroom: posts small blind 400
kanococo: posts big blind 800
*** HOLE CARDS ***
Dealt to kanococo [5h 9d]
VollenAce: folds
zX9: raises 800 to 1600
pokadokapoka: folds
MastaBeta: folds
Buman96: folds
MagicMushroom: calls 1200
kanococo: folds
*** FLOP *** [8s Ad 6d]
MagicMushroom: checks
zX9: bets 1161
MagicMushroom: folds
Uncalled bet (1161) returned to zX9
zX9 collected 4840 from pot
zX9: doesn't show hand
*** SUMMARY ***
Total pot 4840 | Rake 0
Board [ 8s Ad 6d ]
Game ended: 2025/08/31 22:23:05 GMT
Seat 1: pokadokapoka folded before Flop
Seat 2: MastaBeta folded before Flop
Seat 3: Buman96 (button) folded before Flop
Seat 4: MagicMushroom (small blind) folded on the Flop
Seat 5: kanococo (big blind) folded before Flop
Seat 6: VollenAce folded before Flop
Seat 7: zX9 collected (4840)

CoinPoker Hand #290368996: Tournament #1361819, ₮1 Mini Sunday Smash PKO Hold'em No Limit (400/800 ante 120 play) 2025/08/31 22:23:07 GMT
Table '19' 7-max Seat #4 is the button
Seat 1: pokadokapoka (14544 in chips, 88 bounty)
Seat 2: MastaBeta (2940 in chips, 50 bounty)
Seat 3: Buman96 (11615 in chips, 50 bounty)
Seat 4: MagicMushroom (20921 in chips, 100 bounty)
Seat 5: kanococo (12552 in chips, 50 bounty)
Seat 6: VollenAce (28260 in chips, 50 bounty)
Seat 7: zX9 (33105 in chips, 100 bounty)
pokadokapoka: posts the ante 120
MastaBeta: posts the ante 120
Buman96: posts the ante 120
MagicMushroom: posts the ante 120
kanococo: posts the ante 120
VollenAce: posts the ante 120
zX9: posts the ante 120
kanococo: posts small blind 400
VollenAce: posts big blind 800
*** HOLE CARDS ***
Dealt to kanococo [Jh Qd]
zX9: folds
pokadokapoka: raises 800 to 1600
MastaBeta: folds
Buman96: folds
MagicMushroom: folds
kanococo: raises 1600 to 3200
VollenAce: calls 2400
pokadokapoka: calls 1600
*** FLOP *** [4s Js Kh]
kanococo: bets 5220
VollenAce: calls 5220
pokadokapoka: folds
*** TURN *** [4s Js Kh] [Kc]
kanococo: bets 4012 and is all-in
VollenAce: calls 4012
*** RIVER *** [4s Js Kh Kc] [8c]
*** SHOW DOWN ***
kanococo: shows [Jh Qd] (two pairs, Kings and Jacks)
VollenAce: shows [Th Kd] (three of kind, Kings)
VollenAce collected 28904 from pot
*** SUMMARY ***
Total pot 28904 | Rake 0
Board [ 4s Js Kh Kc 8c ]
Game ended: 2025/08/31 22:24:34 GMT
Seat 1: pokadokapoka folded on the Flop
Seat 2: MastaBeta folded before Flop
Seat 3: Buman96 folded before Flop
Seat 4: MagicMushroom (button) folded before Flop
Seat 5: kanococo (small blind) showed [Jh Qd]
Seat 6: VollenAce (big blind) showed [Th Kd] and won (28904) with three of kind, Kings
Seat 7: zX9 folded before Flop

CoinPoker Hand #290773878: Tournament #1364623, Bankroll Starter Freeroll, 20 x ₮0.50 tickets Hold'em No Limit (50/100 ante 13 play) 2025/09/01 21:01:59 GMT
Table '13' 7-max Seat #7 is the button
Seat 1: mcgueen (4774 in chips)
Seat 2: hossein9 (4974 in chips) is sitting out
Seat 3: Lapenho7 (10102 in chips)
Seat 4: StairRoyalFlush (4974 in chips)
Seat 5: shorelinedr (5252 in chips)
Seat 6: GoGoJaga (4924 in chips)
Seat 7: kanococo (5000 in chips) out of hand
mcgueen: posts the ante 13
hossein9: posts the ante 13
Lapenho7: posts the ante 13
StairRoyalFlush: posts the ante 13
shorelinedr: posts the ante 13
GoGoJaga: posts the ante 13
mcgueen: posts small blind 50
hossein9: posts big blind 100
*** HOLE CARDS ***
Lapenho7: folds
StairRoyalFlush: folds
shorelinedr: raises 100 to 200
GoGoJaga: folds
mcgueen has timed out
mcgueen activated time-bank (11 seconds)
hossein9 has reconnected
mcgueen: folds
hossein9: folds
shorelinedr collected 428 from pot
shorelinedr: doesn't show hand
*** SUMMARY ***
Total pot 428 | Rake 0
Board [ ]
Game ended: 2025/09/01 21:02:30 GMT
Seat 1: mcgueen (small blind) folded before Flop
Seat 2: hossein9 (big blind) folded before Flop
Seat 3: Lapenho7 folded before Flop
Seat 4: StairRoyalFlush folded before Flop
Seat 5: shorelinedr collected (428)
Seat 6: GoGoJaga folded before Flop
Seat 7: kanococo (button) folded before Flop (didn't bet)

CoinPoker Hand #290774496: Tournament #1364623, Bankroll Starter Freeroll, 20 x ₮0.50 tickets Hold'em No Limit (50/100 ante 13 play) 2025/09/01 21:02:33 GMT
Table '13' 7-max Seat #1 is the button
Seat 1: mcgueen (4711 in chips)
Seat 2: hossein9 (4861 in chips)
Seat 3: Lapenho7 (10089 in chips)
Seat 4: StairRoyalFlush (4961 in chips)
Seat 5: shorelinedr (5467 in chips)
Seat 6: GoGoJaga (4911 in chips)
Seat 7: kanococo (5000 in chips)
mcgueen: posts the ante 13
hossein9: posts the ante 13
Lapenho7: posts the ante 13
StairRoyalFlush: posts the ante 13
shorelinedr: posts the ante 13
GoGoJaga: posts the ante 13
kanococo: posts the ante 13
hossein9: posts small blind 50
Lapenho7: posts big blind 100
*** HOLE CARDS ***
Dealt to kanococo [8s 7s]
StairRoyalFlush: folds
kanococo is disconnected
shorelinedr: raises 341 to 441
GoGoJaga: folds
kanococo has timed out wile being disconnected
kanococo activated time-bank (30 seconds)
kanococo has timed out wile being disconnected
kanococo: folds
mcgueen: calls 441
hossein9: folds
Lapenho7 has timed out
Lapenho7 activated time-bank (30 seconds)
Lapenho7: folds
*** FLOP *** [5c Td Qs]
shorelinedr: bets 561
mcgueen has timed out
mcgueen activated time-bank (6 seconds)
mcgueen: calls 561
*** TURN *** [5c Td Qs] [Ks]
shorelinedr: bets 1122
mcgueen: calls 1122
*** RIVER *** [5c Td Qs Ks] [6s]
shorelinedr: checks
mcgueen: bets 2574 and is all-in
shorelinedr: folds
Uncalled bet (2574) returned to mcgueen
mcgueen collected 4489 from pot
mcgueen: doesn't show hand
*** SUMMARY ***
Total pot 4489 | Rake 0
Board [ 5c Td Qs Ks 6s ]
Game ended: 2025/09/01 21:04:20 GMT
Seat 1: mcgueen (button) collected (4489)
Seat 2: hossein9 (small blind) folded before Flop
Seat 3: Lapenho7 (big blind) folded before Flop
Seat 4: StairRoyalFlush folded before Flop
Seat 5: shorelinedr folded on the River
Seat 6: GoGoJaga folded before Flop
Seat 7: kanococo folded before Flop

CoinPoker Hand #290776177: Tournament #1364623, Bankroll Starter Freeroll, 20 x ₮0.50 tickets Hold'em No Limit (60/120 ante 15 play) 2025/09/01 21:04:28 GMT
Table '13' 7-max Seat #2 is the button
Seat 1: mcgueen (7063 in chips)
Seat 2: hossein9 (4798 in chips)
Seat 3: Lapenho7 (9976 in chips)
Seat 4: StairRoyalFlush (4948 in chips)
Seat 5: shorelinedr (3330 in chips)
Seat 6: GoGoJaga (4898 in chips)
Seat 7: kanococo (4987 in chips) is sitting out
mcgueen: posts the ante 15
hossein9: posts the ante 15
Lapenho7: posts the ante 15
StairRoyalFlush: posts the ante 15
shorelinedr: posts the ante 15
GoGoJaga: posts the ante 15
kanococo: posts the ante 15
Lapenho7: posts small blind 60
StairRoyalFlush: posts big blind 120
*** HOLE CARDS ***
Dealt to kanococo [Kh Js]
shorelinedr: raises 3315 and is all-in
GoGoJaga: folds
kanococo: folds
mcgueen: folds
hossein9: calls 3315
Lapenho7: folds
StairRoyalFlush: folds
*** FLOP *** [7s 4d 5d]
*** TURN *** [7s 4d 5d] [3d]
*** RIVER *** [7s 4d 5d 3d] [Ah]
*** SHOW DOWN ***
shorelinedr: shows [5h 2c] (a straight, Five high)
hossein9: shows [Th Ts] (a pair of Tens)
shorelinedr collected 6915 from pot
*** SUMMARY ***
Total pot 6915 | Rake 0
Board [ 7s 4d 5d 3d Ah ]
Game ended: 2025/09/01 21:04:54 GMT
Seat 1: mcgueen folded before Flop
Seat 2: hossein9 (button) showed [Th Ts]
Seat 3: Lapenho7 (small blind) folded before Flop
Seat 4: StairRoyalFlush (big blind) folded before Flop
Seat 5: shorelinedr showed [5h 2c] and won (6915) with a straight, Five high
Seat 6: GoGoJaga folded before Flop
Seat 7: kanococo folded before Flop

CoinPoker Hand #290776418: Tournament #1364623, Bankroll Starter Freeroll, 20 x ₮0.50 tickets Hold'em No Limit (60/120 ante 15 play) 2025/09/01 21:04:57 GMT
Table '13' 7-max Seat #3 is the button
Seat 1: mcgueen (7048 in chips)
Seat 2: hossein9 (1468 in chips)
Seat 3: Lapenho7 (9901 in chips)
Seat 4: StairRoyalFlush (4813 in chips)
Seat 5: shorelinedr (6915 in chips)
Seat 6: GoGoJaga (4883 in chips)
Seat 7: kanococo (4972 in chips) is sitting out
mcgueen: posts the ante 15
hossein9: posts the ante 15
Lapenho7: posts the ante 15
StairRoyalFlush: posts the ante 15
shorelinedr: posts the ante 15
GoGoJaga: posts the ante 15
kanococo: posts the ante 15
StairRoyalFlush: posts small blind 60
shorelinedr: posts big blind 120
*** HOLE CARDS ***
Dealt to kanococo [8c Ac]
GoGoJaga has timed out
GoGoJaga activated time-bank (29 seconds)
GoGoJaga: folds
kanococo: folds
mcgueen: calls 120
hossein9: folds
Lapenho7: folds
StairRoyalFlush: folds
shorelinedr: checks
*** FLOP *** [Ah 2d Jd]
shorelinedr: bets 120
mcgueen: calls 120
*** TURN *** [Ah 2d Jd] [5h]
shorelinedr: checks
mcgueen: checks
*** RIVER *** [Ah 2d Jd 5h] [8h]
shorelinedr: checks
mcgueen: checks
*** SHOW DOWN ***
shorelinedr: shows [Ks 9s] (Ace high)
mcgueen: shows [Kc Qd] (Ace high)
mcgueen collected 645 from pot
*** SUMMARY ***
Total pot 645 | Rake 0
Board [ Ah 2d Jd 5h 8h ]
Game ended: 2025/09/01 21:05:57 GMT
Seat 1: mcgueen showed [Kc Qd] and won (645) with Ace high
Seat 2: hossein9 folded before Flop
Seat 3: Lapenho7 (button) folded before Flop
Seat 4: StairRoyalFlush (small blind) folded before Flop
Seat 5: shorelinedr (big blind) showed [Ks 9s]
Seat 6: GoGoJaga folded before Flop
Seat 7: kanococo folded before Flop

CoinPoker Hand #290776823: Tournament #1364623, Bankroll Starter Freeroll, 20 x ₮0.50 tickets Hold'em No Limit (60/120 ante 15 play) 2025/09/01 21:06:01 GMT
Table '13' 7-max Seat #4 is the button
Seat 1: mcgueen (7438 in chips)
Seat 2: hossein9 (1453 in chips)
Seat 3: Lapenho7 (9886 in chips)
Seat 4: StairRoyalFlush (4738 in chips)
Seat 5: shorelinedr (6660 in chips)
Seat 6: GoGoJaga (4868 in chips)
Seat 7: kanococo (4957 in chips) is sitting out
mcgueen: posts the ante 15
hossein9: posts the ante 15
Lapenho7: posts the ante 15
StairRoyalFlush: posts the ante 15
shorelinedr: posts the ante 15
GoGoJaga: posts the ante 15
kanococo: posts the ante 15
shorelinedr: posts small blind 60
GoGoJaga: posts big blind 120
*** HOLE CARDS ***
Dealt to kanococo [3d 7c]
kanococo: folds
mcgueen: calls 120
hossein9: folds
kanococo has reconnected
Lapenho7: calls 120
StairRoyalFlush: folds
shorelinedr: calls 60
GoGoJaga: checks
*** FLOP *** [4c Ah Jh]
shorelinedr: bets 292
GoGoJaga: folds
mcgueen: folds
Lapenho7: folds
Uncalled bet (292) returned to shorelinedr
shorelinedr collected 585 from pot
shorelinedr: doesn't show hand
*** SUMMARY ***
Total pot 585 | Rake 0
Board [ 4c Ah Jh ]
Game ended: 2025/09/01 21:06:35 GMT
Seat 1: mcgueen folded on the Flop
Seat 2: hossein9 folded before Flop
Seat 3: Lapenho7 folded on the Flop
Seat 4: StairRoyalFlush (button) folded before Flop
Seat 5: shorelinedr (small blind) collected (585)
Seat 6: GoGoJaga (big blind) folded on the Flop
Seat 7: kanococo folded before Flop

CoinPoker Hand #290777064: Tournament #1364623, Bankroll Starter Freeroll, 20 x ₮0.50 tickets Hold'em No Limit (75/150 ante 19 play) 2025/09/01 21:06:41 GMT
Table '13' 7-max Seat #5 is the button
Seat 1: mcgueen (7303 in chips)
Seat 2: hossein9 (1438 in chips)
Seat 3: Lapenho7 (9751 in chips)
Seat 4: StairRoyalFlush (4723 in chips)
Seat 5: shorelinedr (7110 in chips)
Seat 6: GoGoJaga (4733 in chips)
Seat 7: kanococo (4942 in chips)
mcgueen: posts the ante 19
hossein9: posts the ante 19
Lapenho7: posts the ante 19
StairRoyalFlush: posts the ante 19
shorelinedr: posts the ante 19
GoGoJaga: posts the ante 19
kanococo: posts the ante 19
GoGoJaga: posts small blind 75
kanococo: posts big blind 150
*** HOLE CARDS ***
Dealt to kanococo [Ts 5d]
mcgueen has timed out
mcgueen activated time-bank (5 seconds)
mcgueen: folds
hossein9: folds
Lapenho7: raises 9732 and is all-in
StairRoyalFlush: folds
shorelinedr: folds
GoGoJaga: folds
kanococo: folds
Lapenho7 collected 10090 from pot
Lapenho7: doesn't show hand
*** SUMMARY ***
Total pot 10090 | Rake 0
Board [ ]
Game ended: 2025/09/01 21:07:08 GMT
Seat 1: mcgueen folded before Flop
Seat 2: hossein9 folded before Flop
Seat 3: Lapenho7 collected (10090)
Seat 4: StairRoyalFlush folded before Flop
Seat 5: shorelinedr (button) folded before Flop
Seat 6: GoGoJaga (small blind) folded before Flop
Seat 7: kanococo (big blind) folded before Flop

CoinPoker Hand #290777280: Tournament #1364623, Bankroll Starter Freeroll, 20 x ₮0.50 tickets Hold'em No Limit (75/150 ante 19 play) 2025/09/01 21:07:09 GMT
Table '13' 7-max Seat #6 is the button
Seat 1: mcgueen (7284 in chips)
Seat 2: hossein9 (1419 in chips)
Seat 3: Lapenho7 (10090 in chips)
Seat 4: StairRoyalFlush (4704 in chips)
Seat 5: shorelinedr (7091 in chips)
Seat 6: GoGoJaga (4639 in chips)
Seat 7: kanococo (4773 in chips)
mcgueen: posts the ante 19
hossein9: posts the ante 19
Lapenho7: posts the ante 19
StairRoyalFlush: posts the ante 19
shorelinedr: posts the ante 19
GoGoJaga: posts the ante 19
kanococo: posts the ante 19
kanococo: posts small blind 75
mcgueen: posts big blind 150
*** HOLE CARDS ***
Dealt to kanococo [Tc Td]
hossein9: raises 1400 and is all-in
Lapenho7: folds
StairRoyalFlush: folds
shorelinedr: calls 1400
GoGoJaga: folds
kanococo: calls 1325
mcgueen: folds
*** FLOP *** [3d 2s 7s]
kanococo: checks
shorelinedr: checks
*** TURN *** [3d 2s 7s] [Kc]
kanococo: bets 2241
shorelinedr: folds
Uncalled bet (2241) returned to kanococo
*** RIVER *** [3d 2s 7s Kc] [8d]
*** SHOW DOWN ***
kanococo: shows [Tc Td] (a pair of Tens)
hossein9: shows [Kh 9c] (a pair of Kings)
hossein9 collected 4483 from pot
*** SUMMARY ***
Total pot 4483 | Rake 0
Board [ 3d 2s 7s Kc 8d ]
Game ended: 2025/09/01 21:07:53 GMT
Seat 1: mcgueen (big blind) folded before Flop
Seat 2: hossein9 showed [Kh 9c] and won (4483) with a pair of Kings
Seat 3: Lapenho7 folded before Flop
Seat 4: StairRoyalFlush folded before Flop
Seat 5: shorelinedr folded on the Turn
Seat 6: GoGoJaga (button) folded before Flop
Seat 7: kanococo (small blind) showed [Tc Td]

CoinPoker Hand #290777532: Tournament #1364623, Bankroll Starter Freeroll, 20 x ₮0.50 tickets Hold'em No Limit (75/150 ante 19 play) 2025/09/01 21:07:54 GMT
Table '13' 7-max Seat #7 is the button
Seat 1: mcgueen (7115 in chips)
Seat 2: hossein9 (4483 in chips)
Seat 3: Lapenho7 (10071 in chips)
Seat 4: StairRoyalFlush (4685 in chips)
Seat 5: shorelinedr (5672 in chips)
Seat 6: GoGoJaga (4620 in chips)
Seat 7: kanococo (3354 in chips)
mcgueen: posts the ante 19
hossein9: posts the ante 19
Lapenho7: posts the ante 19
StairRoyalFlush: posts the ante 19
shorelinedr: posts the ante 19
GoGoJaga: posts the ante 19
kanococo: posts the ante 19
mcgueen: posts small blind 75
hossein9: posts big blind 150
*** HOLE CARDS ***
Dealt to kanococo [8s 5h]
Lapenho7: raises 150 to 300
StairRoyalFlush: calls 300
shorelinedr: calls 300
GoGoJaga: folds
kanococo: folds
mcgueen: calls 225
hossein9: calls 150
*** FLOP *** [7c Kh Qd]
mcgueen: checks
hossein9: checks
Lapenho7: checks
StairRoyalFlush: checks
shorelinedr: checks
*** TURN *** [7c Kh Qd] [As]
mcgueen: checks
hossein9: checks
Lapenho7: bets 816
StairRoyalFlush: folds
shorelinedr: folds
mcgueen: raises 6796 and is all-in
hossein9: folds
Lapenho7: calls 5980
*** RIVER *** [7c Kh Qd As] [Qs]
*** SHOW DOWN ***
mcgueen: shows [Tc Jd] (a straight, Ace high)
Lapenho7: shows [Td Ad] (two pairs, Aces and Queens)
mcgueen collected 15225 from pot
*** SUMMARY ***
Total pot 15225 | Rake 0
Board [ 7c Kh Qd As Qs ]
Game ended: 2025/09/01 21:08:46 GMT
Seat 1: mcgueen (small blind) showed [Tc Jd] and won (15225) with a straight, Ace high
Seat 2: hossein9 (big blind) folded on the Turn
Seat 3: Lapenho7 showed [Td Ad]
Seat 4: StairRoyalFlush folded on the Turn
Seat 5: shorelinedr folded on the Turn
Seat 6: GoGoJaga folded before Flop
Seat 7: kanococo (button) folded before Flop

CoinPoker Hand #290778316: Tournament #1364623, Bankroll Starter Freeroll, 20 x ₮0.50 tickets Hold'em No Limit (100/200 ante 25 play) 2025/09/01 21:09:35 GMT
Table '12' 7-max Seat #2 is the button
Seat 1: QuantToTheMoon (10073 in chips)
Seat 2: rikiidri (1061 in chips)
Seat 3: meghijah (7021 in chips)
Seat 4: BeastSRT (8639 in chips)
Seat 5: Eds9977 (11553 in chips)
Seat 6: AnastasiaC (4662 in chips) is sitting out
Seat 7: kanococo (3335 in chips)
QuantToTheMoon: posts the ante 25
rikiidri: posts the ante 25
meghijah: posts the ante 25
BeastSRT: posts the ante 25
Eds9977: posts the ante 25
AnastasiaC: posts the ante 25
kanococo: posts the ante 25
meghijah: posts small blind 100
BeastSRT: posts big blind 200
*** HOLE CARDS ***
Dealt to kanococo [3c Qs]
Eds9977: folds
AnastasiaC: folds
kanococo: raises 200 to 400
QuantToTheMoon: folds
rikiidri: folds
meghijah: raises 400 to 800
BeastSRT: folds
kanococo: calls 400
*** FLOP *** [6d Ks 5c]
meghijah: bets 987
kanococo: folds
Uncalled bet (987) returned to meghijah
meghijah collected 1975 from pot
meghijah: doesn't show hand
*** SUMMARY ***
Total pot 1975 | Rake 0
Board [ 6d Ks 5c ]
Game ended: 2025/09/01 21:10:31 GMT
Seat 1: QuantToTheMoon folded before Flop
Seat 2: rikiidri (button) folded before Flop
Seat 3: meghijah (small blind) collected (1975)
Seat 4: BeastSRT (big blind) folded before Flop
Seat 5: Eds9977 folded before Flop
Seat 6: AnastasiaC folded before Flop
Seat 7: kanococo folded on the Flop

CoinPoker Hand #290778645: Tournament #1364623, Bankroll Starter Freeroll, 20 x ₮0.50 tickets Hold'em No Limit (100/200 ante 25 play) 2025/09/01 21:10:32 GMT
Table '12' 7-max Seat #3 is the button
Seat 1: QuantToTheMoon (10048 in chips)
Seat 2: rikiidri (1036 in chips)
Seat 3: meghijah (8171 in chips)
Seat 4: BeastSRT (8414 in chips)
Seat 5: Eds9977 (11528 in chips)
Seat 6: AnastasiaC (4637 in chips) is sitting out
Seat 7: kanococo (2510 in chips)
QuantToTheMoon: posts the ante 25
rikiidri: posts the ante 25
meghijah: posts the ante 25
BeastSRT: posts the ante 25
Eds9977: posts the ante 25
AnastasiaC: posts the ante 25
kanococo: posts the ante 25
BeastSRT: posts small blind 100
Eds9977: posts big blind 200
*** HOLE CARDS ***
Dealt to kanococo [Qd Ks]
AnastasiaC: folds
kanococo: raises 200 to 400
QuantToTheMoon: folds
rikiidri: calls 400
meghijah: folds
BeastSRT: folds
Eds9977: calls 200
*** FLOP *** [9c 7d Qs]
Eds9977: checks
kanococo: bets 400
rikiidri: folds
Eds9977: folds
Uncalled bet (400) returned to kanococo
kanococo collected 1475 from pot
kanococo: doesn't show hand
*** SUMMARY ***
Total pot 1475 | Rake 0
Board [ 9c 7d Qs ]
Game ended: 2025/09/01 21:11:14 GMT
Seat 1: QuantToTheMoon folded before Flop
Seat 2: rikiidri folded on the Flop
Seat 3: meghijah (button) folded before Flop
Seat 4: BeastSRT (small blind) folded before Flop
Seat 5: Eds9977 (big blind) folded on the Flop
Seat 6: AnastasiaC folded before Flop
Seat 7: kanococo collected (1475)

CoinPoker Hand #290778939: Tournament #1364623, Bankroll Starter Freeroll, 20 x ₮0.50 tickets Hold'em No Limit (100/200 ante 25 play) 2025/09/01 21:11:15 GMT
Table '12' 7-max Seat #4 is the button
Seat 1: QuantToTheMoon (10023 in chips)
Seat 2: rikiidri (611 in chips)
Seat 3: meghijah (8146 in chips)
Seat 4: BeastSRT (8289 in chips)
Seat 5: Eds9977 (11103 in chips)
Seat 6: AnastasiaC (4612 in chips) is sitting out
Seat 7: kanococo (3560 in chips)
QuantToTheMoon: posts the ante 25
rikiidri: posts the ante 25
meghijah: posts the ante 25
BeastSRT: posts the ante 25
Eds9977: posts the ante 25
AnastasiaC: posts the ante 25
kanococo: posts the ante 25
Eds9977: posts small blind 100
AnastasiaC: posts big blind 200
*** HOLE CARDS ***
Dealt to kanococo [3d 7h]
kanococo: folds
QuantToTheMoon: folds
rikiidri has timed out
rikiidri activated time-bank (30 seconds)
rikiidri: raises 200 to 400
meghijah: folds
BeastSRT: raises 800 to 1200
Eds9977: folds
AnastasiaC: folds
rikiidri: calls 186 and is all-in
Uncalled bet (614) returned to BeastSRT
*** FLOP *** [Ts Ks 3s]
*** TURN *** [Ts Ks 3s] [9s]
*** RIVER *** [Ts Ks 3s 9s] [5s]
*** SHOW DOWN ***
BeastSRT: shows [As Td] (a flush, Ace high)
rikiidri: shows [Qh 8h] (a flush, King high)
BeastSRT collected 1647 from pot
*** SUMMARY ***
Total pot 1647 | Rake 0
Board [ Ts Ks 3s 9s 5s ]
Game ended: 2025/09/01 21:12:00 GMT
Seat 1: QuantToTheMoon folded before Flop
Seat 2: rikiidri showed [Qh 8h]
Seat 3: meghijah folded before Flop
Seat 4: BeastSRT (button) showed [As Td] and won (1647) with a flush, Ace high
Seat 5: Eds9977 (small blind) folded before Flop
Seat 6: AnastasiaC (big blind) folded before Flop
Seat 7: kanococo folded before Flop

CoinPoker Hand #290779289: Tournament #1364623, Bankroll Starter Freeroll, 20 x ₮0.50 tickets Hold'em No Limit (120/240 ante 30 play) 2025/09/01 21:12:08 GMT
Table '12' 7-max Seat #5 is the button
Seat 1: QuantToTheMoon (9998 in chips)
Seat 2: Cry (5000 in chips)
Seat 3: meghijah (8121 in chips)
Seat 4: BeastSRT (9325 in chips)
Seat 5: Eds9977 (10978 in chips)
Seat 6: AnastasiaC (4387 in chips) is sitting out
Seat 7: kanococo (3535 in chips)
QuantToTheMoon: posts the ante 30
Cry: posts the ante 30
meghijah: posts the ante 30
BeastSRT: posts the ante 30
Eds9977: posts the ante 30
AnastasiaC: posts the ante 30
kanococo: posts the ante 30
AnastasiaC: posts small blind 120
kanococo: posts big blind 240
*** HOLE CARDS ***
Dealt to kanococo [Ts Ac]
QuantToTheMoon: folds
Cry: folds
meghijah: folds
BeastSRT: folds
Eds9977: calls 240
AnastasiaC: folds
kanococo: raises 3265 and is all-in
Eds9977: calls 3265
*** FLOP *** [Tc 9s 5c]
*** TURN *** [Tc 9s 5c] [8c]
*** RIVER *** [Tc 9s 5c 8c] [Jd]
*** SHOW DOWN ***
kanococo: shows [Ts Ac] (a pair of Tens)
Eds9977: shows [6c 4s] (Jack high)
kanococo collected 7340 from pot
*** SUMMARY ***
Total pot 7340 | Rake 0
Board [ Tc 9s 5c 8c Jd ]
Game ended: 2025/09/01 21:12:53 GMT
Seat 1: QuantToTheMoon folded before Flop
Seat 2: Cry folded before Flop
Seat 3: meghijah folded before Flop
Seat 4: BeastSRT folded before Flop
Seat 5: Eds9977 (button) showed [6c 4s]
Seat 6: AnastasiaC (small blind) folded before Flop
Seat 7: kanococo (big blind) showed [Ts Ac] and won (7340) with a pair of Tens

CoinPoker Hand #290779676: Tournament #1364623, Bankroll Starter Freeroll, 20 x ₮0.50 tickets Hold'em No Limit (120/240 ante 30 play) 2025/09/01 21:12:54 GMT
Table '12' 7-max Seat #6 is the button
Seat 1: QuantToTheMoon (9968 in chips)
Seat 2: Cry (4970 in chips)
Seat 3: meghijah (8091 in chips)
Seat 4: BeastSRT (9295 in chips)
Seat 5: Eds9977 (7443 in chips)
Seat 6: AnastasiaC (4237 in chips) is sitting out
Seat 7: kanococo (7340 in chips)
QuantToTheMoon: posts the ante 30
Cry: posts the ante 30
meghijah: posts the ante 30
BeastSRT: posts the ante 30
Eds9977: posts the ante 30
AnastasiaC: posts the ante 30
kanococo: posts the ante 30
kanococo: posts small blind 120
QuantToTheMoon: posts big blind 240
*** HOLE CARDS ***
Dealt to kanococo [2c 6h]
Cry: raises 240 to 480
meghijah: folds
BeastSRT: folds
Eds9977: calls 480
AnastasiaC: folds
kanococo: folds
QuantToTheMoon: raises 960 to 1440
Cry: raises 4460 and is all-in
Eds9977: raises 6933 and is all-in
QuantToTheMoon: calls 5973
*** FLOP *** [3h 2d 9h]
*** TURN *** [3h 2d 9h] [6d]
*** RIVER *** [3h 2d 9h 6d] [7d]
*** SHOW DOWN ***
Eds9977: shows [Qc 6c] (a pair of Sixes)
QuantToTheMoon: shows [Jc Kc] (King high)
Eds9977 collected 4946 from side-pot 1
Cry: shows [Th Ad] (Ace high)
Eds9977 collected 15150 from pot
*** SUMMARY ***
Total pot 20096 | Rake 0
Board [ 3h 2d 9h 6d 7d ]
Game ended: 2025/09/01 21:13:53 GMT
Seat 1: QuantToTheMoon (big blind) showed [Jc Kc]
Seat 2: Cry showed [Th Ad]
Seat 3: meghijah folded before Flop
Seat 4: BeastSRT folded before Flop
Seat 5: Eds9977 showed [Qc 6c] and won (20096) with a pair of Sixes
Seat 6: AnastasiaC (button) folded before Flop
Seat 7: kanococo (small blind) folded before Flop

CoinPoker Hand #290780091: Tournament #1364623, Bankroll Starter Freeroll, 20 x ₮0.50 tickets Hold'em No Limit (120/240 ante 30 play) 2025/09/01 21:13:54 GMT
Table '12' 7-max Seat #7 is the button
Seat 1: QuantToTheMoon (2525 in chips)
Seat 3: meghijah (8061 in chips)
Seat 4: BeastSRT (9265 in chips)
Seat 5: Eds9977 (20096 in chips)
Seat 6: AnastasiaC (4207 in chips) is sitting out
Seat 7: kanococo (7190 in chips)
QuantToTheMoon: posts the ante 30
meghijah: posts the ante 30
BeastSRT: posts the ante 30
Eds9977: posts the ante 30
AnastasiaC: posts the ante 30
kanococo: posts the ante 30
QuantToTheMoon: posts small blind 120
meghijah: posts big blind 240
*** HOLE CARDS ***
Dealt to kanococo [9d Jc]
BeastSRT: calls 240
Eds9977: folds
AnastasiaC: folds
kanococo: folds
QuantToTheMoon: calls 120
Daisyduke has reconnected
meghijah: checks
*** FLOP *** [Qh 3c Ad]
QuantToTheMoon: checks
meghijah: checks
BeastSRT: bets 450
QuantToTheMoon: folds
meghijah has timed out
meghijah activated time-bank (30 seconds)
meghijah: folds
Uncalled bet (450) returned to BeastSRT
BeastSRT collected 900 from pot
BeastSRT: doesn't show hand
*** SUMMARY ***
Total pot 900 | Rake 0
Board [ Qh 3c Ad ]
Game ended: 2025/09/01 21:14:43 GMT
Seat 1: QuantToTheMoon (small blind) folded on the Flop
Seat 3: meghijah (big blind) folded on the Flop
Seat 4: BeastSRT collected (900)
Seat 5: Eds9977 folded before Flop
Seat 6: AnastasiaC folded before Flop
Seat 7: kanococo (button) folded before Flop

CoinPoker Hand #290780473: Tournament #1364623, Bankroll Starter Freeroll, 20 x ₮0.50 tickets Hold'em No Limit (120/240 ante 30 play) 2025/09/01 21:14:45 GMT
Table '12' 7-max Seat #1 is the button
Seat 1: QuantToTheMoon (2255 in chips)
Seat 2: Daisyduke (5000 in chips) out of hand
Seat 3: meghijah (7791 in chips)
Seat 4: BeastSRT (9895 in chips)
Seat 5: Eds9977 (20066 in chips)
Seat 6: AnastasiaC (4177 in chips) is sitting out
Seat 7: kanococo (7160 in chips)
QuantToTheMoon: posts the ante 30
meghijah: posts the ante 30
BeastSRT: posts the ante 30
Eds9977: posts the ante 30
AnastasiaC: posts the ante 30
kanococo: posts the ante 30
meghijah: posts small blind 120
BeastSRT: posts big blind 240
*** HOLE CARDS ***
Dealt to kanococo [6d 2c]
Eds9977 has timed out
Eds9977 activated time-bank (30 seconds)
Eds9977: calls 240
AnastasiaC: folds
kanococo: folds
QuantToTheMoon: folds
meghijah: calls 120
BeastSRT: checks
*** FLOP *** [3d 2d Kh]
meghijah: folds
BeastSRT: bets 450
Eds9977: folds
Uncalled bet (450) returned to BeastSRT
BeastSRT collected 900 from pot
BeastSRT: doesn't show hand
*** SUMMARY ***
Total pot 900 | Rake 0
Board [ 3d 2d Kh ]
Game ended: 2025/09/01 21:15:32 GMT
Seat 1: QuantToTheMoon (button) folded before Flop
Seat 2: Daisyduke folded before Flop (didn't bet)
Seat 3: meghijah (small blind) folded on the Flop
Seat 4: BeastSRT (big blind) collected (900)
Seat 5: Eds9977 folded on the Flop
Seat 6: AnastasiaC folded before Flop
Seat 7: kanococo folded before Flop

CoinPoker Hand #290780770: Tournament #1364623, Bankroll Starter Freeroll, 20 x ₮0.50 tickets Hold'em No Limit (140/280 ante 35 play) 2025/09/01 21:15:37 GMT
Table '12' 7-max Seat #3 is the button
Seat 1: QuantToTheMoon (2225 in chips)
Seat 2: Daisyduke (5000 in chips)
Seat 3: meghijah (7521 in chips)
Seat 4: BeastSRT (10525 in chips)
Seat 5: Eds9977 (19796 in chips)
Seat 6: AnastasiaC (4147 in chips) is sitting out
Seat 7: kanococo (7130 in chips)
QuantToTheMoon: posts the ante 35
Daisyduke: posts the ante 35
meghijah: posts the ante 35
BeastSRT: posts the ante 35
Eds9977: posts the ante 35
AnastasiaC: posts the ante 35
kanococo: posts the ante 35
BeastSRT: posts small blind 140
Eds9977: posts big blind 280
*** HOLE CARDS ***
Dealt to kanococo [Jh Kd]
AnastasiaC: folds
kanococo: raises 280 to 560
QuantToTheMoon: folds
Daisyduke: calls 560
meghijah: folds
BeastSRT: calls 420
Eds9977: calls 280
*** FLOP *** [7d 2c Qd]
BeastSRT: checks
Eds9977: checks
kanococo: bets 560
Daisyduke: raises 4405 and is all-in
BeastSRT: folds
Eds9977: folds
kanococo: calls 3845
*** TURN *** [7d 2c Qd] [6c]
*** RIVER *** [7d 2c Qd 6c] [Th]
*** SHOW DOWN ***
Daisyduke: shows [6h Qh] (two pairs, Queens and Sixes)
kanococo: shows [Jh Kd] (King high)
Daisyduke collected 11295 from pot
*** SUMMARY ***
Total pot 11295 | Rake 0
Board [ 7d 2c Qd 6c Th ]
Game ended: 2025/09/01 21:16:35 GMT
Seat 1: QuantToTheMoon folded before Flop
Seat 2: Daisyduke showed [6h Qh] and won (11295) with two pairs, Queens and Sixes
Seat 3: meghijah (button) folded before Flop
Seat 4: BeastSRT (small blind) folded on the Flop
Seat 5: Eds9977 (big blind) folded on the Flop
Seat 6: AnastasiaC folded before Flop
Seat 7: kanococo showed [Jh Kd]

CoinPoker Hand #290781258: Tournament #1364623, Bankroll Starter Freeroll, 20 x ₮0.50 tickets Hold'em No Limit (140/280 ante 35 play) 2025/09/01 21:16:36 GMT
Table '12' 7-max Seat #4 is the button
Seat 1: QuantToTheMoon (2190 in chips)
Seat 2: Daisyduke (11295 in chips)
Seat 3: meghijah (7486 in chips)
Seat 4: BeastSRT (9930 in chips)
Seat 5: Eds9977 (19201 in chips)
Seat 6: AnastasiaC (4112 in chips) is sitting out
Seat 7: kanococo (2130 in chips)
QuantToTheMoon: posts the ante 35
Daisyduke: posts the ante 35
meghijah: posts the ante 35
BeastSRT: posts the ante 35
Eds9977: posts the ante 35
AnastasiaC: posts the ante 35
kanococo: posts the ante 35
Eds9977: posts small blind 140
AnastasiaC: posts big blind 280
*** HOLE CARDS ***
Dealt to kanococo [7d 3c]
kanococo: raises 2095 and is all-in
QuantToTheMoon: raises 2155 and is all-in
Daisyduke: folds
meghijah: folds
BeastSRT: folds
Eds9977: folds
AnastasiaC: folds
Uncalled bet (60) returned to QuantToTheMoon
*** FLOP *** [2h 8d Jd]
*** TURN *** [2h 8d Jd] [Qh]
*** RIVER *** [2h 8d Jd Qh] [Js]
*** SHOW DOWN ***
QuantToTheMoon: shows [Jc 8c] (a full house, Jacks over Eights)
kanococo: shows [7d 3c] (a pair of Jacks)
QuantToTheMoon collected 4855 from pot
*** SUMMARY ***
Total pot 4855 | Rake 0
Board [ 2h 8d Jd Qh Js ]
Game ended: 2025/09/01 21:17:07 GMT
Seat 1: QuantToTheMoon showed [Jc 8c] and won (4855) with a full house, Jacks over Eights
Seat 2: Daisyduke folded before Flop
Seat 3: meghijah folded before Flop
Seat 4: BeastSRT (button) folded before Flop
Seat 5: Eds9977 (small blind) folded before Flop
Seat 6: AnastasiaC (big blind) folded before Flop
Seat 7: kanococo showed [7d 3c]

CoinPoker Hand #291144825: Tournament #1364647, ₮1 Mini Dojo PKO Hold'em No Limit (70/140 ante 21 play) 2025/09/02 17:50:02 GMT
Table '3' 7-max Seat #2 is the button
Seat 1: kanococo (10000 in chips, 50 bounty)
Seat 2: niks2011 (10233 in chips, 50 bounty)
Seat 3: StairRoyalFlush (8013 in chips, 50 bounty)
Seat 5: jannpannn (29682 in chips, 100 bounty)
Seat 6: weiner99 (11623 in chips, 50 bounty)
Seat 7: legster (11065 in chips, 50 bounty)
kanococo: posts the ante 21
niks2011: posts the ante 21
StairRoyalFlush: posts the ante 21
jannpannn: posts the ante 21
weiner99: posts the ante 21
legster: posts the ante 21
StairRoyalFlush: posts small blind 70
jannpannn: posts big blind 140
*** HOLE CARDS ***
Dealt to kanococo [Ah Ac]
Scorpio2283 has reconnected
weiner99: folds
legster: raises 140 to 280
kanococo: raises 280 to 560
niks2011: folds
StairRoyalFlush: folds
jannpannn: folds
legster: calls 280
*** FLOP *** [4s 3s 2d]
legster: checks
kanococo: checks
*** TURN *** [4s 3s 2d] [Th]
legster: bets 1456
kanococo: raises 1456 to 2912
legster: calls 1456
*** RIVER *** [4s 3s 2d Th] [Qd]
legster: checks
kanococo: checks
*** SHOW DOWN ***
legster: shows [Jc Jd] (a pair of Jacks)
kanococo: shows [Ah Ac] (a pair of Aces)
kanococo collected 7280 from pot
*** SUMMARY ***
Total pot 7280 | Rake 0
Board [ 4s 3s 2d Th Qd ]
Game ended: 2025/09/02 17:51:03 GMT
Seat 1: kanococo showed [Ah Ac] and won (7280) with a pair of Aces
Seat 2: niks2011 (button) folded before Flop
Seat 3: StairRoyalFlush (small blind) folded before Flop
Seat 5: jannpannn (big blind) folded before Flop
Seat 6: weiner99 folded before Flop
Seat 7: legster showed [Jc Jd]

CoinPoker Hand #291145352: Tournament #1364647, ₮1 Mini Dojo PKO Hold'em No Limit (70/140 ante 21 play) 2025/09/02 17:51:03 GMT
Table '3' 7-max Seat #3 is the button
Seat 1: kanococo (13787 in chips, 50 bounty)
Seat 2: niks2011 (10212 in chips, 50 bounty)
Seat 3: StairRoyalFlush (7922 in chips, 50 bounty)
Seat 4: Scorpio2283 (10000 in chips, 50 bounty) out of hand
Seat 5: jannpannn (29521 in chips, 100 bounty)
Seat 6: weiner99 (11602 in chips, 50 bounty)
Seat 7: legster (7572 in chips, 50 bounty)
kanococo: posts the ante 21
niks2011: posts the ante 21
StairRoyalFlush: posts the ante 21
jannpannn: posts the ante 21
weiner99: posts the ante 21
legster: posts the ante 21
jannpannn: posts small blind 70
weiner99: posts big blind 140
*** HOLE CARDS ***
Dealt to kanococo [6c 3h]
legster: folds
kanococo: folds
niks2011: folds
StairRoyalFlush: folds
jannpannn: folds
weiner99 collected 336 from pot
weiner99 has timed out
weiner99: doesn't show hand
*** SUMMARY ***
Total pot 336 | Rake 0
Board [ ]
Game ended: 2025/09/02 17:51:22 GMT
Seat 1: kanococo folded before Flop
Seat 2: niks2011 folded before Flop
Seat 3: StairRoyalFlush (button) folded before Flop
Seat 4: Scorpio2283 folded before Flop (didn't bet)
Seat 5: jannpannn (small blind) folded before Flop
Seat 6: weiner99 (big blind) collected (336)
Seat 7: legster folded before Flop

CoinPoker Hand #291145524: Tournament #1364647, ₮1 Mini Dojo PKO Hold'em No Limit (70/140 ante 21 play) 2025/09/02 17:51:22 GMT
Table '3' 7-max Seat #5 is the button
Seat 1: kanococo (13766 in chips, 50 bounty)
Seat 2: niks2011 (10191 in chips, 50 bounty)
Seat 3: StairRoyalFlush (7901 in chips, 50 bounty)
Seat 4: Scorpio2283 (10000 in chips, 50 bounty)
Seat 5: jannpannn (29430 in chips, 100 bounty)
Seat 6: weiner99 (11777 in chips, 50 bounty)
Seat 7: legster (7551 in chips, 50 bounty)
kanococo: posts the ante 21
niks2011: posts the ante 21
StairRoyalFlush: posts the ante 21
Scorpio2283: posts the ante 21
jannpannn: posts the ante 21
weiner99: posts the ante 21
legster: posts the ante 21
weiner99: posts small blind 70
legster: posts big blind 140
*** HOLE CARDS ***
Dealt to kanococo [8c Ad]
kanococo: raises 140 to 280
niks2011: folds
StairRoyalFlush: folds
Scorpio2283: folds
jannpannn: calls 280
weiner99: folds
legster: calls 140
*** FLOP *** [6h As 8d]
legster: checks
kanococo: bets 528
jannpannn: folds
legster: folds
Uncalled bet (528) returned to kanococo
kanococo collected 1057 from pot
kanococo: doesn't show hand
*** SUMMARY ***
Total pot 1057 | Rake 0
Board [ 6h As 8d ]
Game ended: 2025/09/02 17:52:24 GMT
Seat 1: kanococo collected (1057)
Seat 2: niks2011 folded before Flop
Seat 3: StairRoyalFlush folded before Flop
Seat 4: Scorpio2283 folded before Flop
Seat 5: jannpannn (button) folded on the Flop
Seat 6: weiner99 (small blind) folded before Flop
Seat 7: legster (big blind) folded on the Flop

CoinPoker Hand #291146090: Tournament #1364647, ₮1 Mini Dojo PKO Hold'em No Limit (70/140 ante 21 play) 2025/09/02 17:52:24 GMT
Table '3' 7-max Seat #6 is the button
Seat 1: kanococo (14522 in chips, 50 bounty)
Seat 2: niks2011 (10170 in chips, 50 bounty)
Seat 3: StairRoyalFlush (7880 in chips, 50 bounty)
Seat 4: Scorpio2283 (9979 in chips, 50 bounty)
Seat 5: jannpannn (29129 in chips, 100 bounty)
Seat 6: weiner99 (11686 in chips, 50 bounty)
Seat 7: legster (7250 in chips, 50 bounty)
kanococo: posts the ante 21
niks2011: posts the ante 21
StairRoyalFlush: posts the ante 21
Scorpio2283: posts the ante 21
jannpannn: posts the ante 21
weiner99: posts the ante 21
legster: posts the ante 21
legster: posts small blind 70
kanococo: posts big blind 140
*** HOLE CARDS ***
Dealt to kanococo [9s 7d]
niks2011: raises 497 to 637
StairRoyalFlush: folds
Scorpio2283: raises 1274 to 1911
jannpannn: folds
weiner99: folds
legster: folds
kanococo: folds
niks2011: calls 1274
*** FLOP *** [9h As Ks]
niks2011: bets 5529
Scorpio2283: folds
Uncalled bet (5529) returned to niks2011
niks2011 collected 4179 from pot
niks2011: doesn't show hand
*** SUMMARY ***
Total pot 4179 | Rake 0
Board [ 9h As Ks ]
Game ended: 2025/09/02 17:53:02 GMT
Seat 1: kanococo (big blind) folded before Flop
Seat 2: niks2011 collected (4179)
Seat 3: StairRoyalFlush folded before Flop
Seat 4: Scorpio2283 folded on the Flop
Seat 5: jannpannn folded before Flop
Seat 6: weiner99 (button) folded before Flop
Seat 7: legster (small blind) folded before Flop

CoinPoker Hand #291146416: Tournament #1364647, ₮1 Mini Dojo PKO Hold'em No Limit (70/140 ante 21 play) 2025/09/02 17:53:03 GMT
Table '3' 7-max Seat #7 is the button
Seat 1: kanococo (14361 in chips, 50 bounty)
Seat 2: niks2011 (12417 in chips, 50 bounty)
Seat 3: StairRoyalFlush (7859 in chips, 50 bounty)
Seat 4: Scorpio2283 (8047 in chips, 50 bounty)
Seat 5: jannpannn (29108 in chips, 100 bounty)
Seat 6: weiner99 (11665 in chips, 50 bounty)
Seat 7: legster (7159 in chips, 50 bounty)
kanococo: posts the ante 21
niks2011: posts the ante 21
StairRoyalFlush: posts the ante 21
Scorpio2283: posts the ante 21
jannpannn: posts the ante 21
weiner99: posts the ante 21
legster: posts the ante 21
kanococo: posts small blind 70
niks2011: posts big blind 140
*** HOLE CARDS ***
Dealt to kanococo [5c 3h]
StairRoyalFlush: folds
Scorpio2283: raises 140 to 280
jannpannn: folds
weiner99: folds
legster: folds
kanococo: folds
niks2011: folds
Scorpio2283 collected 637 from pot
Scorpio2283: doesn't show hand
*** SUMMARY ***
Total pot 637 | Rake 0
Board [ ]
Game ended: 2025/09/02 17:53:40 GMT
Seat 1: kanococo (small blind) folded before Flop
Seat 2: niks2011 (big blind) folded before Flop
Seat 3: StairRoyalFlush folded before Flop
Seat 4: Scorpio2283 collected (637)
Seat 5: jannpannn folded before Flop
Seat 6: weiner99 folded before Flop
Seat 7: legster (button) folded before Flop

CoinPoker Hand #291146733: Tournament #1364647, ₮1 Mini Dojo PKO Hold'em No Limit (70/140 ante 21 play) 2025/09/02 17:53:41 GMT
Table '3' 7-max Seat #1 is the button
Seat 1: kanococo (14270 in chips, 50 bounty)
Seat 2: niks2011 (12256 in chips, 50 bounty)
Seat 3: StairRoyalFlush (7838 in chips, 50 bounty)
Seat 4: Scorpio2283 (8383 in chips, 50 bounty)
Seat 5: jannpannn (29087 in chips, 100 bounty)
Seat 6: weiner99 (11644 in chips, 50 bounty)
Seat 7: legster (7138 in chips, 50 bounty)
kanococo: posts the ante 21
niks2011: posts the ante 21
StairRoyalFlush: posts the ante 21
Scorpio2283: posts the ante 21
jannpannn: posts the ante 21
weiner99: posts the ante 21
legster: posts the ante 21
niks2011: posts small blind 70
StairRoyalFlush: posts big blind 140
*** HOLE CARDS ***
Dealt to kanococo [Th 8s]
Scorpio2283: folds
jannpannn: folds
weiner99: calls 140
legster: folds
kanococo: raises 140 to 280
niks2011: folds
StairRoyalFlush: folds
weiner99: calls 140
*** FLOP *** [6c 4c 3h]
weiner99: checks
kanococo: checks
*** TURN *** [6c 4c 3h] [Qs]
weiner99: bets 140
kanococo: calls 140
*** RIVER *** [6c 4c 3h Qs] [6h]
weiner99: bets 1197
kanococo: folds
Uncalled bet (1197) returned to weiner99
weiner99 collected 1197 from pot
weiner99 has timed out
weiner99: doesn't show hand
*** SUMMARY ***
Total pot 1197 | Rake 0
Board [ 6c 4c 3h Qs 6h ]
Game ended: 2025/09/02 17:55:09 GMT
Seat 1: kanococo (button) folded on the River
Seat 2: niks2011 (small blind) folded before Flop
Seat 3: StairRoyalFlush (big blind) folded before Flop
Seat 4: Scorpio2283 folded before Flop
Seat 5: jannpannn folded before Flop
Seat 6: weiner99 collected (1197)
Seat 7: legster folded before Flop

CoinPoker Hand #291147967: Hold'em No Limit (0.01/0.02 ) 2025/09/02 17:56:08 GMT
Table 'NL ₮2 VI' 7-max Seat #4 is the button
Seat 1: AbsoluteuNIT (2.03 in chips)
Seat 2: mishanskii (2.00 in chips) out of hand
Seat 3: DragonPok3r (2.00 in chips) out of hand
Seat 5: Shamil05 (0.78 in chips)
Seat 6: kanococo (2.00 in chips)
Seat 7: Lorens95 (2.00 in chips) out of hand
Shamil05: posts small blind 0.01
kanococo: posts big blind 0.02
*** HOLE CARDS ***
Dealt to kanococo [Td 7s]
AbsoluteuNIT: folds
Shamil05: raises 0.04 to 0.06
kanococo: calls 0.04
*** FLOP *** [Jd 6d 2h]
Shamil05: bets 0.08
kanococo: folds
Uncalled bet (0.08) returned to Shamil05
Shamil05 collected 0.11 from pot
Shamil05: doesn't show hand
*** SUMMARY ***
Total pot 0.12 | Rake 0.01
Board [ Jd 6d 2h ]
Game ended: 2025/09/02 17:56:37 GMT
Seat 1: AbsoluteuNIT folded before Flop (didn't bet)
Seat 2: mishanskii folded before Flop (didn't bet)
Seat 3: DragonPok3r folded before Flop (didn't bet)
Seat 5: Shamil05 (small blind) collected (0.11)
Seat 6: kanococo (big blind) folded on the Flop
Seat 7: Lorens95 folded before Flop (didn't bet)

CoinPoker Hand #291148238: Hold'em No Limit (0.01/0.02 ) 2025/09/02 17:56:39 GMT
Table 'NL ₮2 VI' 7-max Seat #5 is the button
Seat 1: AbsoluteuNIT (2.03 in chips)
Seat 2: mishanskii (2.00 in chips) out of hand
Seat 3: DragonPok3r (2.00 in chips) out of hand
Seat 4: Holy1 (0.80 in chips) out of hand
Seat 5: Shamil05 (0.83 in chips)
Seat 6: kanococo (1.94 in chips)
Seat 7: Lorens95 (2.00 in chips)
kanococo: posts small blind 0.01
Lorens95: posts big blind 0.02
*** HOLE CARDS ***
Dealt to kanococo [3s As]
AbsoluteuNIT: folds
Shamil05: folds
kanococo: raises 0.02 to 0.04
Lorens95: folds
kanococo collected 0.06 from pot
kanococo: doesn't show hand
*** SUMMARY ***
Total pot 0.06 | Rake 0.00
Board [ ]
Game ended: 2025/09/02 17:56:50 GMT
Seat 1: AbsoluteuNIT folded before Flop (didn't bet)
Seat 2: mishanskii folded before Flop (didn't bet)
Seat 3: DragonPok3r folded before Flop (didn't bet)
Seat 4: Holy1 folded before Flop (didn't bet)
Seat 5: Shamil05 (button) folded before Flop (didn't bet)
Seat 6: kanococo (small blind) collected (0.06)
Seat 7: Lorens95 (big blind) folded before Flop

CoinPoker Hand #291148357: Hold'em No Limit (0.01/0.02 ) 2025/09/02 17:56:52 GMT
Table 'NL ₮2 VI' 7-max Seat #6 is the button
Seat 1: AbsoluteuNIT (2.03 in chips)
Seat 2: mishanskii (2.00 in chips) out of hand
Seat 3: DragonPok3r (2.00 in chips) out of hand
Seat 4: Holy1 (0.80 in chips) out of hand
Seat 5: Shamil05 (0.83 in chips)
Seat 6: kanococo (1.96 in chips)
Seat 7: Lorens95 (2.00 in chips)
Lorens95: posts small blind 0.01
AbsoluteuNIT: posts big blind 0.02
*** HOLE CARDS ***
Dealt to kanococo [7s 3h]
Shamil05: raises 0.03 to 0.05
kanococo: folds
Lorens95: folds
AbsoluteuNIT: folds
Shamil05 collected 0.08 from pot
Shamil05: doesn't show hand
*** SUMMARY ***
Total pot 0.08 | Rake 0.00
Board [ ]
Game ended: 2025/09/02 17:57:12 GMT
Seat 1: AbsoluteuNIT (big blind) folded before Flop
Seat 2: mishanskii folded before Flop (didn't bet)
Seat 3: DragonPok3r folded before Flop (didn't bet)
Seat 4: Holy1 folded before Flop (didn't bet)
Seat 5: Shamil05 collected (0.08)
Seat 6: kanococo (button) folded before Flop (didn't bet)
Seat 7: Lorens95 (small blind) folded before Flop

CoinPoker Hand #291148428: Hold'em No Limit (0.01/0.02 ) 2025/09/02 17:57:14 GMT
Table 'NL ₮2 VI' 7-max Seat #7 is the button
Seat 1: AbsoluteuNIT (2.01 in chips)
Seat 2: mishanskii (2.00 in chips)
Seat 3: DragonPok3r (2.00 in chips) out of hand
Seat 4: Holy1 (0.80 in chips) out of hand
Seat 5: Shamil05 (0.86 in chips)
Seat 6: kanococo (1.96 in chips)
Seat 7: Lorens95 (1.99 in chips)
AbsoluteuNIT: posts small blind 0.01
mishanskii: posts big blind 0.02
*** HOLE CARDS ***
Dealt to kanococo [2h 6c]
Shamil05: raises 0.02 to 0.04
kanococo: folds
Lorens95: folds
AbsoluteuNIT: folds
mishanskii: raises 0.09 to 0.13
Shamil05: calls 0.09
*** FLOP *** [Th 3s Jd]
mishanskii: bets 0.18
Shamil05: calls 0.18
*** TURN *** [Th 3s Jd] [Js]
mishanskii: bets 0.30
Shamil05: folds
Uncalled bet (0.30) returned to mishanskii
mishanskii collected 0.60 from pot
mishanskii: doesn't show hand
*** SUMMARY ***
Total pot 0.63 | Rake 0.03
Board [ Th 3s Jd Js ]
Game ended: 2025/09/02 17:58:09 GMT
Seat 1: AbsoluteuNIT (small blind) folded before Flop
Seat 2: mishanskii (big blind) collected (0.60)
Seat 3: DragonPok3r folded before Flop (didn't bet)
Seat 4: Holy1 folded before Flop (didn't bet)
Seat 5: Shamil05 folded on the Turn
Seat 6: kanococo folded before Flop (didn't bet)
Seat 7: Lorens95 (button) folded before Flop (didn't bet)

CoinPoker Hand #291148620: Hold'em No Limit (0.01/0.02 ) 2025/09/02 17:58:11 GMT
Table 'NL ₮2 VI' 7-max Seat #1 is the button
Seat 1: AbsoluteuNIT (2.00 in chips)
Seat 2: mishanskii (2.29 in chips)
Seat 3: DragonPok3r (2.00 in chips)
Seat 4: Holy1 (0.80 in chips) out of hand
Seat 5: Shamil05 (0.55 in chips)
Seat 6: kanococo (1.96 in chips)
Seat 7: Lorens95 (2.00 in chips)
mishanskii: posts small blind 0.01
DragonPok3r: posts big blind 0.02
*** HOLE CARDS ***
Dealt to kanococo [4s Ah]
Shamil05: folds
kanococo: folds
Lorens95: folds
AbsoluteuNIT: folds
mishanskii: folds
DragonPok3r collected 0.03 from pot
DragonPok3r: doesn't show hand
*** SUMMARY ***
Total pot 0.03 | Rake 0.00
Board [ ]
Game ended: 2025/09/02 17:58:23 GMT
Seat 1: AbsoluteuNIT (button) folded before Flop (didn't bet)
Seat 2: mishanskii (small blind) folded before Flop
Seat 3: DragonPok3r (big blind) collected (0.03)
Seat 4: Holy1 folded before Flop (didn't bet)
Seat 5: Shamil05 folded before Flop (didn't bet)
Seat 6: kanococo folded before Flop (didn't bet)
Seat 7: Lorens95 folded before Flop (didn't bet)

CoinPoker Hand #291148695: Hold'em No Limit (0.01/0.02 ) 2025/09/02 17:58:25 GMT
Table 'NL ₮2 VI' 7-max Seat #2 is the button
Seat 1: AbsoluteuNIT (2.00 in chips)
Seat 2: mishanskii (2.28 in chips)
Seat 3: DragonPok3r (2.01 in chips)
Seat 4: Holy1 (0.80 in chips)
Seat 5: Shamil05 (0.80 in chips)
Seat 6: kanococo (1.96 in chips)
Seat 7: Lorens95 (2.00 in chips)
DragonPok3r: posts small blind 0.01
Holy1: posts big blind 0.02
*** HOLE CARDS ***
Dealt to kanococo [6s 6d]
Shamil05: folds
kanococo: raises 0.02 to 0.04
Lorens95: folds
AbsoluteuNIT: folds
mishanskii: calls 0.04
DragonPok3r: calls 0.03
Holy1: folds
*** FLOP *** [8s Qs 2d]
DragonPok3r: checks
kanococo: bets 0.04
mishanskii: folds
DragonPok3r: calls 0.04
*** TURN *** [8s Qs 2d] [Jh]
DragonPok3r: checks
kanococo: bets 0.10
DragonPok3r: folds
Uncalled bet (0.10) returned to kanococo
kanococo collected 0.21 from pot
kanococo: doesn't show hand
*** SUMMARY ***
Total pot 0.22 | Rake 0.01
Board [ 8s Qs 2d Jh ]
Game ended: 2025/09/02 17:59:29 GMT
Seat 1: AbsoluteuNIT folded before Flop (didn't bet)
Seat 2: mishanskii (button) folded on the Flop
Seat 3: DragonPok3r (small blind) folded on the Turn
Seat 4: Holy1 (big blind) folded before Flop
Seat 5: Shamil05 folded before Flop (didn't bet)
Seat 6: kanococo collected (0.21)
Seat 7: Lorens95 folded before Flop (didn't bet)

CoinPoker Hand #291148890: Hold'em No Limit (0.01/0.02 ) 2025/09/02 17:59:31 GMT
Table 'NL ₮2 VI' 7-max Seat #3 is the button
Seat 1: AbsoluteuNIT (2.00 in chips)
Seat 2: mishanskii (2.24 in chips)
Seat 3: DragonPok3r (1.93 in chips)
Seat 4: Holy1 (0.78 in chips)
Seat 5: Shamil05 (0.80 in chips)
Seat 6: kanococo (2.09 in chips)
Seat 7: Lorens95 (2.00 in chips)
Holy1: posts small blind 0.01
Shamil05: posts big blind 0.02
*** HOLE CARDS ***
Dealt to kanococo [4d Ks]
kanococo: folds
Lorens95: folds
AbsoluteuNIT: folds
mishanskii: folds
DragonPok3r: folds
Holy1: raises 0.03 to 0.05
Shamil05: folds
Holy1 collected 0.07 from pot
Holy1: doesn't show hand
*** SUMMARY ***
Total pot 0.07 | Rake 0.00
Board [ ]
Game ended: 2025/09/02 17:59:57 GMT
Seat 1: AbsoluteuNIT folded before Flop (didn't bet)
Seat 2: mishanskii folded before Flop (didn't bet)
Seat 3: DragonPok3r (button) folded before Flop (didn't bet)
Seat 4: Holy1 (small blind) collected (0.07)
Seat 5: Shamil05 (big blind) folded before Flop
Seat 6: kanococo folded before Flop (didn't bet)
Seat 7: Lorens95 folded before Flop (didn't bet)

CoinPoker Hand #291148961: Hold'em No Limit (0.01/0.02 ) 2025/09/02 17:59:58 GMT
Table 'NL ₮2 VI' 7-max Seat #4 is the button
Seat 1: AbsoluteuNIT (2.00 in chips)
Seat 2: mishanskii (2.24 in chips)
Seat 3: DragonPok3r (1.93 in chips)
Seat 4: Holy1 (0.80 in chips)
Seat 5: Shamil05 (0.78 in chips)
Seat 6: kanococo (2.09 in chips)
Seat 7: Lorens95 (2.00 in chips)
Shamil05: posts small blind 0.01
kanococo: posts big blind 0.02
*** HOLE CARDS ***
Dealt to kanococo [Td 5c]
Lorens95: folds
AbsoluteuNIT: folds
mishanskii: raises 0.05 to 0.07
DragonPok3r: folds
Holy1: folds
Shamil05: folds
kanococo: folds
mishanskii collected 0.10 from pot
mishanskii: doesn't show hand
*** SUMMARY ***
Total pot 0.10 | Rake 0.00
Board [ ]
Game ended: 2025/09/02 18:00:28 GMT
Seat 1: AbsoluteuNIT folded before Flop (didn't bet)
Seat 2: mishanskii collected (0.10)
Seat 3: DragonPok3r folded before Flop (didn't bet)
Seat 4: Holy1 (button) folded before Flop (didn't bet)
Seat 5: Shamil05 (small blind) folded before Flop
Seat 6: kanococo (big blind) folded before Flop
Seat 7: Lorens95 folded before Flop (didn't bet)

CoinPoker Hand #291149065: Hold'em No Limit (0.01/0.02 ) 2025/09/02 18:00:30 GMT
Table 'NL ₮2 VI' 7-max Seat #5 is the button
Seat 1: AbsoluteuNIT (2.00 in chips)
Seat 2: mishanskii (2.27 in chips)
Seat 3: DragonPok3r (1.93 in chips)
Seat 4: Holy1 (0.80 in chips)
Seat 5: Shamil05 (0.77 in chips)
Seat 6: kanococo (2.07 in chips)
Seat 7: Lorens95 (2.00 in chips)
kanococo: posts small blind 0.01
Lorens95: posts big blind 0.02
*** HOLE CARDS ***
Dealt to kanococo [9c Js]
AbsoluteuNIT: folds
mishanskii: folds
DragonPok3r: folds
Holy1: folds
Shamil05: raises 0.03 to 0.05
kanococo: folds
Lorens95: folds
Shamil05 collected 0.08 from pot
Shamil05: doesn't show hand
*** SUMMARY ***
Total pot 0.08 | Rake 0.00
Board [ ]
Game ended: 2025/09/02 18:00:51 GMT
Seat 1: AbsoluteuNIT folded before Flop (didn't bet)
Seat 2: mishanskii folded before Flop (didn't bet)
Seat 3: DragonPok3r folded before Flop (didn't bet)
Seat 4: Holy1 folded before Flop (didn't bet)
Seat 5: Shamil05 (button) collected (0.08)
Seat 6: kanococo (small blind) folded before Flop
Seat 7: Lorens95 (big blind) folded before Flop

CoinPoker Hand #291149148: Hold'em No Limit (0.01/0.02 ) 2025/09/02 18:00:53 GMT
Table 'NL ₮2 VI' 7-max Seat #6 is the button
Seat 1: AbsoluteuNIT (2.00 in chips)
Seat 2: mishanskii (2.27 in chips)
Seat 3: DragonPok3r (1.93 in chips)
Seat 4: Holy1 (0.80 in chips)
Seat 5: Shamil05 (0.80 in chips)
Seat 6: kanococo (2.06 in chips)
Seat 7: Lorens95 (2.00 in chips)
Lorens95: posts small blind 0.01
AbsoluteuNIT: posts big blind 0.02
*** HOLE CARDS ***
Dealt to kanococo [Ac 5c]
mishanskii: folds
DragonPok3r: raises 0.02 to 0.04
Holy1: folds
Shamil05: folds
kanococo: calls 0.04
Lorens95: folds
AbsoluteuNIT: calls 0.02
*** FLOP *** [8h Jc Ts]
AbsoluteuNIT: checks
DragonPok3r: checks
kanococo: checks
*** TURN *** [8h Jc Ts] [Th]
AbsoluteuNIT: checks
DragonPok3r: checks
kanococo: bets 0.02
AbsoluteuNIT: folds
DragonPok3r: calls 0.02
*** RIVER *** [8h Jc Ts Th] [2d]
DragonPok3r: checks
kanococo: checks
*** SHOW DOWN ***
DragonPok3r: shows [2s 3s] (two pairs, Tens and Twos)
kanococo: mucks hand
DragonPok3r collected 0.16 from pot
*** SUMMARY ***
Total pot 0.17 | Rake 0.01
Board [ 8h Jc Ts Th 2d ]
Game ended: 2025/09/02 18:02:01 GMT
Seat 1: AbsoluteuNIT (big blind) folded on the Turn
Seat 2: mishanskii folded before Flop (didn't bet)
Seat 3: DragonPok3r showed [2s 3s] and won (0.16) with two pairs, Tens and Twos
Seat 4: Holy1 folded before Flop (didn't bet)
Seat 5: Shamil05 folded before Flop (didn't bet)
Seat 6: kanococo (button) mucked
Seat 7: Lorens95 (small blind) folded before Flop

CoinPoker Hand #291147823: Tournament #1364647, ₮1 Mini Dojo PKO Hold'em No Limit (70/140 ante 21 play) 2025/09/02 18:01:36 GMT
Table '3' 7-max Seat #2 is the button
Seat 1: kanococo (13829 in chips, 50 bounty)
Seat 2: niks2011 (12165 in chips, 50 bounty)
Seat 3: StairRoyalFlush (7677 in chips, 50 bounty)
Seat 4: Scorpio2283 (8362 in chips, 50 bounty)
Seat 5: jannpannn (29066 in chips, 100 bounty)
Seat 6: weiner99 (12400 in chips, 50 bounty)
Seat 7: legster (7117 in chips, 50 bounty)
kanococo: posts the ante 21
niks2011: posts the ante 21
StairRoyalFlush: posts the ante 21
Scorpio2283: posts the ante 21
jannpannn: posts the ante 21
weiner99: posts the ante 21
legster: posts the ante 21
StairRoyalFlush: posts small blind 70
Scorpio2283: posts big blind 140
*** HOLE CARDS ***
Dealt to kanococo [Ad 7s]
jannpannn: folds
weiner99 has timed out
weiner99 activated time-bank (58 seconds)
niks2011 has reconnected
weiner99: folds
legster: folds
kanococo: raises 140 to 280
niks2011: folds
StairRoyalFlush: folds
Scorpio2283: folds
kanococo collected 637 from pot
kanococo: doesn't show hand
*** SUMMARY ***
Total pot 637 | Rake 0
Board [ ]
Game ended: 2025/09/02 18:02:44 GMT
Seat 1: kanococo collected (637)
Seat 2: niks2011 (button) folded before Flop
Seat 3: StairRoyalFlush (small blind) folded before Flop
Seat 4: Scorpio2283 (big blind) folded before Flop
Seat 5: jannpannn folded before Flop
Seat 6: weiner99 folded before Flop
Seat 7: legster folded before Flop

CoinPoker Hand #291149468: Hold'em No Limit (0.01/0.02 ) 2025/09/02 18:02:02 GMT
Table 'NL ₮2 VI' 7-max Seat #7 is the button
Seat 1: AbsoluteuNIT (1.96 in chips)
Seat 2: mishanskii (2.27 in chips)
Seat 3: DragonPok3r (2.03 in chips)
Seat 4: Holy1 (0.80 in chips)
Seat 5: Shamil05 (0.80 in chips)
Seat 6: kanococo (2.00 in chips)
Seat 7: Lorens95 (1.99 in chips)
AbsoluteuNIT: posts small blind 0.01
mishanskii: posts big blind 0.02
*** HOLE CARDS ***
Dealt to kanococo [Qs 6h]
DragonPok3r: folds
Holy1: folds
Shamil05: raises 0.02 to 0.04
kanococo: folds
Lorens95: folds
AbsoluteuNIT: folds
mishanskii: raises 0.09 to 0.13
Shamil05: calls 0.09
*** FLOP *** [8s Jc Kc]
mishanskii: bets 0.18
Shamil05: calls 0.18
*** TURN *** [8s Jc Kc] [7c]
mishanskii: bets 0.30
Shamil05: folds
Uncalled bet (0.30) returned to mishanskii
mishanskii collected 0.60 from pot
mishanskii: doesn't show hand
*** SUMMARY ***
Total pot 0.63 | Rake 0.03
Board [ 8s Jc Kc 7c ]
Game ended: 2025/09/02 18:02:56 GMT
Seat 1: AbsoluteuNIT (small blind) folded before Flop
Seat 2: mishanskii (big blind) collected (0.60)
Seat 3: DragonPok3r folded before Flop (didn't bet)
Seat 4: Holy1 folded before Flop (didn't bet)
Seat 5: Shamil05 folded on the Turn
Seat 6: kanococo folded before Flop (didn't bet)
Seat 7: Lorens95 (button) folded before Flop (didn't bet)

CoinPoker Hand #291148326: Tournament #1364647, ₮1 Mini Dojo PKO Hold'em No Limit (80/160 ante 24 play) 2025/09/02 18:02:50 GMT
Table '3' 7-max Seat #3 is the button
Seat 1: kanococo (14165 in chips, 50 bounty)
Seat 2: niks2011 (12144 in chips, 50 bounty)
Seat 3: StairRoyalFlush (7586 in chips, 50 bounty)
Seat 4: Scorpio2283 (8201 in chips, 50 bounty)
Seat 5: jannpannn (29045 in chips, 100 bounty)
Seat 6: weiner99 (12379 in chips, 50 bounty)
Seat 7: legster (7096 in chips, 50 bounty)
kanococo: posts the ante 24
niks2011: posts the ante 24
StairRoyalFlush: posts the ante 24
Scorpio2283: posts the ante 24
jannpannn: posts the ante 24
weiner99: posts the ante 24
legster: posts the ante 24
Scorpio2283: posts small blind 80
jannpannn: posts big blind 160
*** HOLE CARDS ***
Dealt to kanococo [2s 5h]
weiner99 has timed out
weiner99 activated time-bank (32 seconds)
weiner99: calls 160
legster: folds
kanococo: folds
niks2011: folds
StairRoyalFlush: folds
Scorpio2283: folds
jannpannn: checks
*** FLOP *** [Js Td Kh]
jannpannn: checks
weiner99: checks
*** TURN *** [Js Td Kh] [8c]
jannpannn: checks
weiner99: bets 568
jannpannn: folds
Uncalled bet (568) returned to weiner99
weiner99 collected 568 from pot
weiner99: shows [7s 9s]
*** SUMMARY ***
Total pot 568 | Rake 0
Board [ Js Td Kh 8c ]
Game ended: 2025/09/02 18:03:57 GMT
Seat 1: kanococo folded before Flop
Seat 2: niks2011 folded before Flop
Seat 3: StairRoyalFlush (button) folded before Flop
Seat 4: Scorpio2283 (small blind) folded before Flop
Seat 5: jannpannn (big blind) folded on the Turn
Seat 6: weiner99 showed [7s 9s] and won (568) with 
Seat 7: legster folded before Flop

CoinPoker Hand #291150265: Tournament #1364647, ₮1 Mini Dojo PKO Hold'em No Limit (80/160 ante 24 play) 2025/09/02 18:03:58 GMT
Table '3' 7-max Seat #4 is the button
Seat 1: kanococo (14141 in chips, 50 bounty)
Seat 2: niks2011 (12120 in chips, 50 bounty)
Seat 3: StairRoyalFlush (7562 in chips, 50 bounty)
Seat 4: Scorpio2283 (8097 in chips, 50 bounty)
Seat 5: jannpannn (28861 in chips, 100 bounty)
Seat 6: weiner99 (12763 in chips, 50 bounty)
Seat 7: legster (7072 in chips, 50 bounty)
kanococo: posts the ante 24
niks2011: posts the ante 24
StairRoyalFlush: posts the ante 24
Scorpio2283: posts the ante 24
jannpannn: posts the ante 24
weiner99: posts the ante 24
legster: posts the ante 24
jannpannn: posts small blind 80
weiner99: posts big blind 160
*** HOLE CARDS ***
Dealt to kanococo [8d 9d]
legster: folds
kanococo: raises 160 to 320
niks2011: folds
StairRoyalFlush: folds
Scorpio2283: folds
jannpannn: folds
weiner99: calls 160
*** FLOP *** [4d Js Th]
weiner99: checks
kanococo: bets 320
weiner99: calls 320
*** TURN *** [4d Js Th] [Ad]
weiner99: checks
kanococo: bets 764
weiner99: calls 764
*** RIVER *** [4d Js Th Ad] [Kd]
weiner99: checks
kanococo: bets 12713 and is all-in
weiner99: folds
Uncalled bet (12713) returned to kanococo
kanococo collected 3056 from pot
kanococo: doesn't show hand
*** SUMMARY ***
Total pot 3056 | Rake 0
Board [ 4d Js Th Ad Kd ]
Game ended: 2025/09/02 18:05:01 GMT
Seat 1: kanococo collected (3056)
Seat 2: niks2011 folded before Flop
Seat 3: StairRoyalFlush folded before Flop
Seat 4: Scorpio2283 (button) folded before Flop
Seat 5: jannpannn (small blind) folded before Flop
Seat 6: weiner99 (big blind) folded on the River
Seat 7: legster folded before Flop

CoinPoker Hand #291150747: Tournament #1364647, ₮1 Mini Dojo PKO Hold'em No Limit (80/160 ante 24 play) 2025/09/02 18:05:02 GMT
Table '3' 7-max Seat #5 is the button
Seat 1: kanococo (15769 in chips, 50 bounty)
Seat 2: niks2011 (12096 in chips, 50 bounty)
Seat 3: StairRoyalFlush (7538 in chips, 50 bounty)
Seat 4: Scorpio2283 (8073 in chips, 50 bounty)
Seat 5: jannpannn (28757 in chips, 100 bounty)
Seat 6: weiner99 (11335 in chips, 50 bounty)
Seat 7: legster (7048 in chips, 50 bounty)
kanococo: posts the ante 24
niks2011: posts the ante 24
StairRoyalFlush: posts the ante 24
Scorpio2283: posts the ante 24
jannpannn: posts the ante 24
weiner99: posts the ante 24
legster: posts the ante 24
weiner99: posts small blind 80
legster: posts big blind 160
*** HOLE CARDS ***
Dealt to kanococo [Jh Qs]
kanococo: calls 160
niks2011: folds
StairRoyalFlush: folds
Scorpio2283: folds
jannpannn: folds
weiner99: folds
legster: checks
*** FLOP *** [4c 7c 5s]
legster: checks
kanococo: checks
*** TURN *** [4c 7c 5s] [9s]
legster: bets 480
kanococo: calls 480
*** RIVER *** [4c 7c 5s 9s] [3d]
legster: bets 480
kanococo: calls 480
*** SHOW DOWN ***
legster: shows [Ac As] (a pair of Aces)
kanococo: mucks hand
legster collected 2488 from pot
*** SUMMARY ***
Total pot 2488 | Rake 0
Board [ 4c 7c 5s 9s 3d ]
Game ended: 2025/09/02 18:05:59 GMT
Seat 1: kanococo mucked
Seat 2: niks2011 folded before Flop
Seat 3: StairRoyalFlush folded before Flop
Seat 4: Scorpio2283 folded before Flop
Seat 5: jannpannn (button) folded before Flop
Seat 6: weiner99 (small blind) folded before Flop
Seat 7: legster (big blind) showed [Ac As] and won (2488) with a pair of Aces

CoinPoker Hand #291151267: Tournament #1364647, ₮1 Mini Dojo PKO Hold'em No Limit (80/160 ante 24 play) 2025/09/02 18:06:00 GMT
Table '3' 7-max Seat #6 is the button
Seat 1: kanococo (14625 in chips, 50 bounty)
Seat 2: niks2011 (12072 in chips, 50 bounty)
Seat 3: StairRoyalFlush (7514 in chips, 50 bounty)
Seat 4: Scorpio2283 (8049 in chips, 50 bounty)
Seat 5: jannpannn (28733 in chips, 100 bounty)
Seat 6: weiner99 (11231 in chips, 50 bounty)
Seat 7: legster (8392 in chips, 50 bounty)
kanococo: posts the ante 24
niks2011: posts the ante 24
StairRoyalFlush: posts the ante 24
Scorpio2283: posts the ante 24
jannpannn: posts the ante 24
weiner99: posts the ante 24
legster: posts the ante 24
legster: posts small blind 80
kanococo: posts big blind 160
*** HOLE CARDS ***
Dealt to kanococo [3h Qc]
niks2011: folds
StairRoyalFlush: folds
Scorpio2283: folds
jannpannn: folds
weiner99: folds
legster: calls 80
kanococo: checks
*** FLOP *** [7d 2c Jc]
legster: bets 160
kanococo: folds
Uncalled bet (160) returned to legster
legster collected 488 from pot
legster: doesn't show hand
*** SUMMARY ***
Total pot 488 | Rake 0
Board [ 7d 2c Jc ]
Game ended: 2025/09/02 18:06:43 GMT
Seat 1: kanococo (big blind) folded on the Flop
Seat 2: niks2011 folded before Flop
Seat 3: StairRoyalFlush folded before Flop
Seat 4: Scorpio2283 folded before Flop
Seat 5: jannpannn folded before Flop
Seat 6: weiner99 (button) folded before Flop
Seat 7: legster (small blind) collected (488)

CoinPoker Hand #291151745: Tournament #1364647, ₮1 Mini Dojo PKO Hold'em No Limit (80/160 ante 24 play) 2025/09/02 18:06:43 GMT
Table '3' 7-max Seat #7 is the button
Seat 1: kanococo (14441 in chips, 50 bounty)
Seat 2: niks2011 (12048 in chips, 50 bounty)
Seat 3: StairRoyalFlush (7490 in chips, 50 bounty)
Seat 4: Scorpio2283 (8025 in chips, 50 bounty)
Seat 5: jannpannn (28709 in chips, 100 bounty)
Seat 6: weiner99 (11207 in chips, 50 bounty)
Seat 7: legster (8696 in chips, 50 bounty)
kanococo: posts the ante 24
niks2011: posts the ante 24
StairRoyalFlush: posts the ante 24
Scorpio2283: posts the ante 24
jannpannn: posts the ante 24
weiner99: posts the ante 24
legster: posts the ante 24
kanococo: posts small blind 80
niks2011: posts big blind 160
*** HOLE CARDS ***
Dealt to kanococo [2d 9d]
StairRoyalFlush: folds
Scorpio2283: folds
jannpannn: folds
weiner99: folds
legster: folds
kanococo: raises 160 to 320
niks2011: calls 160
*** FLOP *** [5d 4s 5s]
kanococo: checks
niks2011: bets 7178
kanococo: folds
Uncalled bet (7178) returned to niks2011
niks2011 collected 808 from pot
niks2011: doesn't show hand
*** SUMMARY ***
Total pot 808 | Rake 0
Board [ 5d 4s 5s ]
Game ended: 2025/09/02 18:07:18 GMT
Seat 1: kanococo (small blind) folded on the Flop
Seat 2: niks2011 (big blind) collected (808)
Seat 3: StairRoyalFlush folded before Flop
Seat 4: Scorpio2283 folded before Flop
Seat 5: jannpannn folded before Flop
Seat 6: weiner99 folded before Flop
Seat 7: legster (button) folded before Flop

CoinPoker Hand #291152065: Tournament #1364647, ₮1 Mini Dojo PKO Hold'em No Limit (80/160 ante 24 play) 2025/09/02 18:07:19 GMT
Table '3' 7-max Seat #1 is the button
Seat 1: kanococo (14097 in chips, 50 bounty)
Seat 2: niks2011 (12512 in chips, 50 bounty)
Seat 3: StairRoyalFlush (7466 in chips, 50 bounty)
Seat 4: Scorpio2283 (8001 in chips, 50 bounty)
Seat 5: jannpannn (28685 in chips, 100 bounty)
Seat 6: weiner99 (11183 in chips, 50 bounty)
Seat 7: legster (8672 in chips, 50 bounty)
kanococo: posts the ante 24
niks2011: posts the ante 24
StairRoyalFlush: posts the ante 24
Scorpio2283: posts the ante 24
jannpannn: posts the ante 24
weiner99: posts the ante 24
legster: posts the ante 24
niks2011: posts small blind 80
StairRoyalFlush: posts big blind 160
*** HOLE CARDS ***
Dealt to kanococo [Jc 2d]
Scorpio2283: folds
jannpannn: raises 160 to 320
weiner99: folds
legster: folds
kanococo: folds
niks2011: folds
StairRoyalFlush: folds
jannpannn collected 728 from pot
jannpannn: doesn't show hand
*** SUMMARY ***
Total pot 728 | Rake 0
Board [ ]
Game ended: 2025/09/02 18:07:57 GMT
Seat 1: kanococo (button) folded before Flop
Seat 2: niks2011 (small blind) folded before Flop
Seat 3: StairRoyalFlush (big blind) folded before Flop
Seat 4: Scorpio2283 folded before Flop
Seat 5: jannpannn collected (728)
Seat 6: weiner99 folded before Flop
Seat 7: legster folded before Flop

CoinPoker Hand #291152455: Tournament #1364647, ₮1 Mini Dojo PKO Hold'em No Limit (80/160 ante 24 play) 2025/09/02 18:07:57 GMT
Table '3' 7-max Seat #2 is the button
Seat 1: kanococo (14073 in chips, 50 bounty)
Seat 2: niks2011 (12408 in chips, 50 bounty)
Seat 3: StairRoyalFlush (7282 in chips, 50 bounty)
Seat 4: Scorpio2283 (7977 in chips, 50 bounty)
Seat 5: jannpannn (29069 in chips, 100 bounty)
Seat 6: weiner99 (11159 in chips, 50 bounty)
Seat 7: legster (8648 in chips, 50 bounty)
kanococo: posts the ante 24
niks2011: posts the ante 24
StairRoyalFlush: posts the ante 24
Scorpio2283: posts the ante 24
jannpannn: posts the ante 24
weiner99: posts the ante 24
legster: posts the ante 24
StairRoyalFlush: posts small blind 80
Scorpio2283: posts big blind 160
*** HOLE CARDS ***
Dealt to kanococo [7c Th]
jannpannn: folds
weiner99 has timed out
weiner99 activated time-bank (25 seconds)
weiner99: calls 160
legster: folds
kanococo: folds
niks2011: folds
StairRoyalFlush: folds
Scorpio2283: checks
*** FLOP *** [Tc 8h 4s]
Scorpio2283: checks
weiner99: bets 160
Scorpio2283: folds
Uncalled bet (160) returned to weiner99
weiner99 collected 568 from pot
weiner99: doesn't show hand
*** SUMMARY ***
Total pot 568 | Rake 0
Board [ Tc 8h 4s ]
Game ended: 2025/09/02 18:09:04 GMT
Seat 1: kanococo folded before Flop
Seat 2: niks2011 (button) folded before Flop
Seat 3: StairRoyalFlush (small blind) folded before Flop
Seat 4: Scorpio2283 (big blind) folded on the Flop
Seat 5: jannpannn folded before Flop
Seat 6: weiner99 collected (568)
Seat 7: legster folded before Flop

CoinPoker Hand #291153138: Tournament #1364647, ₮1 Mini Dojo PKO Hold'em No Limit (80/160 ante 24 play) 2025/09/02 18:09:05 GMT
Table '3' 7-max Seat #3 is the button
Seat 1: kanococo (14049 in chips, 50 bounty)
Seat 2: niks2011 (12384 in chips, 50 bounty)
Seat 3: StairRoyalFlush (7178 in chips, 50 bounty)
Seat 4: Scorpio2283 (7793 in chips, 50 bounty)
Seat 5: jannpannn (29045 in chips, 100 bounty)
Seat 6: weiner99 (11543 in chips, 50 bounty)
Seat 7: legster (8624 in chips, 50 bounty)
kanococo: posts the ante 24
niks2011: posts the ante 24
StairRoyalFlush: posts the ante 24
Scorpio2283: posts the ante 24
jannpannn: posts the ante 24
weiner99: posts the ante 24
legster: posts the ante 24
Scorpio2283: posts small blind 80
jannpannn: posts big blind 160
*** HOLE CARDS ***
Dealt to kanococo [5s 2h]
weiner99: folds
legster: folds
kanococo: folds
niks2011: folds
StairRoyalFlush: raises 320 to 480
Scorpio2283 has timed out
Scorpio2283 activated time-bank (60 seconds)
Scorpio2283: raises 960 to 1440
jannpannn: folds
StairRoyalFlush has timed out
StairRoyalFlush activated time-bank (60 seconds)
StairRoyalFlush: raises 6674 and is all-in
Scorpio2283: folds
StairRoyalFlush collected 8922 from pot
StairRoyalFlush: doesn't show hand
*** SUMMARY ***
Total pot 8922 | Rake 0
Board [ ]
Game ended: 2025/09/02 18:10:03 GMT
Seat 1: kanococo folded before Flop
Seat 2: niks2011 folded before Flop
Seat 3: StairRoyalFlush (button) collected (8922)
Seat 4: Scorpio2283 (small blind) folded before Flop
Seat 5: jannpannn (big blind) folded before Flop
Seat 6: weiner99 folded before Flop
Seat 7: legster folded before Flop

CoinPoker Hand #291153659: Tournament #1364647, ₮1 Mini Dojo PKO Hold'em No Limit (80/160 ante 24 play) 2025/09/02 18:10:04 GMT
Table '3' 7-max Seat #4 is the button
Seat 1: kanococo (14025 in chips, 50 bounty)
Seat 2: niks2011 (12360 in chips, 50 bounty)
Seat 3: StairRoyalFlush (8922 in chips, 50 bounty)
Seat 4: Scorpio2283 (6329 in chips, 50 bounty)
Seat 5: jannpannn (28861 in chips, 100 bounty)
Seat 6: weiner99 (11519 in chips, 50 bounty)
Seat 7: legster (8600 in chips, 50 bounty)
kanococo: posts the ante 24
niks2011: posts the ante 24
StairRoyalFlush: posts the ante 24
Scorpio2283: posts the ante 24
jannpannn: posts the ante 24
weiner99: posts the ante 24
legster: posts the ante 24
jannpannn: posts small blind 80
weiner99: posts big blind 160
*** HOLE CARDS ***
Dealt to kanococo [Kd 9s]
legster: folds
kanococo: raises 160 to 320
niks2011: folds
StairRoyalFlush: folds
Scorpio2283: folds
jannpannn: folds
weiner99: calls 160
*** FLOP *** [Ah Qh Td]
weiner99: checks
kanococo: checks
*** TURN *** [Ah Qh Td] [5h]
weiner99: bets 888
kanococo: raises 888 to 1776
weiner99: raises 1776 to 3552
kanococo: calls 1776
*** RIVER *** [Ah Qh Td 5h] [Ks]
weiner99: bets 7623 and is all-in
kanococo: calls 7623
*** SHOW DOWN ***
weiner99: shows [5c 5d] (three of kind, Fives)
kanococo: shows [Kd 9s] (a pair of Kings)
weiner99 collected 23238 from pot
*** SUMMARY ***
Total pot 23238 | Rake 0
Board [ Ah Qh Td 5h Ks ]
Game ended: 2025/09/02 18:11:17 GMT
Seat 1: kanococo showed [Kd 9s]
Seat 2: niks2011 folded before Flop
Seat 3: StairRoyalFlush folded before Flop
Seat 4: Scorpio2283 (button) folded before Flop
Seat 5: jannpannn (small blind) folded before Flop
Seat 6: weiner99 (big blind) showed [5c 5d] and won (23238) with three of kind, Fives
Seat 7: legster folded before Flop

CoinPoker Hand #291154262: Tournament #1364647, ₮1 Mini Dojo PKO Hold'em No Limit (100/200 ante 30 play) 2025/09/02 18:11:22 GMT
Table '3' 7-max Seat #5 is the button
Seat 1: kanococo (2506 in chips, 50 bounty)
Seat 2: niks2011 (12336 in chips, 50 bounty)
Seat 3: StairRoyalFlush (8898 in chips, 50 bounty)
Seat 4: Scorpio2283 (6305 in chips, 50 bounty)
Seat 5: jannpannn (28757 in chips, 100 bounty)
Seat 6: weiner99 (23238 in chips, 50 bounty)
Seat 7: legster (8576 in chips, 50 bounty)
kanococo: posts the ante 30
niks2011: posts the ante 30
StairRoyalFlush: posts the ante 30
Scorpio2283: posts the ante 30
jannpannn: posts the ante 30
weiner99: posts the ante 30
legster: posts the ante 30
weiner99: posts small blind 100
legster: posts big blind 200
*** HOLE CARDS ***
Dealt to kanococo [Qs Js]
kanococo: raises 2476 and is all-in
niks2011: folds
StairRoyalFlush: folds
Scorpio2283: folds
jannpannn: folds
weiner99 said, "lol"
weiner99: folds
legster: folds
kanococo collected 2986 from pot
kanococo: doesn't show hand
*** SUMMARY ***
Total pot 2986 | Rake 0
Board [ ]
Game ended: 2025/09/02 18:12:01 GMT
Seat 1: kanococo collected (2986)
Seat 2: niks2011 folded before Flop
Seat 3: StairRoyalFlush folded before Flop
Seat 4: Scorpio2283 folded before Flop
Seat 5: jannpannn (button) folded before Flop
Seat 6: weiner99 (small blind) folded before Flop
Seat 7: legster (big blind) folded before Flop

CoinPoker Hand #291154685: Tournament #1364647, ₮1 Mini Dojo PKO Hold'em No Limit (100/200 ante 30 play) 2025/09/02 18:12:01 GMT
Table '3' 7-max Seat #6 is the button
Seat 1: kanococo (2986 in chips, 50 bounty)
Seat 2: niks2011 (12306 in chips, 50 bounty)
Seat 3: StairRoyalFlush (8868 in chips, 50 bounty)
Seat 4: Scorpio2283 (6275 in chips, 50 bounty)
Seat 5: jannpannn (28727 in chips, 100 bounty)
Seat 6: weiner99 (23108 in chips, 50 bounty)
Seat 7: legster (8346 in chips, 50 bounty)
kanococo: posts the ante 30
niks2011: posts the ante 30
StairRoyalFlush: posts the ante 30
Scorpio2283: posts the ante 30
jannpannn: posts the ante 30
weiner99: posts the ante 30
legster: posts the ante 30
legster: posts small blind 100
kanococo: posts big blind 200
*** HOLE CARDS ***
Dealt to kanococo [4c 3c]
niks2011 has timed out
niks2011 activated time-bank (33 seconds)
niks2011: folds
StairRoyalFlush: folds
Scorpio2283: folds
jannpannn: raises 200 to 400
weiner99: folds
legster: folds
kanococo: calls 200
*** FLOP *** [Jh 2c 7h]
kanococo: bets 400
jannpannn: folds
Uncalled bet (400) returned to kanococo
kanococo collected 1110 from pot
kanococo: doesn't show hand
*** SUMMARY ***
Total pot 1110 | Rake 0
Board [ Jh 2c 7h ]
Game ended: 2025/09/02 18:13:18 GMT
Seat 1: kanococo (big blind) collected (1110)
Seat 2: niks2011 folded before Flop
Seat 3: StairRoyalFlush folded before Flop
Seat 4: Scorpio2283 folded before Flop
Seat 5: jannpannn folded on the Flop
Seat 6: weiner99 (button) folded before Flop
Seat 7: legster (small blind) folded before Flop

CoinPoker Hand #291155429: Tournament #1364647, ₮1 Mini Dojo PKO Hold'em No Limit (100/200 ante 30 play) 2025/09/02 18:13:19 GMT
Table '3' 7-max Seat #7 is the button
Seat 1: kanococo (3666 in chips, 50 bounty)
Seat 2: niks2011 (12276 in chips, 50 bounty)
Seat 3: StairRoyalFlush (8838 in chips, 50 bounty)
Seat 4: Scorpio2283 (6245 in chips, 50 bounty)
Seat 5: jannpannn (28297 in chips, 100 bounty)
Seat 7: legster (8216 in chips, 50 bounty)
kanococo: posts the ante 30
niks2011: posts the ante 30
StairRoyalFlush: posts the ante 30
Scorpio2283: posts the ante 30
jannpannn: posts the ante 30
legster: posts the ante 30
kanococo: posts small blind 100
niks2011: posts big blind 200
*** HOLE CARDS ***
Dealt to kanococo [7h As]
StairRoyalFlush: folds
Scorpio2283: folds
jannpannn: folds
legster: folds
kanococo: raises 200 to 400
niks2011: folds
kanococo collected 780 from pot
kanococo: doesn't show hand
*** SUMMARY ***
Total pot 780 | Rake 0
Board [ ]
Game ended: 2025/09/02 18:13:40 GMT
Seat 1: kanococo (small blind) collected (780)
Seat 2: niks2011 (big blind) folded before Flop
Seat 3: StairRoyalFlush folded before Flop
Seat 4: Scorpio2283 folded before Flop
Seat 5: jannpannn folded before Flop
Seat 7: legster (button) folded before Flop

CoinPoker Hand #291155643: Tournament #1364647, ₮1 Mini Dojo PKO Hold'em No Limit (100/200 ante 30 play) 2025/09/02 18:13:41 GMT
Table '3' 7-max Seat #1 is the button
Seat 1: kanococo (4016 in chips, 50 bounty)
Seat 2: niks2011 (12046 in chips, 50 bounty)
Seat 3: StairRoyalFlush (8808 in chips, 50 bounty)
Seat 4: Scorpio2283 (6215 in chips, 50 bounty)
Seat 5: jannpannn (28267 in chips, 100 bounty)
Seat 7: legster (8186 in chips, 50 bounty)
kanococo: posts the ante 30
niks2011: posts the ante 30
StairRoyalFlush: posts the ante 30
Scorpio2283: posts the ante 30
jannpannn: posts the ante 30
legster: posts the ante 30
niks2011: posts small blind 100
StairRoyalFlush: posts big blind 200
*** HOLE CARDS ***
Dealt to kanococo [7s Js]
Scorpio2283: folds
jannpannn: raises 200 to 400
legster: folds
kanococo: folds
niks2011: folds
StairRoyalFlush: folds
jannpannn collected 880 from pot
jannpannn: doesn't show hand
*** SUMMARY ***
Total pot 880 | Rake 0
Board [ ]
Game ended: 2025/09/02 18:14:24 GMT
Seat 1: kanococo (button) folded before Flop
Seat 2: niks2011 (small blind) folded before Flop
Seat 3: StairRoyalFlush (big blind) folded before Flop
Seat 4: Scorpio2283 folded before Flop
Seat 5: jannpannn collected (880)
Seat 7: legster folded before Flop

CoinPoker Hand #291156043: Tournament #1364647, ₮1 Mini Dojo PKO Hold'em No Limit (100/200 ante 30 play) 2025/09/02 18:14:26 GMT
Table '3' 7-max Seat #2 is the button
Seat 1: kanococo (3986 in chips, 50 bounty)
Seat 2: niks2011 (11916 in chips, 50 bounty)
Seat 3: StairRoyalFlush (8578 in chips, 50 bounty)
Seat 4: Scorpio2283 (6185 in chips, 50 bounty)
Seat 5: jannpannn (28717 in chips, 100 bounty)
Seat 6: PrincessLeia (7777 in chips, 50 bounty)
Seat 7: legster (8156 in chips, 50 bounty)
kanococo: posts the ante 30
niks2011: posts the ante 30
StairRoyalFlush: posts the ante 30
Scorpio2283: posts the ante 30
jannpannn: posts the ante 30
PrincessLeia: posts the ante 30
legster: posts the ante 30
StairRoyalFlush: posts small blind 100
Scorpio2283: posts big blind 200
*** HOLE CARDS ***
Dealt to kanococo [Ac Kh]
jannpannn: folds
PrincessLeia: folds
legster: folds
kanococo: raises 200 to 400
niks2011: raises 11886 and is all-in
StairRoyalFlush: folds
Scorpio2283: calls 5955 and is all-in
kanococo: calls 3556 and is all-in
Uncalled bet (5731) returned to niks2011
*** FLOP *** [7c 4h Jh]
*** TURN *** [7c 4h Jh] [Qd]
*** RIVER *** [7c 4h Jh Qd] [2h]
*** SHOW DOWN ***
niks2011: shows [8h Tc] (Queen high)
Scorpio2283: shows [9c 9s] (a pair of Nines)
Scorpio2283 collected 4398 from side-pot 1
kanococo: shows [Ac Kh] (Ace high)
Scorpio2283 collected 12178 from pot
*** SUMMARY ***
Total pot 16576 | Rake 0
Board [ 7c 4h Jh Qd 2h ]
Game ended: 2025/09/02 18:15:08 GMT
Seat 1: kanococo showed [Ac Kh]
Seat 2: niks2011 (button) showed [8h Tc]
Seat 3: StairRoyalFlush (small blind) folded before Flop
Seat 4: Scorpio2283 (big blind) showed [9c 9s] and won (16576) with a pair of Nines
Seat 5: jannpannn folded before Flop
Seat 6: PrincessLeia folded before Flop
Seat 7: legster folded before Flop

CoinPoker Hand #291157807: Hold'em No Limit (0.01/0.02 ) 2025/09/02 18:16:45 GMT
Table 'NL ₮2 V' 7-max Seat #4 is the button
Seat 1: AbsoluteuNIT (1.81 in chips)
Seat 2: Pinzer94 (2.27 in chips)
Seat 3: betformony (2.46 in chips)
Seat 4: Lorens95 (2.03 in chips)
Seat 5: kleepeh (2.15 in chips)
Seat 6: kanococo (2.00 in chips)
Seat 7: HoldBabyHold (2.06 in chips)
kleepeh: posts small blind 0.01
kanococo: posts big blind 0.02
*** HOLE CARDS ***
Dealt to kanococo [Ah 5h]
HoldBabyHold: folds
AbsoluteuNIT: folds
Pinzer94: folds
betformony: folds
Lorens95: raises 0.03 to 0.05
kleepeh: folds
kanococo: calls 0.03
*** FLOP *** [6d 2d Qs]
kanococo: checks
Lorens95: bets 0.04
kanococo: folds
Uncalled bet (0.04) returned to Lorens95
Lorens95 collected 0.10 from pot
Lorens95: doesn't show hand
*** SUMMARY ***
Total pot 0.11 | Rake 0.01
Board [ 6d 2d Qs ]
Game ended: 2025/09/02 18:17:34 GMT
Seat 1: AbsoluteuNIT folded before Flop (didn't bet)
Seat 2: Pinzer94 folded before Flop (didn't bet)
Seat 3: betformony folded before Flop (didn't bet)
Seat 4: Lorens95 (button) collected (0.10)
Seat 5: kleepeh (small blind) folded before Flop
Seat 6: kanococo (big blind) folded on the Flop
Seat 7: HoldBabyHold folded before Flop (didn't bet)

CoinPoker Hand #291158117: Hold'em No Limit (0.01/0.02 ) 2025/09/02 18:17:38 GMT
Table 'NL ₮2 V' 7-max Seat #5 is the button
Seat 2: Pinzer94 (2.27 in chips)
Seat 3: betformony (2.46 in chips)
Seat 4: Lorens95 (2.08 in chips)
Seat 5: kleepeh (2.14 in chips)
Seat 6: kanococo (1.95 in chips)
Seat 7: HoldBabyHold (2.06 in chips)
kanococo: posts small blind 0.01
HoldBabyHold: posts big blind 0.02
*** HOLE CARDS ***
Dealt to kanococo [Qc 6d]
Pinzer94: folds
betformony: folds
Lorens95: folds
kleepeh: raises 0.04 to 0.06
kanococo: calls 0.05
HoldBabyHold: calls 0.04
*** FLOP *** [3h 6s 8d]
kanococo: checks
HoldBabyHold: checks
kleepeh: checks
*** TURN *** [3h 6s 8d] [9h]
kanococo: bets 0.08
HoldBabyHold: folds
kleepeh: calls 0.08
*** RIVER *** [3h 6s 8d 9h] [9s]
kanococo: bets 0.16
kleepeh: folds
Uncalled bet (0.16) returned to kanococo
kanococo collected 0.32 from pot
kanococo: doesn't show hand
*** SUMMARY ***
Total pot 0.34 | Rake 0.02
Board [ 3h 6s 8d 9h 9s ]
Game ended: 2025/09/02 18:18:51 GMT
Seat 2: Pinzer94 folded before Flop (didn't bet)
Seat 3: betformony folded before Flop (didn't bet)
Seat 4: Lorens95 folded before Flop (didn't bet)
Seat 5: kleepeh (button) folded on the River
Seat 6: kanococo (small blind) collected (0.32)
Seat 7: HoldBabyHold (big blind) folded on the Turn

CoinPoker Hand #291158934: Hold'em No Limit (0.01/0.02 ) 2025/09/02 18:18:54 GMT
Table 'NL ₮2 V' 7-max Seat #6 is the button
Seat 1: Joshaf (2.00 in chips)
Seat 2: Pinzer94 (2.27 in chips)
Seat 3: betformony (2.46 in chips)
Seat 4: Lorens95 (2.08 in chips)
Seat 5: kleepeh (2.00 in chips)
Seat 6: kanococo (2.13 in chips)
Seat 7: HoldBabyHold (2.00 in chips)
HoldBabyHold: posts small blind 0.01
Joshaf: posts big blind 0.02
*** HOLE CARDS ***
Dealt to kanococo [Qc 2c]
Pinzer94: folds
betformony: folds
Lorens95: folds
kleepeh: folds
kanococo: folds
HoldBabyHold: raises 0.06 to 0.08
Joshaf: calls 0.06
*** FLOP *** [Kd Tc 5s]
HoldBabyHold: checks
Joshaf: bets 0.07
HoldBabyHold: folds
Uncalled bet (0.07) returned to Joshaf
Joshaf collected 0.15 from pot
Joshaf: doesn't show hand
*** SUMMARY ***
Total pot 0.16 | Rake 0.01
Board [ Kd Tc 5s ]
Game ended: 2025/09/02 18:19:59 GMT
Seat 1: Joshaf (big blind) collected (0.15)
Seat 2: Pinzer94 folded before Flop (didn't bet)
Seat 3: betformony folded before Flop (didn't bet)
Seat 4: Lorens95 folded before Flop (didn't bet)
Seat 5: kleepeh folded before Flop (didn't bet)
Seat 6: kanococo (button) folded before Flop (didn't bet)
Seat 7: HoldBabyHold (small blind) folded on the Flop

CoinPoker Hand #291159491: Hold'em No Limit (0.01/0.02 ) 2025/09/02 18:20:02 GMT
Table 'NL ₮2 V' 7-max Seat #7 is the button
Seat 1: Joshaf (2.07 in chips)
Seat 2: Pinzer94 (2.27 in chips)
Seat 3: betformony (2.46 in chips)
Seat 4: Lorens95 (2.08 in chips)
Seat 5: kleepeh (2.00 in chips)
Seat 6: kanococo (2.13 in chips)
Seat 7: HoldBabyHold (2.00 in chips)
Joshaf: posts small blind 0.01
Pinzer94: posts big blind 0.02
*** HOLE CARDS ***
Dealt to kanococo [8s 5h]
betformony: raises 0.03 to 0.05
Lorens95: folds
kleepeh has timed out
kleepeh activated time-bank (60 seconds)
kleepeh: folds
kanococo: folds
HoldBabyHold: folds
Joshaf: calls 0.04
Pinzer94: calls 0.03
*** FLOP *** [Qh Qs Th]
Joshaf: checks
Pinzer94: checks
betformony: bets 0.07
Joshaf: calls 0.07
Pinzer94: folds
*** TURN *** [Qh Qs Th] [5d]
Joshaf: checks
betformony: bets 0.18
Joshaf: folds
Uncalled bet (0.18) returned to betformony
betformony collected 0.28 from pot
betformony: doesn't show hand
*** SUMMARY ***
Total pot 0.29 | Rake 0.01
Board [ Qh Qs Th 5d ]
Game ended: 2025/09/02 18:21:42 GMT
Seat 1: Joshaf (small blind) folded on the Turn
Seat 2: Pinzer94 (big blind) folded on the Flop
Seat 3: betformony collected (0.28)
Seat 4: Lorens95 folded before Flop (didn't bet)
Seat 5: kleepeh folded before Flop (didn't bet)
Seat 6: kanococo folded before Flop (didn't bet)
Seat 7: HoldBabyHold (button) folded before Flop (didn't bet)

CoinPoker Hand #291160234: Hold'em No Limit (0.01/0.02 ) 2025/09/02 18:21:45 GMT
Table 'NL ₮2 V' 7-max Seat #1 is the button
Seat 1: Joshaf (1.95 in chips)
Seat 2: Pinzer94 (2.22 in chips)
Seat 3: betformony (2.62 in chips)
Seat 4: Lorens95 (2.08 in chips)
Seat 5: kleepeh (2.00 in chips)
Seat 6: kanococo (2.13 in chips)
Seat 7: HoldBabyHold (2.00 in chips)
Pinzer94: posts small blind 0.01
betformony: posts big blind 0.02
*** HOLE CARDS ***
Dealt to kanococo [Qs 7d]
Lorens95: folds
kleepeh: raises 0.02 to 0.04
kanococo: folds
HoldBabyHold: folds
Joshaf: folds
Pinzer94: folds
betformony: folds
kleepeh collected 0.07 from pot
kleepeh: doesn't show hand
*** SUMMARY ***
Total pot 0.07 | Rake 0.00
Board [ ]
Game ended: 2025/09/02 18:22:20 GMT
Seat 1: Joshaf (button) folded before Flop (didn't bet)
Seat 2: Pinzer94 (small blind) folded before Flop
Seat 3: betformony (big blind) folded before Flop
Seat 4: Lorens95 folded before Flop (didn't bet)
Seat 5: kleepeh collected (0.07)
Seat 6: kanococo folded before Flop (didn't bet)
Seat 7: HoldBabyHold folded before Flop (didn't bet)

CoinPoker Hand #291160611: Hold'em No Limit (0.01/0.02 ) 2025/09/02 18:22:23 GMT
Table 'NL ₮2 V' 7-max Seat #2 is the button
Seat 1: Joshaf (1.95 in chips)
Seat 2: Pinzer94 (2.21 in chips)
Seat 3: betformony (2.60 in chips)
Seat 4: Lorens95 (2.08 in chips)
Seat 5: kleepeh (2.03 in chips)
Seat 6: kanococo (2.13 in chips)
Seat 7: HoldBabyHold (2.00 in chips)
betformony: posts small blind 0.01
Lorens95: posts big blind 0.02
*** HOLE CARDS ***
Dealt to kanococo [6h As]
kleepeh: folds
kanococo: raises 0.02 to 0.04
HoldBabyHold: folds
Joshaf: folds
Pinzer94: folds
betformony: folds
Lorens95: folds
kanococo collected 0.07 from pot
kanococo: doesn't show hand
*** SUMMARY ***
Total pot 0.07 | Rake 0.00
Board [ ]
Game ended: 2025/09/02 18:22:54 GMT
Seat 1: Joshaf folded before Flop (didn't bet)
Seat 2: Pinzer94 (button) folded before Flop (didn't bet)
Seat 3: betformony (small blind) folded before Flop
Seat 4: Lorens95 (big blind) folded before Flop
Seat 5: kleepeh folded before Flop (didn't bet)
Seat 6: kanococo collected (0.07)
Seat 7: HoldBabyHold folded before Flop (didn't bet)

CoinPoker Hand #291161013: Hold'em No Limit (0.01/0.02 ) 2025/09/02 18:22:59 GMT
Table 'NL ₮2 V' 7-max Seat #3 is the button
Seat 1: Joshaf (1.95 in chips)
Seat 2: Pinzer94 (2.21 in chips)
Seat 3: betformony (2.59 in chips)
Seat 4: Lorens95 (2.06 in chips)
Seat 5: kleepeh (2.03 in chips)
Seat 6: kanococo (2.16 in chips)
Seat 7: HoldBabyHold (2.00 in chips)
Lorens95: posts small blind 0.01
kleepeh: posts big blind 0.02
*** HOLE CARDS ***
Dealt to kanococo [Jc 7h]
kanococo: raises 0.02 to 0.04
HoldBabyHold: folds
Joshaf: calls 0.04
Pinzer94: folds
betformony: raises 0.15 to 0.19
Lorens95: calls 0.18
kleepeh: folds
kanococo: folds
Joshaf: calls 0.15
*** FLOP *** [Td 5s Jd]
Lorens95: checks
Joshaf: bets 0.30
betformony: calls 0.30
Lorens95: calls 0.30
*** TURN *** [Td 5s Jd] [2s]
Lorens95: checks
Joshaf has timed out
Joshaf activated time-bank (60 seconds)
Joshaf: bets 0.12
betformony: raises 0.84 to 0.96
Lorens95: folds
Joshaf: raises 1.34 and is all-in
betformony: calls 0.50
*** RIVER *** [Td 5s Jd 2s] [Tc]
*** SHOW DOWN ***
Joshaf: shows [Js Ad] (two pairs, Jacks and Tens)
betformony: shows [Qs Qd] (two pairs, Queens and Tens)
betformony collected 4.25 from pot
*** SUMMARY ***
Total pot 4.45 | Rake 0.20
Board [ Td 5s Jd 2s Tc ]
Game ended: 2025/09/02 18:24:48 GMT
Seat 1: Joshaf showed [Js Ad]
Seat 2: Pinzer94 folded before Flop (didn't bet)
Seat 3: betformony (button) showed [Qs Qd] and won (4.25) with two pairs, Queens and Tens
Seat 4: Lorens95 (small blind) folded on the Turn
Seat 5: kleepeh (big blind) folded before Flop
Seat 6: kanococo folded before Flop
Seat 7: HoldBabyHold folded before Flop (didn't bet)

CoinPoker Hand #291161956: Hold'em No Limit (0.01/0.02 ) 2025/09/02 18:24:52 GMT
Table 'NL ₮2 V' 7-max Seat #4 is the button
Seat 2: Pinzer94 (2.21 in chips)
Seat 3: betformony (4.89 in chips)
Seat 4: Lorens95 (2.00 in chips)
Seat 5: kleepeh (2.01 in chips)
Seat 6: kanococo (2.12 in chips)
Seat 7: HoldBabyHold (2.00 in chips)
kleepeh: posts small blind 0.01
kanococo: posts big blind 0.02
*** HOLE CARDS ***
Dealt to kanococo [As Kh]
HoldBabyHold: folds
Pinzer94: folds
betformony: folds
Lorens95: folds
kleepeh: raises 0.04 to 0.06
kanococo: raises 0.06 to 0.12
kleepeh: calls 0.06
*** FLOP *** [6d Qd 9h]
kleepeh: checks
kanococo: checks
*** TURN *** [6d Qd 9h] [Qc]
kleepeh: bets 0.11
kanococo: calls 0.11
*** RIVER *** [6d Qd 9h Qc] [5d]
kleepeh: bets 0.60
kanococo: folds
Uncalled bet (0.60) returned to kleepeh
kleepeh collected 0.44 from pot
kleepeh: doesn't show hand
*** SUMMARY ***
Total pot 0.46 | Rake 0.02
Board [ 6d Qd 9h Qc 5d ]
Game ended: 2025/09/02 18:25:56 GMT
Seat 2: Pinzer94 folded before Flop (didn't bet)
Seat 3: betformony folded before Flop (didn't bet)
Seat 4: Lorens95 (button) folded before Flop (didn't bet)
Seat 5: kleepeh (small blind) collected (0.44)
Seat 6: kanococo (big blind) folded on the River
Seat 7: HoldBabyHold folded before Flop (didn't bet)

CoinPoker Hand #291162543: Hold'em No Limit (0.01/0.02 ) 2025/09/02 18:26:00 GMT
Table 'NL ₮2 V' 7-max Seat #5 is the button
Seat 2: Pinzer94 (2.21 in chips)
Seat 3: betformony (4.89 in chips)
Seat 4: Lorens95 (2.00 in chips)
Seat 5: kleepeh (2.22 in chips)
Seat 6: kanococo (1.89 in chips)
Seat 7: HoldBabyHold (2.00 in chips)
kanococo: posts small blind 0.01
HoldBabyHold: posts big blind 0.02
*** HOLE CARDS ***
Dealt to kanococo [8s 5c]
Pinzer94: folds
betformony: folds
Lorens95: folds
kleepeh: folds
kanococo: raises 0.02 to 0.04
HoldBabyHold: raises 0.10 to 0.14
kanococo: folds
HoldBabyHold collected 0.18 from pot
HoldBabyHold: doesn't show hand
*** SUMMARY ***
Total pot 0.18 | Rake 0.00
Board [ ]
Game ended: 2025/09/02 18:26:32 GMT
Seat 2: Pinzer94 folded before Flop (didn't bet)
Seat 3: betformony folded before Flop (didn't bet)
Seat 4: Lorens95 folded before Flop (didn't bet)
Seat 5: kleepeh (button) folded before Flop (didn't bet)
Seat 6: kanococo (small blind) folded before Flop
Seat 7: HoldBabyHold (big blind) collected (0.18)

CoinPoker Hand #291162801: Hold'em No Limit (0.01/0.02 ) 2025/09/02 18:26:35 GMT
Table 'NL ₮2 V' 7-max Seat #6 is the button
Seat 2: Pinzer94 (2.21 in chips)
Seat 3: betformony (4.89 in chips)
Seat 4: Lorens95 (2.00 in chips)
Seat 5: kleepeh (2.22 in chips)
Seat 6: kanococo (1.85 in chips)
Seat 7: HoldBabyHold (2.04 in chips)
HoldBabyHold: posts small blind 0.01
Pinzer94: posts big blind 0.02
*** HOLE CARDS ***
Dealt to kanococo [Qc 6h]
betformony: folds
Lorens95: folds
kleepeh: folds
kanococo: raises 0.04 to 0.06
HoldBabyHold: raises 0.16 to 0.22
Pinzer94: folds
kanococo: calls 0.16
*** FLOP *** [Ah Jd Qh]
HoldBabyHold: bets 0.14
kanococo: raises 1.63 and is all-in
HoldBabyHold: calls 1.49
*** TURN *** [Ah Jd Qh] [Jc]
*** RIVER *** [Ah Jd Qh Jc] [Tc]
*** SHOW DOWN ***
kanococo: shows [Qc 6h] (two pairs, Queens and Jacks)
HoldBabyHold: shows [As 5s] (two pairs, Aces and Jacks)
HoldBabyHold collected 3.53 from pot
*** SUMMARY ***
Total pot 3.72 | Rake 0.19
Board [ Ah Jd Qh Jc Tc ]
Game ended: 2025/09/02 18:27:41 GMT
Seat 2: Pinzer94 (big blind) folded before Flop
Seat 3: betformony folded before Flop (didn't bet)
Seat 4: Lorens95 folded before Flop (didn't bet)
Seat 5: kleepeh folded before Flop (didn't bet)
Seat 6: kanococo (button) showed [Qc 6h]
Seat 7: HoldBabyHold (small blind) showed [As 5s] and won (3.53) with two pairs, Aces and Jacks

CoinPoker Hand #291164346: Hold'em No Limit (0.01/0.02 ) 2025/09/02 18:29:28 GMT
Table 'NL ₮2 VI' 7-max Seat #4 is the button
Seat 1: SQuest (3.51 in chips)
Seat 2: naifa (7.32 in chips)
Seat 3: MokiMoki (0.72 in chips)
Seat 4: crispzilla (2.00 in chips)
Seat 5: kanococo (2.00 in chips)
Seat 6: LuckyDragon (3.08 in chips)
Seat 7: GrendelGreat (2.00 in chips)
LuckyDragon: posts small blind 0.01
GrendelGreat: posts big blind 0.02
kanococo: posts big blind 0.02
*** HOLE CARDS ***
Dealt to kanococo [5s Jh]
SQuest: raises 0.04 to 0.06
naifa: folds
MokiMoki: folds
crispzilla: folds
kanococo: folds
LuckyDragon: folds
GrendelGreat: folds
SQuest collected 0.11 from pot
SQuest: doesn't show hand
*** SUMMARY ***
Total pot 0.11 | Rake 0.00
Board [ ]
Game ended: 2025/09/02 18:30:03 GMT
Seat 1: SQuest collected (0.11)
Seat 2: naifa folded before Flop (didn't bet)
Seat 3: MokiMoki folded before Flop (didn't bet)
Seat 4: crispzilla (button) folded before Flop (didn't bet)
Seat 5: kanococo folded before Flop
Seat 6: LuckyDragon (small blind) folded before Flop
Seat 7: GrendelGreat (big blind) folded before Flop

CoinPoker Hand #291164681: Hold'em No Limit (0.01/0.02 ) 2025/09/02 18:30:05 GMT
Table 'NL ₮2 VI' 7-max Seat #6 is the button
Seat 1: SQuest (3.56 in chips)
Seat 2: naifa (7.32 in chips)
Seat 3: MokiMoki (0.72 in chips)
Seat 4: crispzilla (2.00 in chips)
Seat 5: kanococo (1.98 in chips)
Seat 6: LuckyDragon (3.07 in chips)
Seat 7: GrendelGreat (2.00 in chips)
GrendelGreat: posts small blind 0.01
SQuest: posts big blind 0.02
*** HOLE CARDS ***
Dealt to kanococo [4h 9d]
naifa: folds
MokiMoki: raises 0.03 to 0.05
crispzilla: folds
kanococo: folds
LuckyDragon: folds
GrendelGreat: calls 0.04
SQuest: folds
*** FLOP *** [6h 7h Ah]
GrendelGreat: bets 0.11
MokiMoki: folds
Uncalled bet (0.11) returned to GrendelGreat
GrendelGreat collected 0.11 from pot
GrendelGreat: doesn't show hand
*** SUMMARY ***
Total pot 0.12 | Rake 0.01
Board [ 6h 7h Ah ]
Game ended: 2025/09/02 18:31:01 GMT
Seat 1: SQuest (big blind) folded before Flop
Seat 2: naifa folded before Flop (didn't bet)
Seat 3: MokiMoki folded on the Flop
Seat 4: crispzilla folded before Flop (didn't bet)
Seat 5: kanococo folded before Flop (didn't bet)
Seat 6: LuckyDragon (button) folded before Flop (didn't bet)
Seat 7: GrendelGreat (small blind) collected (0.11)

CoinPoker Hand #291165169: Hold'em No Limit (0.01/0.02 ) 2025/09/02 18:31:04 GMT
Table 'NL ₮2 VI' 7-max Seat #7 is the button
Seat 1: SQuest (3.54 in chips)
Seat 2: naifa (7.32 in chips)
Seat 3: MokiMoki (0.67 in chips)
Seat 4: crispzilla (2.00 in chips)
Seat 5: kanococo (1.98 in chips)
Seat 6: LuckyDragon (3.07 in chips)
Seat 7: GrendelGreat (2.06 in chips)
SQuest: posts small blind 0.01
naifa: posts big blind 0.02
*** HOLE CARDS ***
Dealt to kanococo [As Qc]
MokiMoki: folds
crispzilla: folds
kanococo: raises 0.02 to 0.04
LuckyDragon: folds
GrendelGreat: folds
SQuest: calls 0.03
naifa: folds
*** FLOP *** [Jh Kh 7h]
SQuest: checks
kanococo: checks
*** TURN *** [Jh Kh 7h] [9h]
SQuest: checks
kanococo: bets 0.04
SQuest has timed out
SQuest activated time-bank (59 seconds)
SQuest: folds
Uncalled bet (0.04) returned to kanococo
kanococo collected 0.09 from pot
kanococo: doesn't show hand
*** SUMMARY ***
Total pot 0.10 | Rake 0.01
Board [ Jh Kh 7h 9h ]
Game ended: 2025/09/02 18:32:05 GMT
Seat 1: SQuest (small blind) folded on the Turn
Seat 2: naifa (big blind) folded before Flop
Seat 3: MokiMoki folded before Flop (didn't bet)
Seat 4: crispzilla folded before Flop (didn't bet)
Seat 5: kanococo collected (0.09)
Seat 6: LuckyDragon folded before Flop (didn't bet)
Seat 7: GrendelGreat (button) folded before Flop (didn't bet)

CoinPoker Hand #291165861: Hold'em No Limit (0.01/0.02 ) 2025/09/02 18:32:07 GMT
Table 'NL ₮2 VI' 7-max Seat #1 is the button
Seat 1: SQuest (3.50 in chips)
Seat 2: naifa (7.30 in chips)
Seat 3: MokiMoki (0.80 in chips)
Seat 4: crispzilla (2.00 in chips)
Seat 5: kanococo (2.03 in chips)
Seat 6: LuckyDragon (3.07 in chips)
Seat 7: GrendelGreat (2.06 in chips)
naifa: posts small blind 0.01
MokiMoki: posts big blind 0.02
*** HOLE CARDS ***
Dealt to kanococo [8c 2d]
crispzilla: folds
kanococo: folds
LuckyDragon: calls 0.02
GrendelGreat: raises 0.04 to 0.06
SQuest: folds
naifa: folds
MokiMoki: folds
LuckyDragon: folds
GrendelGreat collected 0.11 from pot
GrendelGreat: doesn't show hand
*** SUMMARY ***
Total pot 0.11 | Rake 0.00
Board [ ]
Game ended: 2025/09/02 18:32:39 GMT
Seat 1: SQuest (button) folded before Flop (didn't bet)
Seat 2: naifa (small blind) folded before Flop
Seat 3: MokiMoki (big blind) folded before Flop
Seat 4: crispzilla folded before Flop (didn't bet)
Seat 5: kanococo folded before Flop (didn't bet)
Seat 6: LuckyDragon folded before Flop
Seat 7: GrendelGreat collected (0.11)

CoinPoker Hand #291166176: Hold'em No Limit (0.01/0.02 ) 2025/09/02 18:32:41 GMT
Table 'NL ₮2 VI' 7-max Seat #2 is the button
Seat 1: SQuest (3.50 in chips)
Seat 2: naifa (7.29 in chips)
Seat 3: MokiMoki (0.78 in chips)
Seat 4: crispzilla (2.00 in chips)
Seat 5: kanococo (2.03 in chips)
Seat 6: LuckyDragon (3.05 in chips)
Seat 7: GrendelGreat (2.11 in chips)
MokiMoki: posts small blind 0.01
crispzilla: posts big blind 0.02
*** HOLE CARDS ***
Dealt to kanococo [3c 6d]
kanococo: folds
LuckyDragon: calls 0.02
GrendelGreat: folds
SQuest: raises 0.06 to 0.08
naifa: folds
MokiMoki: folds
crispzilla: folds
LuckyDragon: calls 0.06
*** FLOP *** [Kd Qc 9d]
LuckyDragon: checks
SQuest: checks
*** TURN *** [Kd Qc 9d] [Jd]
LuckyDragon: bets 0.10
SQuest: folds
Uncalled bet (0.10) returned to LuckyDragon
LuckyDragon collected 0.18 from pot
LuckyDragon: doesn't show hand
*** SUMMARY ***
Total pot 0.19 | Rake 0.01
Board [ Kd Qc 9d Jd ]
Game ended: 2025/09/02 18:33:49 GMT
Seat 1: SQuest folded on the Turn
Seat 2: naifa (button) folded before Flop (didn't bet)
Seat 3: MokiMoki (small blind) folded before Flop
Seat 4: crispzilla (big blind) folded before Flop
Seat 5: kanococo folded before Flop (didn't bet)
Seat 6: LuckyDragon collected (0.18)
Seat 7: GrendelGreat folded before Flop (didn't bet)

CoinPoker Hand #291166996: Hold'em No Limit (0.01/0.02 ) 2025/09/02 18:33:51 GMT
Table 'NL ₮2 VI' 7-max Seat #3 is the button
Seat 1: SQuest (3.42 in chips)
Seat 2: naifa (7.29 in chips)
Seat 3: MokiMoki (0.77 in chips) is sitting out
Seat 4: crispzilla (1.98 in chips)
Seat 5: kanococo (2.03 in chips)
Seat 6: LuckyDragon (3.15 in chips)
Seat 7: GrendelGreat (2.11 in chips)
crispzilla: posts small blind 0.01
kanococo: posts big blind 0.02
*** HOLE CARDS ***
Dealt to kanococo [5c Th]
LuckyDragon: calls 0.02
GrendelGreat: raises 0.02 to 0.04
SQuest: folds
naifa: folds
crispzilla: folds
kanococo: folds
LuckyDragon: calls 0.02
*** FLOP *** [8s Ad 8h]
LuckyDragon: checks
GrendelGreat has timed out
GrendelGreat activated time-bank (39 seconds)
GrendelGreat: bets 0.03
LuckyDragon: calls 0.03
*** TURN *** [8s Ad 8h] [3h]
LuckyDragon: folds
GrendelGreat collected 0.16 from pot
GrendelGreat: doesn't show hand
*** SUMMARY ***
Total pot 0.17 | Rake 0.01
Board [ 8s Ad 8h 3h ]
Game ended: 2025/09/02 18:35:05 GMT
Seat 1: SQuest folded before Flop (didn't bet)
Seat 2: naifa folded before Flop (didn't bet)
Seat 3: MokiMoki (button) folded before Flop (didn't bet)
Seat 4: crispzilla (small blind) folded before Flop
Seat 5: kanococo (big blind) folded before Flop
Seat 6: LuckyDragon folded on the Turn
Seat 7: GrendelGreat collected (0.16)

CoinPoker Hand #291167774: Hold'em No Limit (0.01/0.02 ) 2025/09/02 18:35:07 GMT
Table 'NL ₮2 VI' 7-max Seat #4 is the button
Seat 1: SQuest (3.42 in chips)
Seat 2: naifa (7.29 in chips)
Seat 3: tiokosrs (2.00 in chips)
Seat 4: crispzilla (2.00 in chips)
Seat 5: kanococo (2.01 in chips)
Seat 6: LuckyDragon (3.08 in chips)
Seat 7: GrendelGreat (2.20 in chips)
kanococo: posts small blind 0.01
LuckyDragon: posts big blind 0.02
tiokosrs: posts big blind 0.02
*** HOLE CARDS ***
Dealt to kanococo [4s 8c]
GrendelGreat: folds
SQuest: raises 0.06 to 0.08
naifa: folds
tiokosrs: folds
crispzilla: folds
kanococo: folds
LuckyDragon: calls 0.06
*** FLOP *** [8d 3s 6d]
LuckyDragon: checks
SQuest: bets 0.12
LuckyDragon: calls 0.12
*** TURN *** [8d 3s 6d] [Ad]
LuckyDragon: bets 0.16
SQuest: calls 0.16
*** RIVER *** [8d 3s 6d Ad] [Jd]
LuckyDragon: bets 0.24
SQuest: calls 0.24
*** SHOW DOWN ***
LuckyDragon: shows [Ks 2h] (Ace high)
SQuest: shows [Js Jh] (three of kind, Jacks)
SQuest collected 1.17 from pot
*** SUMMARY ***
Total pot 1.23 | Rake 0.06
Board [ 8d 3s 6d Ad Jd ]
Game ended: 2025/09/02 18:36:32 GMT
Seat 1: SQuest showed [Js Jh] and won (1.17) with three of kind, Jacks
Seat 2: naifa folded before Flop (didn't bet)
Seat 3: tiokosrs folded before Flop
Seat 4: crispzilla (button) folded before Flop (didn't bet)
Seat 5: kanococo (small blind) folded before Flop
Seat 6: LuckyDragon (big blind) showed [Ks 2h]
Seat 7: GrendelGreat folded before Flop (didn't bet)

CoinPoker Hand #291168584: Hold'em No Limit (0.01/0.02 ) 2025/09/02 18:36:35 GMT
Table 'NL ₮2 VI' 7-max Seat #5 is the button
Seat 1: SQuest (3.99 in chips)
Seat 2: naifa (7.29 in chips)
Seat 3: tiokosrs (1.98 in chips)
Seat 4: crispzilla (2.00 in chips)
Seat 5: kanococo (2.00 in chips)
Seat 6: LuckyDragon (2.48 in chips)
Seat 7: LegendK (2.00 in chips)
LuckyDragon: posts small blind 0.01
LegendK: posts big blind 0.02
*** HOLE CARDS ***
Dealt to kanococo [Kh 9d]
SQuest: folds
naifa: folds
tiokosrs: folds
crispzilla: folds
kanococo: raises 0.04 to 0.06
LuckyDragon: calls 0.05
LegendK: calls 0.04
*** FLOP *** [6h 5c Ts]
LuckyDragon: checks
LegendK: checks
kanococo: checks
*** TURN *** [6h 5c Ts] [7h]
LuckyDragon: checks
LegendK: checks
kanococo: bets 0.04
LuckyDragon: calls 0.04
LegendK: folds
*** RIVER *** [6h 5c Ts 7h] [3d]
LuckyDragon: checks
kanococo: checks
*** SHOW DOWN ***
LuckyDragon: shows [9c Kd] (King high)
kanococo: shows [Kh 9d] (King high)
LuckyDragon collected 0.13 from pot
kanococo collected 0.12 from pot
*** SUMMARY ***
Total pot 0.26 | Rake 0.01
Board [ 6h 5c Ts 7h 3d ]
Game ended: 2025/09/02 18:37:51 GMT
Seat 1: SQuest folded before Flop (didn't bet)
Seat 2: naifa folded before Flop (didn't bet)
Seat 3: tiokosrs folded before Flop (didn't bet)
Seat 4: crispzilla folded before Flop (didn't bet)
Seat 5: kanococo (button) showed [Kh 9d] and won (0.12) with King high
Seat 6: LuckyDragon (small blind) showed [9c Kd] and won (0.13) with King high
Seat 7: LegendK (big blind) folded on the Turn

CoinPoker Hand #291169713: Hold'em No Limit (0.01/0.02 ) 2025/09/02 18:37:53 GMT
Table 'NL ₮2 VI' 7-max Seat #6 is the button
Seat 1: SQuest (3.99 in chips)
Seat 2: naifa (7.29 in chips)
Seat 3: tiokosrs (1.98 in chips)
Seat 4: crispzilla (2.00 in chips)
Seat 5: kanococo (2.02 in chips)
Seat 6: LuckyDragon (2.51 in chips)
Seat 7: LegendK (1.94 in chips)
LegendK: posts small blind 0.01
SQuest: posts big blind 0.02
*** HOLE CARDS ***
Dealt to kanococo [Jh 8c]
naifa: folds
tiokosrs has timed out
tiokosrs activated time-bank (60 seconds)
tiokosrs: folds
crispzilla: folds
kanococo: folds
LuckyDragon: calls 0.02
LegendK: calls 0.01
SQuest: checks
*** FLOP *** [2h 7c 3d]
LegendK: checks
SQuest: checks
LuckyDragon: checks
*** TURN *** [2h 7c 3d] [4s]
LegendK: checks
SQuest: bets 0.04
LuckyDragon: folds
LegendK: calls 0.04
*** RIVER *** [2h 7c 3d 4s] [9s]
LegendK: checks
SQuest: bets 0.10
LegendK: folds
Uncalled bet (0.10) returned to SQuest
SQuest collected 0.13 from pot
SQuest: doesn't show hand
*** SUMMARY ***
Total pot 0.14 | Rake 0.01
Board [ 2h 7c 3d 4s 9s ]
Game ended: 2025/09/02 18:41:03 GMT
Seat 1: SQuest (big blind) collected (0.13)
Seat 2: naifa folded before Flop (didn't bet)
Seat 3: tiokosrs folded before Flop (didn't bet)
Seat 4: crispzilla folded before Flop (didn't bet)
Seat 5: kanococo folded before Flop (didn't bet)
Seat 6: LuckyDragon (button) folded on the Turn
Seat 7: LegendK (small blind) folded on the River

CoinPoker Hand #291171925: Hold'em No Limit (0.01/0.02 ) 2025/09/02 18:41:04 GMT
Table 'NL ₮2 VI' 7-max Seat #7 is the button
Seat 1: SQuest (4.06 in chips)
Seat 2: naifa (7.29 in chips)
Seat 3: tiokosrs (1.98 in chips)
Seat 4: crispzilla (2.00 in chips)
Seat 5: kanococo (2.02 in chips)
Seat 6: LuckyDragon (2.49 in chips)
Seat 7: LegendK (1.88 in chips)
SQuest: posts small blind 0.01
naifa: posts big blind 0.02
*** HOLE CARDS ***
Dealt to kanococo [7h Jh]
tiokosrs: folds
crispzilla: folds
kanococo: folds
LuckyDragon has timed out
LuckyDragon activated time-bank (58 seconds)
LuckyDragon: calls 0.02
LegendK: folds
SQuest: folds
naifa: checks
*** FLOP *** [Ad Kc 2h]
naifa: checks
LuckyDragon: bets 0.10
naifa: folds
Uncalled bet (0.10) returned to LuckyDragon
LuckyDragon collected 0.05 from pot
LuckyDragon: doesn't show hand
*** SUMMARY ***
Total pot 0.05 | Rake 0.00
Board [ Ad Kc 2h ]
Game ended: 2025/09/02 18:41:55 GMT
Seat 1: SQuest (small blind) folded before Flop
Seat 2: naifa (big blind) folded on the Flop
Seat 3: tiokosrs folded before Flop (didn't bet)
Seat 4: crispzilla folded before Flop (didn't bet)
Seat 5: kanococo folded before Flop (didn't bet)
Seat 6: LuckyDragon collected (0.05)
Seat 7: LegendK (button) folded before Flop (didn't bet)

CoinPoker Hand #291227176: Hold'em No Limit (0.01/0.02 ) 2025/09/02 20:29:50 GMT
Table 'NL ₮2 III' 7-max Seat #1 is the button
Seat 1: Elblop (2.18 in chips)
Seat 2: kanococo (2.00 in chips)
Seat 3: HoldBabyHold (2.01 in chips)
Seat 4: SarkastikBS (1.70 in chips)
Seat 5: GG18vivek (3.37 in chips)
Seat 6: LarryBerry217 (1.71 in chips)
Seat 7: crispzilla (2.16 in chips)
HoldBabyHold: posts small blind 0.01
SarkastikBS: posts big blind 0.02
kanococo: posts big blind 0.02
*** HOLE CARDS ***
Dealt to kanococo [7s 4c]
GG18vivek: folds
LarryBerry217: raises 0.03 to 0.05
crispzilla: raises 0.10 to 0.15
Elblop: folds
kanococo: folds
HoldBabyHold: folds
SarkastikBS: folds
LarryBerry217: folds
crispzilla collected 0.25 from pot
crispzilla: doesn't show hand
*** SUMMARY ***
Total pot 0.25 | Rake 0.00
Board [ ]
Game ended: 2025/09/02 20:30:16 GMT
Seat 1: Elblop (button) folded before Flop (didn't bet)
Seat 2: kanococo folded before Flop
Seat 3: HoldBabyHold (small blind) folded before Flop
Seat 4: SarkastikBS (big blind) folded before Flop
Seat 5: GG18vivek folded before Flop (didn't bet)
Seat 6: LarryBerry217 folded before Flop
Seat 7: crispzilla collected (0.25)

CoinPoker Hand #291227419: Hold'em No Limit (0.01/0.02 ) 2025/09/02 20:30:18 GMT
Table 'NL ₮2 III' 7-max Seat #3 is the button
Seat 1: Elblop (2.18 in chips)
Seat 2: kanococo (1.98 in chips)
Seat 3: HoldBabyHold (2.00 in chips)
Seat 4: SarkastikBS (1.68 in chips)
Seat 5: GG18vivek (3.37 in chips)
Seat 6: LarryBerry217 (1.66 in chips)
Seat 7: crispzilla (2.26 in chips)
SarkastikBS: posts small blind 0.01
GG18vivek: posts big blind 0.02
*** HOLE CARDS ***
Dealt to kanococo [Qc 2c]
LarryBerry217: folds
crispzilla: folds
Elblop: folds
kanococo: raises 0.02 to 0.04
HoldBabyHold: folds
SarkastikBS: folds
GG18vivek is disconnected
GG18vivek has timed out wile being disconnected
GG18vivek activated time-bank (59 seconds)
kanococo said, "Lol"
GG18vivek has timed out wile being disconnected
GG18vivek: folds
kanococo collected 0.07 from pot
kanococo: doesn't show hand
*** SUMMARY ***
Total pot 0.07 | Rake 0.00
Board [ ]
Game ended: 2025/09/02 20:32:59 GMT
Seat 1: Elblop folded before Flop (didn't bet)
Seat 2: kanococo collected (0.07)
Seat 3: HoldBabyHold (button) folded before Flop (didn't bet)
Seat 4: SarkastikBS (small blind) folded before Flop
Seat 5: GG18vivek (big blind) folded before Flop
Seat 6: LarryBerry217 folded before Flop (didn't bet)
Seat 7: crispzilla folded before Flop (didn't bet)

CoinPoker Hand #291228651: Hold'em No Limit (0.01/0.02 ) 2025/09/02 20:33:01 GMT
Table 'NL ₮2 III' 7-max Seat #4 is the button
Seat 1: Elblop (2.18 in chips)
Seat 2: kanococo (2.01 in chips)
Seat 3: HoldBabyHold (2.00 in chips)
Seat 4: SarkastikBS (1.67 in chips)
Seat 5: GG18vivek (3.35 in chips) is sitting out
Seat 6: LarryBerry217 (1.66 in chips)
Seat 7: crispzilla (2.26 in chips)
LarryBerry217: posts small blind 0.01
crispzilla: posts big blind 0.02
*** HOLE CARDS ***
Dealt to kanococo [Qs 6s]
Elblop: folds
kanococo: folds
HoldBabyHold: folds
SarkastikBS: folds
LarryBerry217: calls 0.01
crispzilla: raises 0.04 to 0.06
LarryBerry217: folds
crispzilla collected 0.08 from pot
crispzilla: doesn't show hand
*** SUMMARY ***
Total pot 0.08 | Rake 0.00
Board [ ]
Game ended: 2025/09/02 20:33:22 GMT
Seat 1: Elblop folded before Flop (didn't bet)
Seat 2: kanococo folded before Flop (didn't bet)
Seat 3: HoldBabyHold folded before Flop (didn't bet)
Seat 4: SarkastikBS (button) folded before Flop (didn't bet)
Seat 5: GG18vivek folded before Flop (didn't bet)
Seat 6: LarryBerry217 (small blind) folded before Flop
Seat 7: crispzilla (big blind) collected (0.08)

CoinPoker Hand #291228859: Hold'em No Limit (0.01/0.02 ) 2025/09/02 20:33:25 GMT
Table 'NL ₮2 III' 7-max Seat #6 is the button
Seat 1: Elblop (2.18 in chips)
Seat 2: kanococo (2.01 in chips)
Seat 3: HoldBabyHold (2.00 in chips)
Seat 4: SarkastikBS (1.67 in chips)
Seat 5: GG18vivek (3.35 in chips) is sitting out
Seat 6: LarryBerry217 (1.64 in chips)
Seat 7: crispzilla (2.28 in chips)
crispzilla: posts small blind 0.01
Elblop: posts big blind 0.02
*** HOLE CARDS ***
Dealt to kanococo [Kh Js]
kanococo: raises 0.02 to 0.04
HoldBabyHold: calls 0.04
SarkastikBS: raises 0.20 to 0.24
LarryBerry217: folds
crispzilla: folds
Elblop: calls 0.22
kanococo: calls 0.20
HoldBabyHold: calls 0.20
*** FLOP *** [2s 8s Kd]
Elblop: checks
kanococo: bets 0.46
HoldBabyHold: folds
SarkastikBS: raises 1.43 and is all-in
Elblop: folds
kanococo: calls 0.97
*** TURN *** [2s 8s Kd] [Ad]
*** RIVER *** [2s 8s Kd Ad] [7d]
*** SHOW DOWN ***
SarkastikBS: shows [As Qs] (a pair of Aces)
kanococo: shows [Kh Js] (a pair of Kings)
SarkastikBS collected 3.64 from pot
*** SUMMARY ***
Total pot 3.83 | Rake 0.19
Board [ 2s 8s Kd Ad 7d ]
Game ended: 2025/09/02 20:34:19 GMT
Seat 1: Elblop (big blind) folded on the Flop
Seat 2: kanococo showed [Kh Js]
Seat 3: HoldBabyHold folded on the Flop
Seat 4: SarkastikBS showed [As Qs] and won (3.64) with a pair of Aces
Seat 5: GG18vivek folded before Flop (didn't bet)
Seat 6: LarryBerry217 (button) folded before Flop (didn't bet)
Seat 7: crispzilla (small blind) folded before Flop

CoinPoker Hand #291229353: Hold'em No Limit (0.01/0.02 ) 2025/09/02 20:34:21 GMT
Table 'NL ₮2 III' 7-max Seat #7 is the button
Seat 1: Elblop (2.00 in chips)
Seat 2: kanococo (0.34 in chips)
Seat 3: HoldBabyHold (2.00 in chips)
Seat 4: SarkastikBS (3.64 in chips)
Seat 5: GG18vivek (3.35 in chips) is sitting out
Seat 6: LarryBerry217 (1.64 in chips)
Seat 7: crispzilla (2.27 in chips)
Elblop: posts small blind 0.01
kanococo: posts big blind 0.02
*** HOLE CARDS ***
Dealt to kanococo [9h 9c]
HoldBabyHold: folds
SarkastikBS: raises 0.03 to 0.05
LarryBerry217: calls 0.05
crispzilla: folds
Elblop: calls 0.04
kanococo: raises 0.32 and is all-in
SarkastikBS: folds
LarryBerry217: calls 0.29
Elblop: folds
*** FLOP *** [2c 4d 2h]
*** TURN *** [2c 4d 2h] [Ac]
*** RIVER *** [2c 4d 2h Ac] [5c]
*** SHOW DOWN ***
kanococo: shows [9h 9c] (two pairs, Nines and Twos)
LarryBerry217: shows [8s Kh] (a pair of Twos)
kanococo collected 0.74 from pot
*** SUMMARY ***
Total pot 0.78 | Rake 0.04
Board [ 2c 4d 2h Ac 5c ]
Game ended: 2025/09/02 20:35:15 GMT
Seat 1: Elblop (small blind) folded before Flop
Seat 2: kanococo (big blind) showed [9h 9c] and won (0.74) with two pairs, Nines and Twos
Seat 3: HoldBabyHold folded before Flop (didn't bet)
Seat 4: SarkastikBS folded before Flop
Seat 5: GG18vivek folded before Flop (didn't bet)
Seat 6: LarryBerry217 showed [8s Kh]
Seat 7: crispzilla (button) folded before Flop (didn't bet)

CoinPoker Hand #291229744: Hold'em No Limit (0.01/0.02 ) 2025/09/02 20:35:17 GMT
Table 'NL ₮2 III' 7-max Seat #1 is the button
Seat 1: Elblop (1.95 in chips)
Seat 2: kanococo (0.74 in chips)
Seat 3: HoldBabyHold (2.00 in chips)
Seat 4: SarkastikBS (3.59 in chips)
Seat 5: GG18vivek (3.35 in chips) is sitting out
Seat 6: LarryBerry217 (1.30 in chips)
Seat 7: crispzilla (2.27 in chips)
kanococo: posts small blind 0.01
HoldBabyHold: posts big blind 0.02
*** HOLE CARDS ***
Dealt to kanococo [Jd 4c]
SarkastikBS: folds
LarryBerry217: folds
crispzilla: raises 0.04 to 0.06
Elblop: calls 0.06
kanococo: calls 0.05
HoldBabyHold: folds
*** FLOP *** [7d 2c Td]
kanococo: checks
crispzilla: checks
Elblop: checks
*** TURN *** [7d 2c Td] [7c]
kanococo: bets 0.09
crispzilla: folds
Elblop: raises 0.37 to 0.46
kanococo: folds
Uncalled bet (0.37) returned to Elblop
Elblop collected 0.37 from pot
Elblop: doesn't show hand
*** SUMMARY ***
Total pot 0.38 | Rake 0.01
Board [ 7d 2c Td 7c ]
Game ended: 2025/09/02 20:36:52 GMT
Seat 1: Elblop (button) collected (0.37)
Seat 2: kanococo (small blind) folded on the Turn
Seat 3: HoldBabyHold (big blind) folded before Flop
Seat 4: SarkastikBS folded before Flop (didn't bet)
Seat 5: GG18vivek folded before Flop (didn't bet)
Seat 6: LarryBerry217 folded before Flop (didn't bet)
Seat 7: crispzilla folded on the Turn

CoinPoker Hand #291230527: Hold'em No Limit (0.01/0.02 ) 2025/09/02 20:36:54 GMT
Table 'NL ₮2 III' 7-max Seat #2 is the button
Seat 1: Elblop (2.17 in chips)
Seat 2: kanococo (0.59 in chips)
Seat 3: HoldBabyHold (2.00 in chips)
Seat 4: SarkastikBS (3.59 in chips)
Seat 5: GG18vivek (3.35 in chips) is sitting out
Seat 6: LarryBerry217 (1.30 in chips)
Seat 7: crispzilla (2.21 in chips)
HoldBabyHold: posts small blind 0.01
SarkastikBS: posts big blind 0.02
*** HOLE CARDS ***
Dealt to kanococo [Jh 4s]
LarryBerry217: folds
crispzilla: folds
Elblop: folds
kanococo: folds
HoldBabyHold: folds
SarkastikBS collected 0.03 from pot
SarkastikBS: doesn't show hand
*** SUMMARY ***
Total pot 0.03 | Rake 0.00
Board [ ]
Game ended: 2025/09/02 20:37:14 GMT
Seat 1: Elblop folded before Flop (didn't bet)
Seat 2: kanococo (button) folded before Flop (didn't bet)
Seat 3: HoldBabyHold (small blind) folded before Flop
Seat 4: SarkastikBS (big blind) collected (0.03)
Seat 5: GG18vivek folded before Flop (didn't bet)
Seat 6: LarryBerry217 folded before Flop (didn't bet)
Seat 7: crispzilla folded before Flop (didn't bet)

CoinPoker Hand #291230685: Hold'em No Limit (0.01/0.02 ) 2025/09/02 20:37:16 GMT
Table 'NL ₮2 III' 7-max Seat #3 is the button
Seat 1: Elblop (2.17 in chips)
Seat 2: kanococo (0.59 in chips)
Seat 3: HoldBabyHold (2.00 in chips)
Seat 4: SarkastikBS (3.60 in chips)
Seat 5: GG18vivek (3.35 in chips) is sitting out
Seat 6: LarryBerry217 (1.30 in chips)
Seat 7: crispzilla (2.21 in chips)
SarkastikBS: posts small blind 0.01
LarryBerry217: posts big blind 0.02
*** HOLE CARDS ***
Dealt to kanococo [2c 9s]
crispzilla: folds
Elblop: folds
kanococo: folds
HoldBabyHold: folds
SarkastikBS: folds
LarryBerry217 collected 0.03 from pot
LarryBerry217: doesn't show hand
*** SUMMARY ***
Total pot 0.03 | Rake 0.00
Board [ ]
Game ended: 2025/09/02 20:37:38 GMT
Seat 1: Elblop folded before Flop (didn't bet)
Seat 2: kanococo folded before Flop (didn't bet)
Seat 3: HoldBabyHold (button) folded before Flop (didn't bet)
Seat 4: SarkastikBS (small blind) folded before Flop
Seat 5: GG18vivek folded before Flop (didn't bet)
Seat 6: LarryBerry217 (big blind) collected (0.03)
Seat 7: crispzilla folded before Flop (didn't bet)

CoinPoker Hand #291230864: Hold'em No Limit (0.01/0.02 ) 2025/09/02 20:37:40 GMT
Table 'NL ₮2 III' 7-max Seat #4 is the button
Seat 1: Elblop (2.17 in chips)
Seat 2: kanococo (0.59 in chips)
Seat 3: HoldBabyHold (2.00 in chips)
Seat 4: SarkastikBS (3.59 in chips)
Seat 5: GG18vivek (3.35 in chips) is sitting out
Seat 6: LarryBerry217 (1.31 in chips)
Seat 7: crispzilla (2.21 in chips)
LarryBerry217: posts small blind 0.01
crispzilla: posts big blind 0.02
*** HOLE CARDS ***
Dealt to kanococo [6d 3s]
Elblop: folds
kanococo: folds
HoldBabyHold: folds
SarkastikBS: folds
LarryBerry217: calls 0.01
crispzilla: checks
*** FLOP *** [Qs Jh Ks]
LarryBerry217: checks
crispzilla: bets 0.04
LarryBerry217: folds
Uncalled bet (0.04) returned to crispzilla
crispzilla collected 0.04 from pot
crispzilla: doesn't show hand
*** SUMMARY ***
Total pot 0.04 | Rake 0.00
Board [ Qs Jh Ks ]
Game ended: 2025/09/02 20:38:18 GMT
Seat 1: Elblop folded before Flop (didn't bet)
Seat 2: kanococo folded before Flop (didn't bet)
Seat 3: HoldBabyHold folded before Flop (didn't bet)
Seat 4: SarkastikBS (button) folded before Flop (didn't bet)
Seat 5: GG18vivek folded before Flop (didn't bet)
Seat 6: LarryBerry217 (small blind) folded on the Flop
Seat 7: crispzilla (big blind) collected (0.04)

CoinPoker Hand #291231203: Hold'em No Limit (0.01/0.02 ) 2025/09/02 20:38:20 GMT
Table 'NL ₮2 III' 7-max Seat #6 is the button
Seat 1: Elblop (2.17 in chips)
Seat 2: kanococo (0.59 in chips)
Seat 3: HoldBabyHold (2.00 in chips)
Seat 4: SarkastikBS (3.59 in chips)
Seat 5: GG18vivek (3.35 in chips) is sitting out
Seat 6: LarryBerry217 (1.29 in chips)
Seat 7: crispzilla (2.23 in chips)
crispzilla: posts small blind 0.01
Elblop: posts big blind 0.02
*** HOLE CARDS ***
Dealt to kanococo [2s Th]
kanococo: folds
HoldBabyHold: folds
SarkastikBS: folds
LarryBerry217: folds
crispzilla: raises 0.04 to 0.06
Elblop: raises 2.15 and is all-in
crispzilla has timed out
crispzilla activated time-bank (36 seconds)
crispzilla: folds
Elblop collected 2.23 from pot
Elblop: doesn't show hand
*** SUMMARY ***
Total pot 2.23 | Rake 0.00
Board [ ]
Game ended: 2025/09/02 20:39:04 GMT
Seat 1: Elblop (big blind) collected (2.23)
Seat 2: kanococo folded before Flop (didn't bet)
Seat 3: HoldBabyHold folded before Flop (didn't bet)
Seat 4: SarkastikBS folded before Flop (didn't bet)
Seat 5: GG18vivek folded before Flop (didn't bet)
Seat 6: LarryBerry217 (button) folded before Flop (didn't bet)
Seat 7: crispzilla (small blind) folded before Flop

CoinPoker Hand #291231630: Hold'em No Limit (0.01/0.02 ) 2025/09/02 20:39:06 GMT
Table 'NL ₮2 III' 7-max Seat #7 is the button
Seat 1: Elblop (2.23 in chips)
Seat 2: kanococo (0.59 in chips)
Seat 3: HoldBabyHold (2.00 in chips)
Seat 4: SarkastikBS (3.59 in chips)
Seat 5: GG18vivek (3.35 in chips) is sitting out
Seat 6: LarryBerry217 (1.29 in chips)
Seat 7: crispzilla (2.17 in chips)
Elblop: posts small blind 0.01
kanococo: posts big blind 0.02
*** HOLE CARDS ***
Dealt to kanococo [Ks 5d]
HoldBabyHold: folds
Elblop said, "take that!"
SarkastikBS: folds
LarryBerry217: folds
crispzilla: folds
Elblop: folds
kanococo collected 0.03 from pot
kanococo: doesn't show hand
*** SUMMARY ***
Total pot 0.03 | Rake 0.00
Board [ ]
Game ended: 2025/09/02 20:39:23 GMT
Seat 1: Elblop (small blind) folded before Flop
Seat 2: kanococo (big blind) collected (0.03)
Seat 3: HoldBabyHold folded before Flop (didn't bet)
Seat 4: SarkastikBS folded before Flop (didn't bet)
Seat 5: GG18vivek folded before Flop (didn't bet)
Seat 6: LarryBerry217 folded before Flop (didn't bet)
Seat 7: crispzilla (button) folded before Flop (didn't bet)

CoinPoker Hand #291231768: Hold'em No Limit (0.01/0.02 ) 2025/09/02 20:39:25 GMT
Table 'NL ₮2 III' 7-max Seat #1 is the button
Seat 1: Elblop (2.22 in chips)
Seat 2: kanococo (0.60 in chips)
Seat 3: HoldBabyHold (2.00 in chips)
Seat 4: SarkastikBS (3.59 in chips)
Seat 5: GG18vivek (3.35 in chips) is sitting out
Seat 6: LarryBerry217 (1.29 in chips)
Seat 7: crispzilla (2.17 in chips)
kanococo: posts small blind 0.01
HoldBabyHold: posts big blind 0.02
*** HOLE CARDS ***
Dealt to kanococo [5h 6s]
SarkastikBS: folds
LarryBerry217: calls 0.02
crispzilla: folds
Elblop: calls 0.02
kanococo: folds
HoldBabyHold: checks
*** FLOP *** [5d 7d Qd]
HoldBabyHold: checks
LarryBerry217: bets 0.03
Elblop: folds
HoldBabyHold: folds
Uncalled bet (0.03) returned to LarryBerry217
LarryBerry217 collected 0.07 from pot
LarryBerry217: doesn't show hand
*** SUMMARY ***
Total pot 0.07 | Rake 0.00
Board [ 5d 7d Qd ]
Game ended: 2025/09/02 20:40:05 GMT
Seat 1: Elblop (button) folded on the Flop
Seat 2: kanococo (small blind) folded before Flop
Seat 3: HoldBabyHold (big blind) folded on the Flop
Seat 4: SarkastikBS folded before Flop (didn't bet)
Seat 5: GG18vivek folded before Flop (didn't bet)
Seat 6: LarryBerry217 collected (0.07)
Seat 7: crispzilla folded before Flop (didn't bet)

CoinPoker Hand #291232171: Hold'em No Limit (0.01/0.02 ) 2025/09/02 20:40:08 GMT
Table 'NL ₮2 III' 7-max Seat #2 is the button
Seat 1: Elblop (2.20 in chips)
Seat 2: kanococo (0.59 in chips)
Seat 3: HoldBabyHold (2.00 in chips)
Seat 4: SarkastikBS (3.59 in chips)
Seat 5: GG18vivek (3.35 in chips) is sitting out
Seat 6: LarryBerry217 (1.34 in chips)
Seat 7: crispzilla (2.17 in chips)
HoldBabyHold: posts small blind 0.01
SarkastikBS: posts big blind 0.02
*** HOLE CARDS ***
Dealt to kanococo [7s 7c]
LarryBerry217: folds
crispzilla: raises 0.04 to 0.06
Elblop: folds
kanococo: calls 0.06
HoldBabyHold: folds
SarkastikBS: folds
*** FLOP *** [6s 9h Jh]
crispzilla: checks
kanococo: bets 0.07
crispzilla: folds
Uncalled bet (0.07) returned to kanococo
kanococo collected 0.14 from pot
kanococo: doesn't show hand
*** SUMMARY ***
Total pot 0.15 | Rake 0.01
Board [ 6s 9h Jh ]
Game ended: 2025/09/02 20:40:55 GMT
Seat 1: Elblop folded before Flop (didn't bet)
Seat 2: kanococo (button) collected (0.14)
Seat 3: HoldBabyHold (small blind) folded before Flop
Seat 4: SarkastikBS (big blind) folded before Flop
Seat 5: GG18vivek folded before Flop (didn't bet)
Seat 6: LarryBerry217 folded before Flop (didn't bet)
Seat 7: crispzilla folded on the Flop

CoinPoker Hand #291232544: Hold'em No Limit (0.01/0.02 ) 2025/09/02 20:40:57 GMT
Table 'NL ₮2 III' 7-max Seat #3 is the button
Seat 1: Elblop (2.20 in chips)
Seat 2: kanococo (0.67 in chips)
Seat 3: HoldBabyHold (1.99 in chips)
Seat 4: SarkastikBS (3.57 in chips)
Seat 5: GG18vivek (3.35 in chips) is sitting out
Seat 6: LarryBerry217 (1.34 in chips)
Seat 7: crispzilla (2.11 in chips)
SarkastikBS: posts small blind 0.01
LarryBerry217: posts big blind 0.02
*** HOLE CARDS ***
Dealt to kanococo [Qs Kh]
crispzilla: folds
Elblop: folds
kanococo: raises 0.02 to 0.04
HoldBabyHold: folds
SarkastikBS: calls 0.03
LarryBerry217: calls 0.02
*** FLOP *** [2s 7c 3s]
SarkastikBS: checks
LarryBerry217: bets 0.04
kanococo: calls 0.04
SarkastikBS: folds
*** TURN *** [2s 7c 3s] [Jh]
LarryBerry217: checks
kanococo: bets 0.09
LarryBerry217: calls 0.09
*** RIVER *** [2s 7c 3s Jh] [4h]
LarryBerry217: checks
kanococo: checks
*** SHOW DOWN ***
LarryBerry217: shows [4s 9s] (a pair of Fours)
kanococo: mucks hand
LarryBerry217 collected 0.36 from pot
*** SUMMARY ***
Total pot 0.38 | Rake 0.02
Board [ 2s 7c 3s Jh 4h ]
Game ended: 2025/09/02 20:41:45 GMT
Seat 1: Elblop folded before Flop (didn't bet)
Seat 2: kanococo mucked
Seat 3: HoldBabyHold (button) folded before Flop (didn't bet)
Seat 4: SarkastikBS (small blind) folded on the Flop
Seat 5: GG18vivek folded before Flop (didn't bet)
Seat 6: LarryBerry217 (big blind) showed [4s 9s] and won (0.36) with a pair of Fours
Seat 7: crispzilla folded before Flop (didn't bet)

CoinPoker Hand #291232921: Hold'em No Limit (0.01/0.02 ) 2025/09/02 20:41:47 GMT
Table 'NL ₮2 III' 7-max Seat #4 is the button
Seat 1: Elblop (2.20 in chips)
Seat 2: kanococo (0.50 in chips)
Seat 3: HoldBabyHold (2.00 in chips)
Seat 4: SarkastikBS (3.53 in chips)
Seat 5: GG18vivek (3.35 in chips) is sitting out
Seat 6: LarryBerry217 (1.53 in chips)
Seat 7: crispzilla (2.11 in chips)
LarryBerry217: posts small blind 0.01
crispzilla: posts big blind 0.02
*** HOLE CARDS ***
Dealt to kanococo [7c Ac]
Elblop: folds
kanococo: folds
HoldBabyHold: folds
SarkastikBS: folds
LarryBerry217: raises 0.02 to 0.04
crispzilla: calls 0.02
*** FLOP *** [Kc 9h 7h]
LarryBerry217: bets 0.02
crispzilla: raises 0.06 to 0.08
LarryBerry217: folds
Uncalled bet (0.06) returned to crispzilla
crispzilla collected 0.12 from pot
crispzilla: doesn't show hand
GG18vivek has reconnected
*** SUMMARY ***
Total pot 0.12 | Rake 0.00
Board [ Kc 9h 7h ]
Game ended: 2025/09/02 20:42:26 GMT
Seat 1: Elblop folded before Flop (didn't bet)
Seat 2: kanococo folded before Flop (didn't bet)
Seat 3: HoldBabyHold folded before Flop (didn't bet)
Seat 4: SarkastikBS (button) folded before Flop (didn't bet)
Seat 5: GG18vivek folded before Flop (didn't bet)
Seat 6: LarryBerry217 (small blind) folded on the Flop
Seat 7: crispzilla (big blind) collected (0.12)

CoinPoker Hand #291233362: Hold'em No Limit (0.01/0.02 ) 2025/09/02 20:42:28 GMT
Table 'NL ₮2 III' 7-max Seat #6 is the button
Seat 1: Elblop (2.20 in chips)
Seat 2: kanococo (0.50 in chips)
Seat 3: HoldBabyHold (2.00 in chips)
Seat 4: SarkastikBS (3.53 in chips)
Seat 5: GG18vivek (3.35 in chips)
Seat 6: LarryBerry217 (1.47 in chips)
Seat 7: crispzilla (2.17 in chips)
crispzilla: posts small blind 0.01
Elblop: posts big blind 0.02
GG18vivek: posts big blind 0.02
*** HOLE CARDS ***
Dealt to kanococo [7d Td]
kanococo: folds
HoldBabyHold: folds
SarkastikBS: folds
GG18vivek: checks
LarryBerry217: folds
crispzilla: calls 0.01
Elblop: checks
*** FLOP *** [5d Jd Qh]
crispzilla: checks
Elblop: checks
GG18vivek: checks
*** TURN *** [5d Jd Qh] [7s]
crispzilla has timed out
crispzilla activated time-bank (23 seconds)
crispzilla: checks
Elblop: checks
GG18vivek: checks
*** RIVER *** [5d Jd Qh 7s] [2c]
crispzilla: checks
Elblop: checks
GG18vivek: checks
*** SHOW DOWN ***
crispzilla: shows [Tc 6c] (Queen high)
Elblop: shows [Kc 9c] (King high)
GG18vivek: mucks hand
Elblop collected 0.06 from pot
*** SUMMARY ***
Total pot 0.06 | Rake 0.00
Board [ 5d Jd Qh 7s 2c ]
Game ended: 2025/09/02 20:43:57 GMT
Seat 1: Elblop (big blind) showed [Kc 9c] and won (0.06) with King high
Seat 2: kanococo folded before Flop (didn't bet)
Seat 3: HoldBabyHold folded before Flop (didn't bet)
Seat 4: SarkastikBS folded before Flop (didn't bet)
Seat 5: GG18vivek mucked
Seat 6: LarryBerry217 (button) folded before Flop (didn't bet)
Seat 7: crispzilla (small blind) showed [Tc 6c]

CoinPoker Hand #291233992: Hold'em No Limit (0.01/0.02 ) 2025/09/02 20:43:59 GMT
Table 'NL ₮2 III' 7-max Seat #7 is the button
Seat 1: Elblop (2.24 in chips)
Seat 2: kanococo (0.50 in chips)
Seat 3: HoldBabyHold (2.00 in chips)
Seat 4: SarkastikBS (3.53 in chips)
Seat 5: GG18vivek (3.33 in chips) is sitting out
Seat 6: LarryBerry217 (1.47 in chips)
Seat 7: crispzilla (2.15 in chips)
Elblop: posts small blind 0.01
kanococo: posts big blind 0.02
*** HOLE CARDS ***
Dealt to kanococo [Kh 6h]
HoldBabyHold: folds
SarkastikBS: folds
LarryBerry217: raises 0.04 to 0.06
crispzilla: folds
Elblop: calls 0.05
kanococo: raises 0.48 and is all-in
LarryBerry217: calls 0.44
Elblop: folds
*** FLOP *** [8h 3h 9h]
*** TURN *** [8h 3h 9h] [Tc]
*** RIVER *** [8h 3h 9h Tc] [5c]
*** SHOW DOWN ***
kanococo: shows [Kh 6h] (a flush, King high)
LarryBerry217: shows [Ks Kc] (a pair of Kings)
kanococo collected 1.01 from pot
*** SUMMARY ***
Total pot 1.06 | Rake 0.05
Board [ 8h 3h 9h Tc 5c ]
Game ended: 2025/09/02 20:44:40 GMT
Seat 1: Elblop (small blind) folded before Flop
Seat 2: kanococo (big blind) showed [Kh 6h] and won (1.01) with a flush, King high
Seat 3: HoldBabyHold folded before Flop (didn't bet)
Seat 4: SarkastikBS folded before Flop (didn't bet)
Seat 5: GG18vivek folded before Flop (didn't bet)
Seat 6: LarryBerry217 showed [Ks Kc]
Seat 7: crispzilla (button) folded before Flop (didn't bet)

CoinPoker Hand #291234259: Hold'em No Limit (0.01/0.02 ) 2025/09/02 20:44:42 GMT
Table 'NL ₮2 III' 7-max Seat #1 is the button
Seat 1: Elblop (2.18 in chips)
Seat 2: kanococo (1.01 in chips)
Seat 3: HoldBabyHold (2.00 in chips)
Seat 4: SarkastikBS (3.53 in chips)
Seat 5: otaldojamal (2.00 in chips)
Seat 6: LarryBerry217 (0.97 in chips)
Seat 7: crispzilla (2.15 in chips)
kanococo: posts small blind 0.01
HoldBabyHold: posts big blind 0.02
otaldojamal: posts big blind 0.02
*** HOLE CARDS ***
Dealt to kanococo [7d 7h]
SarkastikBS: folds
Elblop said, "course"
kanococo said, "hahaha sorry"
otaldojamal: raises 0.04 to 0.06
LarryBerry217: calls 0.06
crispzilla: folds
Elblop said, "lol its poker"
Elblop: calls 0.06
kanococo: calls 0.05
HoldBabyHold: folds
*** FLOP *** [Jh 6h Kh]
kanococo: bets 0.12
otaldojamal: calls 0.12
LarryBerry217: folds
Elblop: folds
*** TURN *** [Jh 6h Kh] [Ah]
kanococo: bets 0.83 and is all-in
otaldojamal: folds
Uncalled bet (0.83) returned to kanococo
kanococo collected 0.47 from pot
kanococo: doesn't show hand
*** SUMMARY ***
Total pot 0.50 | Rake 0.03
Board [ Jh 6h Kh Ah ]
Game ended: 2025/09/02 20:45:45 GMT
Seat 1: Elblop (button) folded on the Flop
Seat 2: kanococo (small blind) collected (0.47)
Seat 3: HoldBabyHold (big blind) folded before Flop
Seat 4: SarkastikBS folded before Flop (didn't bet)
Seat 5: otaldojamal folded on the Turn
Seat 6: LarryBerry217 folded on the Flop
Seat 7: crispzilla folded before Flop (didn't bet)

CoinPoker Hand #291234845: Hold'em No Limit (0.01/0.02 ) 2025/09/02 20:45:47 GMT
Table 'NL ₮2 III' 7-max Seat #2 is the button
Seat 1: Elblop (2.12 in chips)
Seat 2: kanococo (1.30 in chips)
Seat 3: HoldBabyHold (2.00 in chips)
Seat 4: SarkastikBS (3.53 in chips)
Seat 5: otaldojamal (2.00 in chips)
Seat 6: LarryBerry217 (0.91 in chips)
Seat 7: crispzilla (2.15 in chips)
HoldBabyHold: posts small blind 0.01
SarkastikBS: posts big blind 0.02
*** HOLE CARDS ***
Dealt to kanococo [2s 9c]
otaldojamal: folds
LarryBerry217: folds
crispzilla: raises 0.04 to 0.06
Elblop: folds
kanococo: folds
HoldBabyHold: folds
SarkastikBS: folds
crispzilla collected 0.09 from pot
crispzilla: doesn't show hand
*** SUMMARY ***
Total pot 0.09 | Rake 0.00
Board [ ]
Game ended: 2025/09/02 20:46:06 GMT
Seat 1: Elblop folded before Flop (didn't bet)
Seat 2: kanococo (button) folded before Flop (didn't bet)
Seat 3: HoldBabyHold (small blind) folded before Flop
Seat 4: SarkastikBS (big blind) folded before Flop
Seat 5: otaldojamal folded before Flop (didn't bet)
Seat 6: LarryBerry217 folded before Flop (didn't bet)
Seat 7: crispzilla collected (0.09)

CoinPoker Hand #291234987: Hold'em No Limit (0.01/0.02 ) 2025/09/02 20:46:08 GMT
Table 'NL ₮2 III' 7-max Seat #3 is the button
Seat 1: Elblop (2.12 in chips)
Seat 2: kanococo (1.30 in chips)
Seat 3: HoldBabyHold (2.00 in chips)
Seat 4: SarkastikBS (3.51 in chips)
Seat 5: otaldojamal (2.00 in chips)
Seat 6: LarryBerry217 (0.91 in chips)
Seat 7: crispzilla (2.18 in chips)
SarkastikBS: posts small blind 0.01
otaldojamal: posts big blind 0.02
*** HOLE CARDS ***
Dealt to kanococo [4h Td]
LarryBerry217: folds
crispzilla: folds
Elblop: raises 0.02 to 0.04
kanococo: folds
HoldBabyHold: raises 0.10 to 0.14
SarkastikBS: folds
otaldojamal: folds
Elblop: calls 0.10
*** FLOP *** [5s 3h 2d]
Elblop: checks
HoldBabyHold: checks
*** TURN *** [5s 3h 2d] [3s]
Elblop: bets 0.14
HoldBabyHold: calls 0.14
*** RIVER *** [5s 3h 2d 3s] [6d]
Elblop: checks
HoldBabyHold: checks
*** SHOW DOWN ***
Elblop: shows [Kc Jc] (a pair of Threes)
HoldBabyHold: shows [Kd Ad] (a pair of Threes)
HoldBabyHold collected 0.56 from pot
*** SUMMARY ***
Total pot 0.59 | Rake 0.03
Board [ 5s 3h 2d 3s 6d ]
Game ended: 2025/09/02 20:47:15 GMT
Seat 1: Elblop showed [Kc Jc]
Seat 2: kanococo folded before Flop (didn't bet)
Seat 3: HoldBabyHold (button) showed [Kd Ad] and won (0.56) with a pair of Threes
Seat 4: SarkastikBS (small blind) folded before Flop
Seat 5: otaldojamal (big blind) folded before Flop
Seat 6: LarryBerry217 folded before Flop (didn't bet)
Seat 7: crispzilla folded before Flop (didn't bet)

CoinPoker Hand #291235574: Hold'em No Limit (0.01/0.02 ) 2025/09/02 20:47:17 GMT
Table 'NL ₮2 III' 7-max Seat #4 is the button
Seat 1: Elblop (2.00 in chips)
Seat 2: kanococo (1.30 in chips)
Seat 3: HoldBabyHold (2.28 in chips)
Seat 4: SarkastikBS (3.50 in chips)
Seat 5: otaldojamal (1.98 in chips)
Seat 6: LarryBerry217 (0.91 in chips)
Seat 7: crispzilla (2.18 in chips)
otaldojamal: posts small blind 0.01
LarryBerry217: posts big blind 0.02
*** HOLE CARDS ***
Dealt to kanococo [Qc 8h]
crispzilla: folds
Elblop: folds
kanococo: folds
HoldBabyHold: folds
SarkastikBS: folds
otaldojamal: raises 0.04 to 0.06
LarryBerry217: folds
otaldojamal collected 0.08 from pot
otaldojamal: doesn't show hand
*** SUMMARY ***
Total pot 0.08 | Rake 0.00
Board [ ]
Game ended: 2025/09/02 20:47:51 GMT
Seat 1: Elblop folded before Flop (didn't bet)
Seat 2: kanococo folded before Flop (didn't bet)
Seat 3: HoldBabyHold folded before Flop (didn't bet)
Seat 4: SarkastikBS (button) folded before Flop (didn't bet)
Seat 5: otaldojamal (small blind) collected (0.08)
Seat 6: LarryBerry217 (big blind) folded before Flop
Seat 7: crispzilla folded before Flop (didn't bet)

CoinPoker Hand #291235841: Hold'em No Limit (0.01/0.02 ) 2025/09/02 20:47:53 GMT
Table 'NL ₮2 III' 7-max Seat #5 is the button
Seat 1: Elblop (2.00 in chips)
Seat 2: kanococo (1.30 in chips)
Seat 3: HoldBabyHold (2.28 in chips)
Seat 4: SarkastikBS (3.50 in chips)
Seat 5: otaldojamal (2.00 in chips)
Seat 6: LarryBerry217 (0.89 in chips)
Seat 7: crispzilla (2.18 in chips)
LarryBerry217: posts small blind 0.01
crispzilla: posts big blind 0.02
*** HOLE CARDS ***
Dealt to kanococo [9d 4d]
Elblop: folds
kanococo: folds
HoldBabyHold: folds
SarkastikBS: folds
otaldojamal: folds
LarryBerry217: folds
crispzilla collected 0.03 from pot
crispzilla: doesn't show hand
*** SUMMARY ***
Total pot 0.03 | Rake 0.00
Board [ ]
Game ended: 2025/09/02 20:48:14 GMT
Seat 1: Elblop folded before Flop (didn't bet)
Seat 2: kanococo folded before Flop (didn't bet)
Seat 3: HoldBabyHold folded before Flop (didn't bet)
Seat 4: SarkastikBS folded before Flop (didn't bet)
Seat 5: otaldojamal (button) folded before Flop (didn't bet)
Seat 6: LarryBerry217 (small blind) folded before Flop
Seat 7: crispzilla (big blind) collected (0.03)

CoinPoker Hand #291236049: Hold'em No Limit (0.01/0.02 ) 2025/09/02 20:48:16 GMT
Table 'NL ₮2 III' 7-max Seat #6 is the button
Seat 1: Elblop (2.00 in chips)
Seat 2: kanococo (1.30 in chips)
Seat 3: HoldBabyHold (2.28 in chips)
Seat 4: SarkastikBS (3.50 in chips)
Seat 5: otaldojamal (2.00 in chips)
Seat 6: LarryBerry217 (0.88 in chips)
Seat 7: crispzilla (2.19 in chips)
crispzilla: posts small blind 0.01
Elblop: posts big blind 0.02
*** HOLE CARDS ***
Dealt to kanococo [Th 9h]
kanococo: folds
HoldBabyHold: folds
SarkastikBS: folds
otaldojamal: raises 0.03 to 0.05
LarryBerry217: raises 0.10 to 0.15
crispzilla: folds
Elblop: folds
otaldojamal: folds
LarryBerry217 collected 0.23 from pot
LarryBerry217: doesn't show hand
*** SUMMARY ***
Total pot 0.23 | Rake 0.00
Board [ ]
Game ended: 2025/09/02 20:49:01 GMT
Seat 1: Elblop (big blind) folded before Flop
Seat 2: kanococo folded before Flop (didn't bet)
Seat 3: HoldBabyHold folded before Flop (didn't bet)
Seat 4: SarkastikBS folded before Flop (didn't bet)
Seat 5: otaldojamal folded before Flop
Seat 6: LarryBerry217 (button) collected (0.23)
Seat 7: crispzilla (small blind) folded before Flop

CoinPoker Hand #291236324: Hold'em No Limit (0.01/0.02 ) 2025/09/02 20:49:03 GMT
Table 'NL ₮2 III' 7-max Seat #7 is the button
Seat 1: Elblop (2.00 in chips)
Seat 2: kanococo (1.30 in chips)
Seat 3: HoldBabyHold (2.28 in chips)
Seat 4: SarkastikBS (3.50 in chips)
Seat 5: otaldojamal (2.00 in chips)
Seat 6: LarryBerry217 (0.96 in chips)
Seat 7: crispzilla (2.18 in chips)
Elblop: posts small blind 0.01
kanococo: posts big blind 0.02
*** HOLE CARDS ***
Dealt to kanococo [9c Th]
HoldBabyHold: folds
SarkastikBS: folds
otaldojamal: raises 0.03 to 0.05
LarryBerry217: folds
crispzilla: calls 0.05
Elblop: folds
kanococo: calls 0.03
*** FLOP *** [5c Ac Kd]
kanococo: bets 0.04
otaldojamal: raises 0.11 to 0.15
crispzilla: folds
kanococo: folds
Uncalled bet (0.11) returned to otaldojamal
otaldojamal collected 0.23 from pot
otaldojamal: doesn't show hand
*** SUMMARY ***
Total pot 0.24 | Rake 0.01
Board [ 5c Ac Kd ]
Game ended: 2025/09/02 20:50:05 GMT
Seat 1: Elblop (small blind) folded before Flop
Seat 2: kanococo (big blind) folded on the Flop
Seat 3: HoldBabyHold folded before Flop (didn't bet)
Seat 4: SarkastikBS folded before Flop (didn't bet)
Seat 5: otaldojamal collected (0.23)
Seat 6: LarryBerry217 folded before Flop (didn't bet)
Seat 7: crispzilla (button) folded on the Flop

CoinPoker Hand #291236774: Hold'em No Limit (0.01/0.02 ) 2025/09/02 20:50:07 GMT
Table 'NL ₮2 III' 7-max Seat #1 is the button
Seat 1: Elblop (1.99 in chips)
Seat 2: kanococo (1.21 in chips)
Seat 3: HoldBabyHold (2.28 in chips)
Seat 4: SarkastikBS (3.50 in chips)
Seat 5: otaldojamal (2.14 in chips)
Seat 6: LarryBerry217 (0.96 in chips)
Seat 7: crispzilla (2.13 in chips)
kanococo: posts small blind 0.01
HoldBabyHold: posts big blind 0.02
*** HOLE CARDS ***
Dealt to kanococo [Kh Th]
SarkastikBS: raises 0.02 to 0.04
otaldojamal: folds
LarryBerry217: folds
crispzilla: folds
Elblop: folds
kanococo: raises 0.06 to 0.10
HoldBabyHold: folds
SarkastikBS: calls 0.06
*** FLOP *** [8d Qs 5h]
kanococo: checks
SarkastikBS: checks
*** TURN *** [8d Qs 5h] [5c]
kanococo: bets 0.04
SarkastikBS: calls 0.04
*** RIVER *** [8d Qs 5h 5c] [3c]
kanococo: bets 0.14
SarkastikBS: folds
Uncalled bet (0.14) returned to kanococo
kanococo collected 0.28 from pot
kanococo: doesn't show hand
*** SUMMARY ***
Total pot 0.30 | Rake 0.02
Board [ 8d Qs 5h 5c 3c ]
Game ended: 2025/09/02 20:51:05 GMT
Seat 1: Elblop (button) folded before Flop (didn't bet)
Seat 2: kanococo (small blind) collected (0.28)
Seat 3: HoldBabyHold (big blind) folded before Flop
Seat 4: SarkastikBS folded on the River
Seat 5: otaldojamal folded before Flop (didn't bet)
Seat 6: LarryBerry217 folded before Flop (didn't bet)
Seat 7: crispzilla folded before Flop (didn't bet)

CoinPoker Hand #291237052: Hold'em No Limit (0.01/0.02 ) 2025/09/02 20:51:07 GMT
Table 'NL ₮2 III' 7-max Seat #2 is the button
Seat 1: Elblop (2.00 in chips)
Seat 2: kanococo (1.35 in chips)
Seat 3: HoldBabyHold (2.26 in chips)
Seat 4: SarkastikBS (3.36 in chips)
Seat 5: otaldojamal (2.14 in chips)
Seat 6: LarryBerry217 (0.96 in chips)
Seat 7: crispzilla (2.13 in chips)
HoldBabyHold: posts small blind 0.01
SarkastikBS: posts big blind 0.02
*** HOLE CARDS ***
Dealt to kanococo [5h 3h]
otaldojamal: folds
LarryBerry217: raises 0.04 to 0.06
crispzilla: folds
Elblop: folds
kanococo: folds
HoldBabyHold: folds
SarkastikBS: folds
LarryBerry217 collected 0.09 from pot
LarryBerry217: doesn't show hand
*** SUMMARY ***
Total pot 0.09 | Rake 0.00
Board [ ]
Game ended: 2025/09/02 20:51:36 GMT
Seat 1: Elblop folded before Flop (didn't bet)
Seat 2: kanococo (button) folded before Flop (didn't bet)
Seat 3: HoldBabyHold (small blind) folded before Flop
Seat 4: SarkastikBS (big blind) folded before Flop
Seat 5: otaldojamal folded before Flop (didn't bet)
Seat 6: LarryBerry217 collected (0.09)
Seat 7: crispzilla folded before Flop (didn't bet)

CoinPoker Hand #291237366: Hold'em No Limit (0.01/0.02 ) 2025/09/02 20:51:38 GMT
Table 'NL ₮2 III' 7-max Seat #3 is the button
Seat 1: Elblop (2.00 in chips)
Seat 2: kanococo (1.35 in chips)
Seat 3: HoldBabyHold (2.25 in chips)
Seat 4: SarkastikBS (3.34 in chips)
Seat 5: otaldojamal (2.14 in chips)
Seat 6: LarryBerry217 (0.99 in chips)
Seat 7: crispzilla (2.13 in chips)
SarkastikBS: posts small blind 0.01
otaldojamal: posts big blind 0.02
*** HOLE CARDS ***
Dealt to kanococo [5h As]
LarryBerry217: calls 0.02
crispzilla: folds
Elblop: folds
kanococo: raises 0.04 to 0.06
HoldBabyHold: folds
SarkastikBS: folds
otaldojamal: calls 0.04
LarryBerry217: calls 0.04
*** FLOP *** [Ad 7h Kd]
otaldojamal: checks
LarryBerry217: bets 0.93 and is all-in
kanococo: raises 1.29 and is all-in
otaldojamal: folds
Uncalled bet (0.36) returned to kanococo
*** TURN *** [Ad 7h Kd] [Qh]
*** RIVER *** [Ad 7h Kd Qh] [2h]
*** SHOW DOWN ***
kanococo: shows [5h As] (a pair of Aces)
LarryBerry217: shows [Ah 6h] (a flush, Ace high)
LarryBerry217 collected 1.95 from pot
*** SUMMARY ***
Total pot 2.05 | Rake 0.10
Board [ Ad 7h Kd Qh 2h ]
Game ended: 2025/09/02 20:52:53 GMT
Seat 1: Elblop folded before Flop (didn't bet)
Seat 2: kanococo showed [5h As]
Seat 3: HoldBabyHold (button) folded before Flop (didn't bet)
Seat 4: SarkastikBS (small blind) folded before Flop
Seat 5: otaldojamal (big blind) folded on the Flop
Seat 6: LarryBerry217 showed [Ah 6h] and won (1.95) with a flush, Ace high
Seat 7: crispzilla folded before Flop (didn't bet)

CoinPoker Hand #291237872: Hold'em No Limit (0.01/0.02 ) 2025/09/02 20:52:56 GMT
Table 'NL ₮2 III' 7-max Seat #4 is the button
Seat 1: Elblop (2.00 in chips)
Seat 2: kanococo (0.36 in chips)
Seat 3: HoldBabyHold (2.25 in chips)
Seat 4: SarkastikBS (3.33 in chips)
Seat 5: otaldojamal (2.08 in chips)
Seat 6: LarryBerry217 (1.95 in chips)
Seat 7: crispzilla (2.13 in chips)
otaldojamal: posts small blind 0.01
LarryBerry217: posts big blind 0.02
*** HOLE CARDS ***
Dealt to kanococo [4h Tc]
crispzilla: folds
Elblop: folds
kanococo: folds
HoldBabyHold: raises 0.03 to 0.05
SarkastikBS: folds
otaldojamal: folds
LarryBerry217: folds
HoldBabyHold collected 0.08 from pot
HoldBabyHold: doesn't show hand
*** SUMMARY ***
Total pot 0.08 | Rake 0.00
Board [ ]
Game ended: 2025/09/02 20:53:14 GMT
Seat 1: Elblop folded before Flop (didn't bet)
Seat 2: kanococo folded before Flop (didn't bet)
Seat 3: HoldBabyHold collected (0.08)
Seat 4: SarkastikBS (button) folded before Flop (didn't bet)
Seat 5: otaldojamal (small blind) folded before Flop
Seat 6: LarryBerry217 (big blind) folded before Flop
Seat 7: crispzilla folded before Flop (didn't bet)

CoinPoker Hand #291238016: Hold'em No Limit (0.01/0.02 ) 2025/09/02 20:53:17 GMT
Table 'NL ₮2 III' 7-max Seat #5 is the button
Seat 1: Elblop (2.00 in chips)
Seat 2: kanococo (0.36 in chips)
Seat 3: HoldBabyHold (2.28 in chips)
Seat 4: SarkastikBS (3.33 in chips)
Seat 5: otaldojamal (2.07 in chips)
Seat 6: LarryBerry217 (1.93 in chips)
Seat 7: crispzilla (2.13 in chips)
LarryBerry217: posts small blind 0.01
crispzilla: didn't post big blind
Elblop: posts big blind 0.02
*** HOLE CARDS ***
Dealt to kanococo [Kd Qh]
kanococo: raises 0.36 and is all-in
HoldBabyHold: folds
SarkastikBS: folds
otaldojamal: folds
LarryBerry217: folds
Elblop: folds
kanococo collected 0.39 from pot
kanococo: doesn't show hand
*** SUMMARY ***
Total pot 0.39 | Rake 0.00
Board [ ]
Game ended: 2025/09/02 20:53:42 GMT
Seat 1: Elblop (big blind) folded before Flop
Seat 2: kanococo collected (0.39)
Seat 3: HoldBabyHold folded before Flop (didn't bet)
Seat 4: SarkastikBS folded before Flop (didn't bet)
Seat 5: otaldojamal (button) folded before Flop (didn't bet)
Seat 6: LarryBerry217 (small blind) folded before Flop
Seat 7: crispzilla folded before Flop (didn't bet)

CoinPoker Hand #291238112: Hold'em No Limit (0.01/0.02 ) 2025/09/02 20:53:31 GMT
Table 'NL ₮2 I' 7-max Seat #1 is the button
Seat 1: Anonkontello (2.27 in chips)
Seat 2: Aceinthehole (2.98 in chips) out of hand
Seat 3: vicmitch (4.30 in chips)
Seat 4: MarditZion (1.95 in chips)
Seat 5: kanococo (2.00 in chips)
Seat 6: otaldojamal (2.00 in chips)
Seat 7: pash0420 (1.34 in chips)
vicmitch: posts small blind 0.01
MarditZion: posts big blind 0.02
kanococo: posts big blind 0.02
pash0420: posts big blind 0.02
*** HOLE CARDS ***
Dealt to kanococo [4d 7d]
kanococo: checks
otaldojamal: raises 0.09 to 0.11
pash0420: raises 0.11 to 0.22
Anonkontello: calls 0.22
vicmitch has timed out
vicmitch activated time-bank (26 seconds)
vicmitch: folds
MarditZion: folds
kanococo: folds
otaldojamal: calls 0.11
*** FLOP *** [6c 5s Qh]
otaldojamal: checks
pash0420: bets 0.23
Anonkontello: folds
otaldojamal: folds
Uncalled bet (0.23) returned to pash0420
pash0420 collected 0.67 from pot
pash0420: doesn't show hand
*** SUMMARY ***
Total pot 0.71 | Rake 0.04
Board [ 6c 5s Qh ]
Game ended: 2025/09/02 20:54:57 GMT
Seat 1: Anonkontello (button) folded on the Flop
Seat 2: Aceinthehole folded before Flop (didn't bet)
Seat 3: vicmitch (small blind) folded before Flop
Seat 4: MarditZion (big blind) folded before Flop
Seat 5: kanococo folded before Flop
Seat 6: otaldojamal folded on the Flop
Seat 7: pash0420 collected (0.67)

CoinPoker Hand #291238298: Hold'em No Limit (0.01/0.02 ) 2025/09/02 20:53:44 GMT
Table 'NL ₮2 III' 7-max Seat #6 is the button
Seat 1: Elblop (2.00 in chips)
Seat 2: kanococo (0.39 in chips)
Seat 3: HoldBabyHold (2.28 in chips)
Seat 4: SarkastikBS (3.33 in chips)
Seat 5: otaldojamal (2.07 in chips)
Seat 6: LarryBerry217 (1.92 in chips)
Seat 7: crispzilla (2.13 in chips) is sitting out
Elblop: posts small blind 0.01
kanococo: posts big blind 0.02
*** HOLE CARDS ***
Dealt to kanococo [Qc Tc]
HoldBabyHold: folds
SarkastikBS has timed out
SarkastikBS activated time-bank (50 seconds)
SarkastikBS: folds
otaldojamal: folds
LarryBerry217: calls 0.02
Elblop: calls 0.01
kanococo: raises 0.08 to 0.10
LarryBerry217: calls 0.08
Elblop: folds
*** FLOP *** [3c 2d 3d]
kanococo: bets 0.29 and is all-in
LarryBerry217 has timed out
LarryBerry217 activated time-bank (60 seconds)
LarryBerry217: calls 0.29
*** TURN *** [3c 2d 3d] [3s]
*** RIVER *** [3c 2d 3d 3s] [Js]
*** SHOW DOWN ***
kanococo: shows [Qc Tc] (three of kind, Threes)
LarryBerry217: shows [As 7h] (three of kind, Threes)
LarryBerry217 collected 0.76 from pot
*** SUMMARY ***
Total pot 0.80 | Rake 0.04
Board [ 3c 2d 3d 3s Js ]
Game ended: 2025/09/02 20:55:00 GMT
Seat 1: Elblop (small blind) folded before Flop
Seat 2: kanococo (big blind) showed [Qc Tc]
Seat 3: HoldBabyHold folded before Flop (didn't bet)
Seat 4: SarkastikBS folded before Flop (didn't bet)
Seat 5: otaldojamal folded before Flop (didn't bet)
Seat 6: LarryBerry217 (button) showed [As 7h] and won (0.76) with three of kind, Threes
Seat 7: crispzilla folded before Flop (didn't bet)

CoinPoker Hand #291238776: Hold'em No Limit (0.01/0.02 ) 2025/09/02 20:54:59 GMT
Table 'NL ₮2 I' 7-max Seat #3 is the button
Seat 1: Anonkontello (2.05 in chips)
Seat 2: Aceinthehole (2.98 in chips) out of hand
Seat 3: vicmitch (4.29 in chips)
Seat 4: MarditZion (1.93 in chips)
Seat 5: kanococo (1.98 in chips)
Seat 6: otaldojamal (2.00 in chips)
Seat 7: pash0420 (1.79 in chips)
MarditZion: posts small blind 0.01
kanococo: posts big blind 0.02
*** HOLE CARDS ***
Dealt to kanococo [Kh Jd]
otaldojamal: raises 0.03 to 0.05
pash0420: raises 0.05 to 0.10
Anonkontello: calls 0.10
vicmitch: folds
MarditZion: folds
kanococo: calls 0.08
otaldojamal: calls 0.05
*** FLOP *** [5h 9c 7s]
kanococo: checks
otaldojamal has timed out
otaldojamal activated time-bank (41 seconds)
otaldojamal: bets 0.19
pash0420: folds
Anonkontello: folds
kanococo: folds
Uncalled bet (0.19) returned to otaldojamal
otaldojamal collected 0.39 from pot
otaldojamal: doesn't show hand
*** SUMMARY ***
Total pot 0.41 | Rake 0.02
Board [ 5h 9c 7s ]
Game ended: 2025/09/02 20:56:23 GMT
Seat 1: Anonkontello folded on the Flop
Seat 2: Aceinthehole folded before Flop (didn't bet)
Seat 3: vicmitch (button) folded before Flop (didn't bet)
Seat 4: MarditZion (small blind) folded before Flop
Seat 5: kanococo (big blind) folded on the Flop
Seat 6: otaldojamal collected (0.39)
Seat 7: pash0420 folded on the Flop

CoinPoker Hand #291239391: Hold'em No Limit (0.01/0.02 ) 2025/09/02 20:56:25 GMT
Table 'NL ₮2 I' 7-max Seat #4 is the button
Seat 1: Anonkontello (2.00 in chips)
Seat 2: Aceinthehole (2.98 in chips) out of hand
Seat 3: vicmitch (4.29 in chips)
Seat 4: MarditZion (1.92 in chips)
Seat 5: kanococo (1.88 in chips)
Seat 6: otaldojamal (2.29 in chips)
Seat 7: pash0420 (1.69 in chips)
kanococo: posts small blind 0.01
otaldojamal: posts big blind 0.02
*** HOLE CARDS ***
Dealt to kanococo [9d 8s]
pash0420: raises 0.02 to 0.04
Anonkontello: calls 0.04
vicmitch: folds
MarditZion: folds
kanococo: folds
otaldojamal: folds
*** FLOP *** [4s 3h 2s]
pash0420: bets 0.11
Anonkontello: calls 0.11
*** TURN *** [4s 3h 2s] [Ad]
pash0420: bets 0.16
Anonkontello: raises 0.34 to 0.50
pash0420: calls 0.34
*** RIVER *** [4s 3h 2s Ad] [Jc]
pash0420: checks
Anonkontello: bets 1.35 and is all-in
pash0420: folds
Uncalled bet (1.35) returned to Anonkontello
Anonkontello collected 1.26 from pot
Anonkontello: doesn't show hand
*** SUMMARY ***
Total pot 1.33 | Rake 0.07
Board [ 4s 3h 2s Ad Jc ]
Game ended: 2025/09/02 20:57:33 GMT
Seat 1: Anonkontello collected (1.26)
Seat 2: Aceinthehole folded before Flop (didn't bet)
Seat 3: vicmitch folded before Flop (didn't bet)
Seat 4: MarditZion (button) folded before Flop (didn't bet)
Seat 5: kanococo (small blind) folded before Flop
Seat 6: otaldojamal (big blind) folded before Flop
Seat 7: pash0420 folded on the River

CoinPoker Hand #291239604: Hold'em No Limit (0.01/0.02 ) 2025/09/02 20:57:35 GMT
Table 'NL ₮2 I' 7-max Seat #5 is the button
Seat 1: Anonkontello (2.61 in chips)
Seat 2: Aceinthehole (2.98 in chips) out of hand
Seat 3: vicmitch (4.29 in chips)
Seat 4: MarditZion (1.92 in chips)
Seat 5: kanococo (1.87 in chips)
Seat 6: otaldojamal (2.27 in chips)
Seat 7: pash0420 (1.04 in chips)
otaldojamal: posts small blind 0.01
pash0420: posts big blind 0.02
*** HOLE CARDS ***
Dealt to kanococo [As 5d]
Anonkontello: raises 0.03 to 0.05
vicmitch: calls 0.05
MarditZion: folds
kanococo: folds
otaldojamal: folds
pash0420: raises 0.25 to 0.30
Anonkontello: raises 2.56 and is all-in
vicmitch: folds
pash0420: calls 0.74 and is all-in
Uncalled bet (1.57) returned to Anonkontello
*** FLOP *** [4d Th Jd]
*** TURN *** [4d Th Jd] [3s]
*** RIVER *** [4d Th Jd 3s] [Tc]
*** SHOW DOWN ***
Anonkontello: shows [Qd Ad] (a pair of Tens)
pash0420: shows [8s 9d] (a pair of Tens)
Anonkontello collected 2.03 from pot
*** SUMMARY ***
Total pot 2.14 | Rake 0.11
Board [ 4d Th Jd 3s Tc ]
Game ended: 2025/09/02 20:58:28 GMT
Seat 1: Anonkontello showed [Qd Ad] and won (2.03) with a pair of Tens
Seat 2: Aceinthehole folded before Flop (didn't bet)
Seat 3: vicmitch folded before Flop
Seat 4: MarditZion folded before Flop (didn't bet)
Seat 5: kanococo (button) folded before Flop (didn't bet)
Seat 6: otaldojamal (small blind) folded before Flop
Seat 7: pash0420 (big blind) showed [8s 9d]

CoinPoker Hand #291239814: Hold'em No Limit (0.01/0.02 ) 2025/09/02 20:58:31 GMT
Table 'NL ₮2 I' 7-max Seat #6 is the button
Seat 1: Anonkontello (3.60 in chips)
Seat 2: Aceinthehole (2.98 in chips) out of hand
Seat 3: vicmitch (4.24 in chips)
Seat 4: MarditZion (1.92 in chips)
Seat 5: kanococo (1.87 in chips)
Seat 6: otaldojamal (2.26 in chips)
Anonkontello: posts big blind 0.02
*** HOLE CARDS ***
Dealt to kanococo [Kh 6d]
vicmitch: folds
MarditZion: raises 0.04 to 0.06
kanococo: folds
otaldojamal: folds
Anonkontello: calls 0.04
*** FLOP *** [Kc Jh 5d]
Anonkontello: checks
MarditZion: bets 0.05
Anonkontello: folds
Uncalled bet (0.05) returned to MarditZion
MarditZion collected 0.11 from pot
MarditZion: doesn't show hand
*** SUMMARY ***
Total pot 0.12 | Rake 0.01
Board [ Kc Jh 5d ]
Game ended: 2025/09/02 20:59:11 GMT
Seat 1: Anonkontello (big blind) folded on the Flop
Seat 2: Aceinthehole folded before Flop (didn't bet)
Seat 3: vicmitch folded before Flop (didn't bet)
Seat 4: MarditZion collected (0.11)
Seat 5: kanococo folded before Flop (didn't bet)
Seat 6: otaldojamal (button) folded before Flop (didn't bet)

CoinPoker Hand #291239936: Hold'em No Limit (0.01/0.02 ) 2025/09/02 20:59:13 GMT
Table 'NL ₮2 I' 7-max Seat #7 is the button
Seat 1: Anonkontello (3.54 in chips)
Seat 2: Aceinthehole (2.98 in chips)
Seat 3: vicmitch (4.24 in chips)
Seat 4: MarditZion (1.97 in chips)
Seat 5: kanococo (1.87 in chips)
Seat 6: otaldojamal (2.26 in chips)
Seat 7: G3TR3KTF1SH (2.00 in chips)
Anonkontello: posts small blind 0.01
Aceinthehole: posts big blind 0.02
G3TR3KTF1SH: posts big blind 0.02
*** HOLE CARDS ***
Dealt to kanococo [6c 5h]
vicmitch: folds
MarditZion: folds
kanococo: folds
otaldojamal: folds
G3TR3KTF1SH: checks
Anonkontello: raises 0.10 to 0.12
Aceinthehole: calls 0.10
G3TR3KTF1SH: folds
*** FLOP *** [Jd 2s 3d]
Anonkontello: checks
Aceinthehole: checks
*** TURN *** [Jd 2s 3d] [5c]
Anonkontello: bets 0.06
Aceinthehole: calls 0.06
*** RIVER *** [Jd 2s 3d 5c] [Kc]
Anonkontello: bets 0.54
Aceinthehole: folds
Uncalled bet (0.54) returned to Anonkontello
Anonkontello collected 0.36 from pot
Anonkontello: doesn't show hand
*** SUMMARY ***
Total pot 0.38 | Rake 0.02
Board [ Jd 2s 3d 5c Kc ]
Game ended: 2025/09/02 21:00:51 GMT
Seat 1: Anonkontello (small blind) collected (0.36)
Seat 2: Aceinthehole (big blind) folded on the River
Seat 3: vicmitch folded before Flop (didn't bet)
Seat 4: MarditZion folded before Flop (didn't bet)
Seat 5: kanococo folded before Flop (didn't bet)
Seat 6: otaldojamal folded before Flop (didn't bet)
Seat 7: G3TR3KTF1SH (button) folded before Flop

CoinPoker Hand #291240252: Hold'em No Limit (0.01/0.02 ) 2025/09/02 21:00:53 GMT
Table 'NL ₮2 I' 7-max Seat #1 is the button
Seat 1: Anonkontello (3.72 in chips)
Seat 2: Aceinthehole (2.80 in chips)
Seat 3: vicmitch (4.24 in chips)
Seat 4: MarditZion (1.97 in chips)
Seat 5: kanococo (1.87 in chips)
Seat 6: otaldojamal (2.26 in chips)
Seat 7: G3TR3KTF1SH (2.00 in chips)
Aceinthehole: posts small blind 0.01
vicmitch: posts big blind 0.02
*** HOLE CARDS ***
Dealt to kanococo [5s 2d]
MarditZion: folds
kanococo: folds
otaldojamal: folds
G3TR3KTF1SH: folds
Anonkontello: raises 0.04 to 0.06
Aceinthehole: folds
vicmitch: calls 0.04
*** FLOP *** [5d 3d Kd]
vicmitch: checks
Anonkontello has timed out
Anonkontello activated time-bank (60 seconds)
Anonkontello: checks
*** TURN *** [5d 3d Kd] [Tc]
vicmitch: bets 0.12
Anonkontello: folds
Uncalled bet (0.12) returned to vicmitch
vicmitch collected 0.12 from pot
vicmitch: doesn't show hand
*** SUMMARY ***
Total pot 0.13 | Rake 0.01
Board [ 5d 3d Kd Tc ]
Game ended: 2025/09/02 21:01:55 GMT
Seat 1: Anonkontello (button) folded on the Turn
Seat 2: Aceinthehole (small blind) folded before Flop
Seat 3: vicmitch (big blind) collected (0.12)
Seat 4: MarditZion folded before Flop (didn't bet)
Seat 5: kanococo folded before Flop (didn't bet)
Seat 6: otaldojamal folded before Flop (didn't bet)
Seat 7: G3TR3KTF1SH folded before Flop (didn't bet)

CoinPoker Hand #291240514: Hold'em No Limit (0.01/0.02 ) 2025/09/02 21:01:58 GMT
Table 'NL ₮2 I' 7-max Seat #2 is the button
Seat 1: Anonkontello (3.66 in chips)
Seat 2: Aceinthehole (2.79 in chips)
Seat 3: vicmitch (4.30 in chips)
Seat 4: MarditZion (1.97 in chips)
Seat 5: kanococo (1.87 in chips)
Seat 6: otaldojamal (2.26 in chips)
Seat 7: G3TR3KTF1SH (2.00 in chips)
vicmitch: posts small blind 0.01
MarditZion: posts big blind 0.02
*** HOLE CARDS ***
Dealt to kanococo [4c Js]
kanococo: folds
otaldojamal: folds
G3TR3KTF1SH: raises 0.03 to 0.05
Anonkontello: raises 0.13 to 0.18
Aceinthehole: folds
vicmitch: folds
MarditZion: folds
G3TR3KTF1SH: folds
Anonkontello collected 0.26 from pot
Anonkontello: doesn't show hand
*** SUMMARY ***
Total pot 0.26 | Rake 0.00
Board [ ]
Game ended: 2025/09/02 21:02:32 GMT
Seat 1: Anonkontello collected (0.26)
Seat 2: Aceinthehole (button) folded before Flop (didn't bet)
Seat 3: vicmitch (small blind) folded before Flop
Seat 4: MarditZion (big blind) folded before Flop
Seat 5: kanococo folded before Flop (didn't bet)
Seat 6: otaldojamal folded before Flop (didn't bet)
Seat 7: G3TR3KTF1SH folded before Flop

CoinPoker Hand #291240658: Hold'em No Limit (0.01/0.02 ) 2025/09/02 21:02:35 GMT
Table 'NL ₮2 I' 7-max Seat #3 is the button
Seat 1: Anonkontello (3.74 in chips) is sitting out
Seat 2: Aceinthehole (2.79 in chips)
Seat 3: vicmitch (4.29 in chips)
Seat 4: MarditZion (1.95 in chips)
Seat 5: kanococo (1.87 in chips)
Seat 6: otaldojamal (2.26 in chips)
Seat 7: G3TR3KTF1SH (2.00 in chips)
MarditZion: posts small blind 0.01
kanococo: posts big blind 0.02
*** HOLE CARDS ***
Dealt to kanococo [3c Td]
otaldojamal: folds
G3TR3KTF1SH: folds
Dtappp is disconnected
Aceinthehole: raises 0.04 to 0.06
Dtappp has reconnected
vicmitch: calls 0.06
MarditZion: folds
kanococo: folds
*** FLOP *** [3s 9d 8d]
Aceinthehole: bets 0.09
vicmitch: calls 0.09
*** TURN *** [3s 9d 8d] [5h]
Aceinthehole: checks
vicmitch: checks
*** RIVER *** [3s 9d 8d 5h] [8c]
Aceinthehole: bets 0.02
vicmitch: folds
Uncalled bet (0.02) returned to Aceinthehole
Aceinthehole collected 0.31 from pot
Aceinthehole: doesn't show hand
*** SUMMARY ***
Total pot 0.33 | Rake 0.02
Board [ 3s 9d 8d 5h 8c ]
Game ended: 2025/09/02 21:03:48 GMT
Seat 1: Anonkontello folded before Flop (didn't bet)
Seat 2: Aceinthehole collected (0.31)
Seat 3: vicmitch (button) folded on the River
Seat 4: MarditZion (small blind) folded before Flop
Seat 5: kanococo (big blind) folded before Flop
Seat 6: otaldojamal folded before Flop (didn't bet)
Seat 7: G3TR3KTF1SH folded before Flop (didn't bet)

CoinPoker Hand #291241167: Hold'em No Limit (0.01/0.02 ) 2025/09/02 21:03:50 GMT
Table 'NL ₮2 I' 7-max Seat #4 is the button
Seat 1: Dtappp (2.00 in chips)
Seat 2: Aceinthehole (2.95 in chips)
Seat 3: vicmitch (4.14 in chips)
Seat 4: MarditZion (1.94 in chips)
Seat 5: kanococo (1.85 in chips)
Seat 6: otaldojamal (2.26 in chips)
Seat 7: G3TR3KTF1SH (2.00 in chips)
kanococo: posts small blind 0.01
otaldojamal: posts big blind 0.02
Dtappp: posts big blind 0.02
*** HOLE CARDS ***
Dealt to kanococo [Js Td]
G3TR3KTF1SH: raises 0.03 to 0.05
Dtappp: folds
Aceinthehole: folds
vicmitch: folds
MarditZion: folds
kanococo: calls 0.04
otaldojamal: raises 0.17 to 0.22
G3TR3KTF1SH: calls 0.17
kanococo: folds
*** FLOP *** [3s 7h Ac]
otaldojamal: checks
G3TR3KTF1SH: checks
*** TURN *** [3s 7h Ac] [Jc]
otaldojamal: bets 0.24
G3TR3KTF1SH: raises 0.48 to 0.72
otaldojamal: raises 1.80 and is all-in
G3TR3KTF1SH: folds
Uncalled bet (1.32) returned to otaldojamal
otaldojamal collected 1.92 from pot
otaldojamal: doesn't show hand
*** SUMMARY ***
Total pot 1.95 | Rake 0.03
Board [ 3s 7h Ac Jc ]
Game ended: 2025/09/02 21:05:06 GMT
Seat 1: Dtappp folded before Flop
Seat 2: Aceinthehole folded before Flop (didn't bet)
Seat 3: vicmitch folded before Flop (didn't bet)
Seat 4: MarditZion (button) folded before Flop (didn't bet)
Seat 5: kanococo (small blind) folded before Flop
Seat 6: otaldojamal (big blind) collected (1.92)
Seat 7: G3TR3KTF1SH folded on the Turn

CoinPoker Hand #291241832: Hold'em No Limit (0.01/0.02 ) 2025/09/02 21:05:10 GMT
Table 'NL ₮2 I' 7-max Seat #5 is the button
Seat 1: Dtappp (1.98 in chips)
Seat 2: Aceinthehole (2.95 in chips)
Seat 3: vicmitch (4.14 in chips)
Seat 4: MarditZion (1.94 in chips)
Seat 5: kanococo (1.80 in chips)
Seat 6: otaldojamal (3.24 in chips)
Seat 7: G3TR3KTF1SH (2.00 in chips)
otaldojamal: posts small blind 0.01
G3TR3KTF1SH: posts big blind 0.02
*** HOLE CARDS ***
Dealt to kanococo [Kd Js]
Dtappp: folds
Aceinthehole: folds
kanococo is disconnected
kanococo has reconnected
vicmitch: folds
MarditZion: folds
kanococo: raises 0.06 to 0.08
otaldojamal: folds
G3TR3KTF1SH: folds
kanococo collected 0.11 from pot
kanococo: doesn't show hand
*** SUMMARY ***
Total pot 0.11 | Rake 0.00
Board [ ]
Game ended: 2025/09/02 21:05:44 GMT
Seat 1: Dtappp folded before Flop (didn't bet)
Seat 2: Aceinthehole folded before Flop (didn't bet)
Seat 3: vicmitch folded before Flop (didn't bet)
Seat 4: MarditZion folded before Flop (didn't bet)
Seat 5: kanococo (button) collected (0.11)
Seat 6: otaldojamal (small blind) folded before Flop
Seat 7: G3TR3KTF1SH (big blind) folded before Flop

CoinPoker Hand #291242083: Hold'em No Limit (0.01/0.02 ) 2025/09/02 21:05:46 GMT
Table 'NL ₮2 I' 7-max Seat #6 is the button
Seat 1: Dtappp (2.00 in chips)
Seat 2: Aceinthehole (2.95 in chips)
Seat 3: vicmitch (4.14 in chips)
Seat 4: MarditZion (1.94 in chips)
Seat 5: kanococo (1.83 in chips)
Seat 6: otaldojamal (3.23 in chips)
Seat 7: G3TR3KTF1SH (2.00 in chips)
G3TR3KTF1SH: posts small blind 0.01
Dtappp: posts big blind 0.02
*** HOLE CARDS ***
Dealt to kanococo [Ks 2c]
Aceinthehole: folds
vicmitch: calls 0.02
MarditZion: folds
kanococo: folds
otaldojamal has timed out
otaldojamal activated time-bank (40 seconds)
otaldojamal: raises 0.06 to 0.08
G3TR3KTF1SH: folds
Dtappp: folds
vicmitch: calls 0.06
*** FLOP *** [4s 3d 8h]
vicmitch: checks
otaldojamal: bets 0.05
vicmitch: calls 0.05
*** TURN *** [4s 3d 8h] [3h]
vicmitch: checks
otaldojamal: checks
*** RIVER *** [4s 3d 8h 3h] [Kd]
vicmitch: checks
otaldojamal: bets 0.28
vicmitch: folds
Uncalled bet (0.28) returned to otaldojamal
otaldojamal collected 0.28 from pot
otaldojamal: doesn't show hand
*** SUMMARY ***
Total pot 0.29 | Rake 0.01
Board [ 4s 3d 8h 3h Kd ]
Game ended: 2025/09/02 21:07:36 GMT
Seat 1: Dtappp (big blind) folded before Flop
Seat 2: Aceinthehole folded before Flop (didn't bet)
Seat 3: vicmitch folded on the River
Seat 4: MarditZion folded before Flop (didn't bet)
Seat 5: kanococo folded before Flop (didn't bet)
Seat 6: otaldojamal (button) collected (0.28)
Seat 7: G3TR3KTF1SH (small blind) folded before Flop

CoinPoker Hand #291243010: Hold'em No Limit (0.01/0.02 ) 2025/09/02 21:07:38 GMT
Table 'NL ₮2 I' 7-max Seat #7 is the button
Seat 1: SQuest (2.00 in chips)
Seat 2: Aceinthehole (2.95 in chips)
Seat 3: vicmitch (4.01 in chips)
Seat 4: MarditZion (1.94 in chips)
Seat 5: kanococo (1.83 in chips)
Seat 6: otaldojamal (3.38 in chips)
Seat 7: G3TR3KTF1SH (1.99 in chips)
SQuest: posts small blind 0.01
Aceinthehole: didn't post big blind
vicmitch: posts big blind 0.02
*** HOLE CARDS ***
Dealt to kanococo [7h Qc]
MarditZion: folds
kanococo: raises 0.04 to 0.06
otaldojamal: folds
G3TR3KTF1SH: calls 0.06
SQuest: folds
vicmitch: folds
*** FLOP *** [4c Kh 9d]
kanococo: checks
G3TR3KTF1SH: checks
*** TURN *** [4c Kh 9d] [9c]
kanococo: bets 0.07
G3TR3KTF1SH: calls 0.07
*** RIVER *** [4c Kh 9d 9c] [Jd]
kanococo: bets 0.14
G3TR3KTF1SH: folds
Uncalled bet (0.14) returned to kanococo
kanococo collected 0.28 from pot
kanococo: doesn't show hand
*** SUMMARY ***
Total pot 0.29 | Rake 0.01
Board [ 4c Kh 9d 9c Jd ]
Game ended: 2025/09/02 21:08:38 GMT
Seat 1: SQuest (small blind) folded before Flop
Seat 2: Aceinthehole folded before Flop (didn't bet)
Seat 3: vicmitch (big blind) folded before Flop
Seat 4: MarditZion folded before Flop (didn't bet)
Seat 5: kanococo collected (0.28)
Seat 6: otaldojamal folded before Flop (didn't bet)
Seat 7: G3TR3KTF1SH (button) folded on the River

CoinPoker Hand #291243497: Hold'em No Limit (0.01/0.02 ) 2025/09/02 21:08:40 GMT
Table 'NL ₮2 I' 7-max Seat #1 is the button
Seat 1: SQuest (1.99 in chips)
Seat 2: Aceinthehole (2.95 in chips) is sitting out
Seat 3: vicmitch (3.99 in chips)
Seat 4: MarditZion (1.94 in chips)
Seat 5: kanococo (1.98 in chips)
Seat 6: otaldojamal (3.38 in chips)
Seat 7: G3TR3KTF1SH (2.00 in chips)
vicmitch: posts small blind 0.01
MarditZion: posts big blind 0.02
*** HOLE CARDS ***
Dealt to kanococo [Jc 7h]
kanococo: folds
otaldojamal: folds
G3TR3KTF1SH: folds
SQuest: raises 0.04 to 0.06
vicmitch: folds
MarditZion: folds
SQuest collected 0.09 from pot
SQuest: doesn't show hand
*** SUMMARY ***
Total pot 0.09 | Rake 0.00
Board [ ]
Game ended: 2025/09/02 21:09:12 GMT
Seat 1: SQuest (button) collected (0.09)
Seat 2: Aceinthehole folded before Flop (didn't bet)
Seat 3: vicmitch (small blind) folded before Flop
Seat 4: MarditZion (big blind) folded before Flop
Seat 5: kanococo folded before Flop (didn't bet)
Seat 6: otaldojamal folded before Flop (didn't bet)
Seat 7: G3TR3KTF1SH folded before Flop (didn't bet)

CoinPoker Hand #291243790: Hold'em No Limit (0.01/0.02 ) 2025/09/02 21:09:14 GMT
Table 'NL ₮2 I' 7-max Seat #3 is the button
Seat 1: SQuest (2.02 in chips)
Seat 2: Aceinthehole (2.95 in chips) is sitting out
Seat 3: vicmitch (3.98 in chips)
Seat 4: MarditZion (1.92 in chips)
Seat 5: kanococo (1.98 in chips)
Seat 6: otaldojamal (3.38 in chips)
Seat 7: G3TR3KTF1SH (2.00 in chips)
MarditZion: posts small blind 0.01
kanococo: posts big blind 0.02
*** HOLE CARDS ***
Dealt to kanococo [Jc Kc]
otaldojamal: folds
G3TR3KTF1SH: folds
SQuest: folds
vicmitch: folds
MarditZion: folds
kanococo collected 0.03 from pot
kanococo: doesn't show hand
*** SUMMARY ***
Total pot 0.03 | Rake 0.00
Board [ ]
Game ended: 2025/09/02 21:09:45 GMT
Seat 1: SQuest folded before Flop (didn't bet)
Seat 2: Aceinthehole folded before Flop (didn't bet)
Seat 3: vicmitch (button) folded before Flop (didn't bet)
Seat 4: MarditZion (small blind) folded before Flop
Seat 5: kanococo (big blind) collected (0.03)
Seat 6: otaldojamal folded before Flop (didn't bet)
Seat 7: G3TR3KTF1SH folded before Flop (didn't bet)

CoinPoker Hand #291244089: Hold'em No Limit (0.01/0.02 ) 2025/09/02 21:09:48 GMT
Table 'NL ₮2 I' 7-max Seat #4 is the button
Seat 1: SQuest (2.02 in chips)
Seat 2: Aceinthehole (2.95 in chips) is sitting out
Seat 3: vicmitch (3.98 in chips)
Seat 4: MarditZion (1.91 in chips)
Seat 5: kanococo (1.99 in chips)
Seat 6: otaldojamal (3.38 in chips)
Seat 7: G3TR3KTF1SH (2.00 in chips)
kanococo: posts small blind 0.01
otaldojamal: posts big blind 0.02
*** HOLE CARDS ***
Dealt to kanococo [Ts 7s]
G3TR3KTF1SH: folds
SQuest: folds
vicmitch: folds
MarditZion: folds
kanococo: raises 0.02 to 0.04
otaldojamal: calls 0.02
*** FLOP *** [3c Jd Kd]
kanococo: checks
otaldojamal: bets 0.02
kanococo: calls 0.02
*** TURN *** [3c Jd Kd] [Qs]
kanococo: checks
otaldojamal: bets 0.05
kanococo: folds
Uncalled bet (0.05) returned to otaldojamal
otaldojamal collected 0.11 from pot
otaldojamal: doesn't show hand
*** SUMMARY ***
Total pot 0.12 | Rake 0.01
Board [ 3c Jd Kd Qs ]
Game ended: 2025/09/02 21:10:47 GMT
Seat 1: SQuest folded before Flop (didn't bet)
Seat 2: Aceinthehole folded before Flop (didn't bet)
Seat 3: vicmitch folded before Flop (didn't bet)
Seat 4: MarditZion (button) folded before Flop (didn't bet)
Seat 5: kanococo (small blind) folded on the Turn
Seat 6: otaldojamal (big blind) collected (0.11)
Seat 7: G3TR3KTF1SH folded before Flop (didn't bet)

CoinPoker Hand #291244521: Hold'em No Limit (0.01/0.02 ) 2025/09/02 21:10:50 GMT
Table 'NL ₮2 I' 7-max Seat #5 is the button
Seat 1: SQuest (2.02 in chips)
Seat 2: Aceinthehole (2.95 in chips) is sitting out
Seat 3: vicmitch (3.98 in chips)
Seat 4: MarditZion (1.91 in chips)
Seat 5: kanococo (1.93 in chips)
Seat 6: otaldojamal (3.43 in chips)
Seat 7: G3TR3KTF1SH (2.00 in chips)
otaldojamal: posts small blind 0.01
G3TR3KTF1SH: posts big blind 0.02
*** HOLE CARDS ***
Dealt to kanococo [Jd Ac]
SQuest: folds
vicmitch: folds
MarditZion: raises 0.04 to 0.06
kanococo: raises 0.06 to 0.12
otaldojamal: folds
G3TR3KTF1SH: folds
MarditZion: calls 0.06
*** FLOP *** [Ks 5h 5d]
MarditZion: checks
kanococo: bets 0.06
MarditZion: calls 0.06
*** TURN *** [Ks 5h 5d] [6c]
MarditZion: checks
kanococo: checks
*** RIVER *** [Ks 5h 5d 6c] [3d]
MarditZion: checks
kanococo: bets 0.10
MarditZion: calls 0.10
*** SHOW DOWN ***
kanococo: shows [Jd Ac] (a pair of Fives)
MarditZion: shows [9c 9s] (two pairs, Nines and Fives)
MarditZion collected 0.56 from pot
*** SUMMARY ***
Total pot 0.59 | Rake 0.03
Board [ Ks 5h 5d 6c 3d ]
Game ended: 2025/09/02 21:12:21 GMT
Seat 1: SQuest folded before Flop (didn't bet)
Seat 2: Aceinthehole folded before Flop (didn't bet)
Seat 3: vicmitch folded before Flop (didn't bet)
Seat 4: MarditZion showed [9c 9s] and won (0.56) with two pairs, Nines and Fives
Seat 5: kanococo (button) showed [Jd Ac]
Seat 6: otaldojamal (small blind) folded before Flop
Seat 7: G3TR3KTF1SH (big blind) folded before Flop

CoinPoker Hand #291245147: Hold'em No Limit (0.01/0.02 ) 2025/09/02 21:12:23 GMT
Table 'NL ₮2 I' 7-max Seat #6 is the button
Seat 1: SQuest (2.02 in chips)
Seat 2: Aceinthehole (2.95 in chips) is sitting out
Seat 3: vicmitch (3.98 in chips)
Seat 4: MarditZion (2.19 in chips)
Seat 5: kanococo (1.65 in chips)
Seat 6: otaldojamal (3.42 in chips)
Seat 7: G3TR3KTF1SH (1.98 in chips)
G3TR3KTF1SH: posts small blind 0.01
SQuest: posts big blind 0.02
*** HOLE CARDS ***
Dealt to kanococo [Qd 4h]
vicmitch: folds
MarditZion: folds
kanococo: folds
otaldojamal: folds
G3TR3KTF1SH: raises 0.04 to 0.06
SQuest: folds
G3TR3KTF1SH collected 0.08 from pot
G3TR3KTF1SH: doesn't show hand
*** SUMMARY ***
Total pot 0.08 | Rake 0.00
Board [ ]
Game ended: 2025/09/02 21:12:46 GMT
Seat 1: SQuest (big blind) folded before Flop
Seat 2: Aceinthehole folded before Flop (didn't bet)
Seat 3: vicmitch folded before Flop (didn't bet)
Seat 4: MarditZion folded before Flop (didn't bet)
Seat 5: kanococo folded before Flop (didn't bet)
Seat 6: otaldojamal (button) folded before Flop (didn't bet)
Seat 7: G3TR3KTF1SH (small blind) collected (0.08)

CoinPoker Hand #291245403: Hold'em No Limit (0.01/0.02 ) 2025/09/02 21:12:48 GMT
Table 'NL ₮2 I' 7-max Seat #7 is the button
Seat 1: SQuest (2.00 in chips)
Seat 2: Aceinthehole (2.95 in chips) is sitting out
Seat 3: vicmitch (3.98 in chips)
Seat 4: MarditZion (2.19 in chips)
Seat 5: kanococo (1.65 in chips)
Seat 6: otaldojamal (3.42 in chips)
Seat 7: G3TR3KTF1SH (2.00 in chips)
SQuest: posts small blind 0.01
vicmitch: posts big blind 0.02
*** HOLE CARDS ***
Dealt to kanococo [4h Kd]
MarditZion: folds
kanococo: folds
otaldojamal: folds
G3TR3KTF1SH: folds
SQuest: raises 0.03 to 0.05
vicmitch: calls 0.03
*** FLOP *** [5s Qd Td]
SQuest: bets 0.06
vicmitch: folds
Uncalled bet (0.06) returned to SQuest
SQuest collected 0.09 from pot
SQuest: doesn't show hand
*** SUMMARY ***
Total pot 0.10 | Rake 0.01
Board [ 5s Qd Td ]
Game ended: 2025/09/02 21:13:26 GMT
Seat 1: SQuest (small blind) collected (0.09)
Seat 2: Aceinthehole folded before Flop (didn't bet)
Seat 3: vicmitch (big blind) folded on the Flop
Seat 4: MarditZion folded before Flop (didn't bet)
Seat 5: kanococo folded before Flop (didn't bet)
Seat 6: otaldojamal folded before Flop (didn't bet)
Seat 7: G3TR3KTF1SH (button) folded before Flop (didn't bet)

CoinPoker Hand #291245714: Hold'em No Limit (0.01/0.02 ) 2025/09/02 21:13:28 GMT
Table 'NL ₮2 I' 7-max Seat #1 is the button
Seat 1: SQuest (2.04 in chips)
Seat 2: Aceinthehole (2.95 in chips) is sitting out
Seat 3: vicmitch (3.93 in chips)
Seat 4: MarditZion (2.19 in chips)
Seat 5: kanococo (1.65 in chips)
Seat 6: otaldojamal (3.42 in chips)
Seat 7: G3TR3KTF1SH (2.00 in chips)
vicmitch: posts small blind 0.01
MarditZion: posts big blind 0.02
*** HOLE CARDS ***
Dealt to kanococo [5h 8d]
kanococo: folds
otaldojamal: folds
G3TR3KTF1SH: folds
SQuest: folds
vicmitch: calls 0.01
MarditZion: checks
*** FLOP *** [Kc 3h 4c]
vicmitch: checks
MarditZion: bets 0.10
vicmitch has timed out
vicmitch activated time-bank (9 seconds)
vicmitch: folds
Uncalled bet (0.10) returned to MarditZion
MarditZion collected 0.04 from pot
MarditZion: doesn't show hand
*** SUMMARY ***
Total pot 0.04 | Rake 0.00
Board [ Kc 3h 4c ]
Game ended: 2025/09/02 21:14:30 GMT
Seat 1: SQuest (button) folded before Flop (didn't bet)
Seat 2: Aceinthehole folded before Flop (didn't bet)
Seat 3: vicmitch (small blind) folded on the Flop
Seat 4: MarditZion (big blind) collected (0.04)
Seat 5: kanococo folded before Flop (didn't bet)
Seat 6: otaldojamal folded before Flop (didn't bet)
Seat 7: G3TR3KTF1SH folded before Flop (didn't bet)

CoinPoker Hand #291246223: Hold'em No Limit (0.01/0.02 ) 2025/09/02 21:14:34 GMT
Table 'NL ₮2 I' 7-max Seat #3 is the button
Seat 1: SQuest (2.04 in chips)
Seat 2: Aceinthehole (2.95 in chips) is sitting out
Seat 3: vicmitch (3.91 in chips)
Seat 4: MarditZion (2.21 in chips)
Seat 5: kanococo (1.65 in chips)
Seat 6: otaldojamal (3.42 in chips)
Seat 7: G3TR3KTF1SH (2.00 in chips)
MarditZion: posts small blind 0.01
kanococo: posts big blind 0.02
*** HOLE CARDS ***
Dealt to kanococo [3s Kh]
otaldojamal: folds
G3TR3KTF1SH: folds
SQuest: folds
vicmitch: calls 0.02
MarditZion: raises 0.04 to 0.06
kanococo: folds
vicmitch: calls 0.04
*** FLOP *** [8s 7c 7d]
MarditZion: bets 0.06
vicmitch: calls 0.06
*** TURN *** [8s 7c 7d] [Qc]
MarditZion: checks
vicmitch: checks
*** RIVER *** [8s 7c 7d Qc] [5h]
MarditZion: checks
vicmitch: checks
*** SHOW DOWN ***
MarditZion: shows [Ts 9s] (a pair of Sevens)
vicmitch: shows [As 9d] (a pair of Sevens)
vicmitch collected 0.25 from pot
*** SUMMARY ***
Total pot 0.26 | Rake 0.01
Board [ 8s 7c 7d Qc 5h ]
Game ended: 2025/09/02 21:15:31 GMT
Seat 1: SQuest folded before Flop (didn't bet)
Seat 2: Aceinthehole folded before Flop (didn't bet)
Seat 3: vicmitch (button) showed [As 9d] and won (0.25) with a pair of Sevens
Seat 4: MarditZion (small blind) showed [Ts 9s]
Seat 5: kanococo (big blind) folded before Flop
Seat 6: otaldojamal folded before Flop (didn't bet)
Seat 7: G3TR3KTF1SH folded before Flop (didn't bet)

CoinPoker Hand #291246646: Hold'em No Limit (0.01/0.02 ) 2025/09/02 21:15:33 GMT
Table 'NL ₮2 I' 7-max Seat #4 is the button
Seat 1: SQuest (2.04 in chips)
Seat 2: Aceinthehole (2.95 in chips) is sitting out
Seat 3: vicmitch (4.04 in chips)
Seat 4: MarditZion (2.09 in chips)
Seat 5: kanococo (1.63 in chips)
Seat 6: otaldojamal (3.42 in chips)
Seat 7: G3TR3KTF1SH (2.00 in chips)
kanococo: posts small blind 0.01
otaldojamal: posts big blind 0.02
*** HOLE CARDS ***
Dealt to kanococo [Tc 5s]
G3TR3KTF1SH: folds
SQuest: folds
vicmitch: calls 0.02
MarditZion: folds
kanococo: raises 0.04 to 0.06
otaldojamal: folds
vicmitch: calls 0.04
*** FLOP *** [Qd Qs 8c]
kanococo: checks
vicmitch: checks
*** TURN *** [Qd Qs 8c] [6h]
kanococo: bets 0.06
vicmitch: calls 0.06
*** RIVER *** [Qd Qs 8c 6h] [7c]
kanococo: bets 0.25
vicmitch: folds
Uncalled bet (0.25) returned to kanococo
kanococo collected 0.25 from pot
kanococo: doesn't show hand
*** SUMMARY ***
Total pot 0.26 | Rake 0.01
Board [ Qd Qs 8c 6h 7c ]
Game ended: 2025/09/02 21:16:41 GMT
Seat 1: SQuest folded before Flop (didn't bet)
Seat 2: Aceinthehole folded before Flop (didn't bet)
Seat 3: vicmitch folded on the River
Seat 4: MarditZion (button) folded before Flop (didn't bet)
Seat 5: kanococo (small blind) collected (0.25)
Seat 6: otaldojamal (big blind) folded before Flop
Seat 7: G3TR3KTF1SH folded before Flop (didn't bet)

CoinPoker Hand #291247185: Hold'em No Limit (0.01/0.02 ) 2025/09/02 21:16:43 GMT
Table 'NL ₮2 I' 7-max Seat #5 is the button
Seat 1: SQuest (2.04 in chips)
Seat 2: Aceinthehole (2.95 in chips) is sitting out
Seat 3: vicmitch (3.92 in chips)
Seat 4: MarditZion (2.09 in chips)
Seat 5: kanococo (1.76 in chips)
Seat 6: otaldojamal (3.40 in chips)
Seat 7: G3TR3KTF1SH (2.00 in chips)
otaldojamal: posts small blind 0.01
G3TR3KTF1SH: posts big blind 0.02
*** HOLE CARDS ***
Dealt to kanococo [6d 6h]
SQuest: folds
vicmitch: calls 0.02
MarditZion: folds
kanococo: raises 0.04 to 0.06
otaldojamal: folds
G3TR3KTF1SH: folds
vicmitch: calls 0.04
*** FLOP *** [7s 4c 3d]
vicmitch: checks
kanococo: bets 0.07
vicmitch: calls 0.07
*** TURN *** [7s 4c 3d] [7d]
vicmitch: checks
kanococo: checks
*** RIVER *** [7s 4c 3d 7d] [6s]
vicmitch: bets 0.16
kanococo: raises 1.63 and is all-in
vicmitch: folds
Uncalled bet (1.47) returned to kanococo
kanococo collected 0.60 from pot
kanococo: doesn't show hand
*** SUMMARY ***
Total pot 0.61 | Rake 0.01
Board [ 7s 4c 3d 7d 6s ]
Game ended: 2025/09/02 21:17:58 GMT
Seat 1: SQuest folded before Flop (didn't bet)
Seat 2: Aceinthehole folded before Flop (didn't bet)
Seat 3: vicmitch folded on the River
Seat 4: MarditZion folded before Flop (didn't bet)
Seat 5: kanococo (button) collected (0.60)
Seat 6: otaldojamal (small blind) folded before Flop
Seat 7: G3TR3KTF1SH (big blind) folded before Flop

CoinPoker Hand #291247656: Hold'em No Limit (0.01/0.02 ) 2025/09/02 21:18:00 GMT
Table 'NL ₮2 I' 7-max Seat #6 is the button
Seat 1: SQuest (2.04 in chips)
Seat 2: SoBrokeAF (2.00 in chips) out of hand
Seat 3: vicmitch (3.63 in chips)
Seat 4: MarditZion (2.09 in chips)
Seat 5: kanococo (2.07 in chips)
Seat 6: otaldojamal (3.39 in chips)
Seat 7: G3TR3KTF1SH (1.98 in chips)
G3TR3KTF1SH: posts small blind 0.01
SQuest: posts big blind 0.02
*** HOLE CARDS ***
Dealt to kanococo [2h 9d]
vicmitch: folds
MarditZion: folds
kanococo: folds
otaldojamal: raises 0.03 to 0.05
G3TR3KTF1SH: folds
SQuest: folds
otaldojamal collected 0.08 from pot
otaldojamal: doesn't show hand
*** SUMMARY ***
Total pot 0.08 | Rake 0.00
Board [ ]
Game ended: 2025/09/02 21:18:22 GMT
Seat 1: SQuest (big blind) folded before Flop
Seat 2: SoBrokeAF folded before Flop (didn't bet)
Seat 3: vicmitch folded before Flop (didn't bet)
Seat 4: MarditZion folded before Flop (didn't bet)
Seat 5: kanococo folded before Flop (didn't bet)
Seat 6: otaldojamal (button) collected (0.08)
Seat 7: G3TR3KTF1SH (small blind) folded before Flop

CoinPoker Hand #291247847: Hold'em No Limit (0.01/0.02 ) 2025/09/02 21:18:26 GMT
Table 'NL ₮2 I' 7-max Seat #7 is the button
Seat 1: SQuest (2.02 in chips)
Seat 2: SoBrokeAF (2.00 in chips)
Seat 3: vicmitch (3.63 in chips)
Seat 4: MarditZion (2.09 in chips)
Seat 5: kanococo (2.07 in chips)
Seat 6: otaldojamal (3.42 in chips)
Seat 7: G3TR3KTF1SH (1.99 in chips)
SQuest: posts small blind 0.01
SoBrokeAF: posts big blind 0.02
*** HOLE CARDS ***
Dealt to kanococo [2h Qh]
vicmitch: folds
MarditZion: raises 0.04 to 0.06
kanococo: folds
otaldojamal: raises 0.15 to 0.21
G3TR3KTF1SH: folds
SQuest: folds
SoBrokeAF: folds
MarditZion: folds
otaldojamal collected 0.30 from pot
otaldojamal: doesn't show hand
*** SUMMARY ***
Total pot 0.30 | Rake 0.00
Board [ ]
Game ended: 2025/09/02 21:18:57 GMT
Seat 1: SQuest (small blind) folded before Flop
Seat 2: SoBrokeAF (big blind) folded before Flop
Seat 3: vicmitch folded before Flop (didn't bet)
Seat 4: MarditZion folded before Flop
Seat 5: kanococo folded before Flop (didn't bet)
Seat 6: otaldojamal collected (0.30)
Seat 7: G3TR3KTF1SH (button) folded before Flop (didn't bet)

CoinPoker Hand #291248112: Hold'em No Limit (0.01/0.02 ) 2025/09/02 21:18:59 GMT
Table 'NL ₮2 I' 7-max Seat #1 is the button
Seat 1: SQuest (2.01 in chips)
Seat 2: SoBrokeAF (1.98 in chips)
Seat 3: vicmitch (3.63 in chips)
Seat 4: MarditZion (2.03 in chips)
Seat 5: kanococo (2.07 in chips)
Seat 6: otaldojamal (3.51 in chips)
Seat 7: G3TR3KTF1SH (2.00 in chips)
SoBrokeAF: posts small blind 0.01
vicmitch: posts big blind 0.02
*** HOLE CARDS ***
Dealt to kanococo [Ad Js]
MarditZion: folds
kanococo: raises 0.04 to 0.06
otaldojamal: folds
G3TR3KTF1SH: folds
SQuest: calls 0.06
SoBrokeAF: calls 0.05
vicmitch: folds
*** FLOP *** [Ks Ah 2c]
SoBrokeAF: checks
kanococo: bets 0.04
SQuest: folds
SoBrokeAF: folds
Uncalled bet (0.04) returned to kanococo
kanococo collected 0.19 from pot
kanococo: doesn't show hand
*** SUMMARY ***
Total pot 0.20 | Rake 0.01
Board [ Ks Ah 2c ]
Game ended: 2025/09/02 21:19:54 GMT
Seat 1: SQuest (button) folded on the Flop
Seat 2: SoBrokeAF (small blind) folded on the Flop
Seat 3: vicmitch (big blind) folded before Flop
Seat 4: MarditZion folded before Flop (didn't bet)
Seat 5: kanococo collected (0.19)
Seat 6: otaldojamal folded before Flop (didn't bet)
Seat 7: G3TR3KTF1SH folded before Flop (didn't bet)

CoinPoker Hand #291248401: Hold'em No Limit (0.01/0.02 ) 2025/09/02 21:19:56 GMT
Table 'NL ₮2 I' 7-max Seat #2 is the button
Seat 1: SQuest (2.00 in chips)
Seat 2: SoBrokeAF (2.00 in chips)
Seat 3: vicmitch (3.61 in chips)
Seat 4: MarditZion (2.03 in chips)
Seat 5: kanococo (2.20 in chips)
Seat 6: otaldojamal (3.51 in chips)
Seat 7: G3TR3KTF1SH (2.00 in chips)
vicmitch: posts small blind 0.01
MarditZion: posts big blind 0.02
*** HOLE CARDS ***
Dealt to kanococo [Ts 9s]
kanococo: folds
otaldojamal: raises 0.03 to 0.05
G3TR3KTF1SH: folds
SQuest: folds
SoBrokeAF: folds
vicmitch: calls 0.04
MarditZion has timed out
MarditZion activated time-bank (60 seconds)
MarditZion: folds
*** FLOP *** [3h Qh As]
vicmitch: checks
otaldojamal: checks
*** TURN *** [3h Qh As] [Ad]
vicmitch: bets 0.11
otaldojamal: folds
Uncalled bet (0.11) returned to vicmitch
vicmitch collected 0.11 from pot
vicmitch: doesn't show hand
*** SUMMARY ***
Total pot 0.12 | Rake 0.01
Board [ 3h Qh As Ad ]
Game ended: 2025/09/02 21:21:12 GMT
Seat 1: SQuest folded before Flop (didn't bet)
Seat 2: SoBrokeAF (button) folded before Flop (didn't bet)
Seat 3: vicmitch (small blind) collected (0.11)
Seat 4: MarditZion (big blind) folded before Flop
Seat 5: kanococo folded before Flop (didn't bet)
Seat 6: otaldojamal folded on the Turn
Seat 7: G3TR3KTF1SH folded before Flop (didn't bet)

CoinPoker Hand #291248909: Hold'em No Limit (0.01/0.02 ) 2025/09/02 21:21:13 GMT
Table 'NL ₮2 I' 7-max Seat #3 is the button
Seat 1: SQuest (2.00 in chips)
Seat 2: SoBrokeAF (2.00 in chips)
Seat 3: vicmitch (3.67 in chips)
Seat 4: MarditZion (2.01 in chips)
Seat 5: kanococo (2.20 in chips)
Seat 6: otaldojamal (3.46 in chips)
Seat 7: G3TR3KTF1SH (2.00 in chips)
MarditZion: posts small blind 0.01
kanococo: posts big blind 0.02
*** HOLE CARDS ***
Dealt to kanococo [9c Ac]
otaldojamal: folds
G3TR3KTF1SH: folds
SQuest: folds
SoBrokeAF: folds
vicmitch: folds
MarditZion: folds
kanococo collected 0.03 from pot
kanococo: doesn't show hand
*** SUMMARY ***
Total pot 0.03 | Rake 0.00
Board [ ]
Game ended: 2025/09/02 21:21:51 GMT
Seat 1: SQuest folded before Flop (didn't bet)
Seat 2: SoBrokeAF folded before Flop (didn't bet)
Seat 3: vicmitch (button) folded before Flop (didn't bet)
Seat 4: MarditZion (small blind) folded before Flop
Seat 5: kanococo (big blind) collected (0.03)
Seat 6: otaldojamal folded before Flop (didn't bet)
Seat 7: G3TR3KTF1SH folded before Flop (didn't bet)

CoinPoker Hand #291249186: Hold'em No Limit (0.01/0.02 ) 2025/09/02 21:21:53 GMT
Table 'NL ₮2 I' 7-max Seat #4 is the button
Seat 1: SQuest (2.00 in chips)
Seat 2: SoBrokeAF (2.00 in chips)
Seat 3: vicmitch (3.67 in chips)
Seat 4: MarditZion (2.00 in chips)
Seat 5: kanococo (2.21 in chips)
Seat 6: otaldojamal (3.46 in chips)
Seat 7: G3TR3KTF1SH (2.00 in chips)
kanococo: posts small blind 0.01
otaldojamal: posts big blind 0.02
*** HOLE CARDS ***
Dealt to kanococo [2h 6c]
G3TR3KTF1SH: folds
SQuest: folds
SoBrokeAF: folds
vicmitch: folds
MarditZion: folds
kanococo: raises 0.02 to 0.04
otaldojamal has timed out
otaldojamal activated time-bank (60 seconds)
otaldojamal: folds
kanococo collected 0.06 from pot
kanococo: doesn't show hand
*** SUMMARY ***
Total pot 0.06 | Rake 0.00
Board [ ]
Game ended: 2025/09/02 21:22:40 GMT
Seat 1: SQuest folded before Flop (didn't bet)
Seat 2: SoBrokeAF folded before Flop (didn't bet)
Seat 3: vicmitch folded before Flop (didn't bet)
Seat 4: MarditZion (button) folded before Flop (didn't bet)
Seat 5: kanococo (small blind) collected (0.06)
Seat 6: otaldojamal (big blind) folded before Flop
Seat 7: G3TR3KTF1SH folded before Flop (didn't bet)

CoinPoker Hand #291249526: Hold'em No Limit (0.01/0.02 ) 2025/09/02 21:22:42 GMT
Table 'NL ₮2 I' 7-max Seat #5 is the button
Seat 1: SQuest (2.00 in chips)
Seat 2: SoBrokeAF (2.00 in chips)
Seat 3: vicmitch (3.67 in chips)
Seat 4: MarditZion (2.00 in chips)
Seat 5: kanococo (2.23 in chips)
Seat 6: otaldojamal (3.44 in chips)
Seat 7: G3TR3KTF1SH (2.00 in chips)
otaldojamal: posts small blind 0.01
G3TR3KTF1SH: posts big blind 0.02
*** HOLE CARDS ***
Dealt to kanococo [5s 9h]
SQuest: folds
SoBrokeAF: folds
vicmitch: folds
MarditZion: folds
kanococo: folds
otaldojamal: folds
G3TR3KTF1SH collected 0.03 from pot
G3TR3KTF1SH: doesn't show hand
*** SUMMARY ***
Total pot 0.03 | Rake 0.00
Board [ ]
Game ended: 2025/09/02 21:23:07 GMT
Seat 1: SQuest folded before Flop (didn't bet)
Seat 2: SoBrokeAF folded before Flop (didn't bet)
Seat 3: vicmitch folded before Flop (didn't bet)
Seat 4: MarditZion folded before Flop (didn't bet)
Seat 5: kanococo (button) folded before Flop (didn't bet)
Seat 6: otaldojamal (small blind) folded before Flop
Seat 7: G3TR3KTF1SH (big blind) collected (0.03)

CoinPoker Hand #291249689: Hold'em No Limit (0.01/0.02 ) 2025/09/02 21:23:10 GMT
Table 'NL ₮2 I' 7-max Seat #6 is the button
Seat 1: SQuest (2.00 in chips)
Seat 2: SoBrokeAF (2.00 in chips)
Seat 3: vicmitch (3.67 in chips)
Seat 4: MarditZion (2.00 in chips)
Seat 5: kanococo (2.23 in chips)
Seat 6: otaldojamal (3.43 in chips)
Seat 7: G3TR3KTF1SH (2.01 in chips)
G3TR3KTF1SH: posts small blind 0.01
SQuest: posts big blind 0.02
*** HOLE CARDS ***
Dealt to kanococo [5c 8s]
SoBrokeAF: folds
vicmitch: folds
MarditZion: raises 0.04 to 0.06
kanococo: folds
otaldojamal: folds
G3TR3KTF1SH: folds
SQuest: folds
MarditZion collected 0.09 from pot
MarditZion: doesn't show hand
*** SUMMARY ***
Total pot 0.09 | Rake 0.00
Board [ ]
Game ended: 2025/09/02 21:23:39 GMT
Seat 1: SQuest (big blind) folded before Flop
Seat 2: SoBrokeAF folded before Flop (didn't bet)
Seat 3: vicmitch folded before Flop (didn't bet)
Seat 4: MarditZion collected (0.09)
Seat 5: kanococo folded before Flop (didn't bet)
Seat 6: otaldojamal (button) folded before Flop (didn't bet)
Seat 7: G3TR3KTF1SH (small blind) folded before Flop

CoinPoker Hand #291249881: Hold'em No Limit (0.01/0.02 ) 2025/09/02 21:23:42 GMT
Table 'NL ₮2 I' 7-max Seat #7 is the button
Seat 1: SQuest (2.00 in chips)
Seat 2: SoBrokeAF (2.00 in chips)
Seat 3: vicmitch (3.67 in chips)
Seat 4: MarditZion (2.03 in chips)
Seat 5: kanococo (2.23 in chips)
Seat 6: otaldojamal (3.43 in chips)
Seat 7: G3TR3KTF1SH (2.00 in chips)
SQuest: posts small blind 0.01
SoBrokeAF: posts big blind 0.02
*** HOLE CARDS ***
Dealt to kanococo [Qc 6h]
vicmitch: folds
MarditZion: folds
kanococo: folds
otaldojamal: folds
G3TR3KTF1SH: folds
SQuest: folds
SoBrokeAF collected 0.03 from pot
SoBrokeAF: doesn't show hand
*** SUMMARY ***
Total pot 0.03 | Rake 0.00
Board [ ]
Game ended: 2025/09/02 21:24:06 GMT
Seat 1: SQuest (small blind) folded before Flop
Seat 2: SoBrokeAF (big blind) collected (0.03)
Seat 3: vicmitch folded before Flop (didn't bet)
Seat 4: MarditZion folded before Flop (didn't bet)
Seat 5: kanococo folded before Flop (didn't bet)
Seat 6: otaldojamal folded before Flop (didn't bet)
Seat 7: G3TR3KTF1SH (button) folded before Flop (didn't bet)

CoinPoker Hand #291250098: Hold'em No Limit (0.01/0.02 ) 2025/09/02 21:24:08 GMT
Table 'NL ₮2 I' 7-max Seat #1 is the button
Seat 1: SQuest (2.00 in chips)
Seat 2: SoBrokeAF (2.01 in chips)
Seat 3: vicmitch (3.67 in chips)
Seat 4: MarditZion (2.03 in chips)
Seat 5: kanococo (2.23 in chips)
Seat 6: otaldojamal (3.43 in chips)
Seat 7: G3TR3KTF1SH (2.00 in chips)
SoBrokeAF: posts small blind 0.01
vicmitch: posts big blind 0.02
*** HOLE CARDS ***
Dealt to kanococo [3d 9c]
MarditZion: folds
kanococo: folds
otaldojamal: folds
G3TR3KTF1SH: folds
SQuest: folds
SoBrokeAF: folds
vicmitch collected 0.03 from pot
vicmitch: doesn't show hand
*** SUMMARY ***
Total pot 0.03 | Rake 0.00
Board [ ]
Game ended: 2025/09/02 21:24:29 GMT
Seat 1: SQuest (button) folded before Flop (didn't bet)
Seat 2: SoBrokeAF (small blind) folded before Flop
Seat 3: vicmitch (big blind) collected (0.03)
Seat 4: MarditZion folded before Flop (didn't bet)
Seat 5: kanococo folded before Flop (didn't bet)
Seat 6: otaldojamal folded before Flop (didn't bet)
Seat 7: G3TR3KTF1SH folded before Flop (didn't bet)

CoinPoker Hand #291250279: Hold'em No Limit (0.01/0.02 ) 2025/09/02 21:24:31 GMT
Table 'NL ₮2 I' 7-max Seat #2 is the button
Seat 1: SQuest (2.00 in chips)
Seat 2: SoBrokeAF (2.00 in chips)
Seat 3: vicmitch (3.68 in chips)
Seat 4: MarditZion (2.03 in chips)
Seat 5: kanococo (2.23 in chips)
Seat 6: otaldojamal (3.43 in chips)
Seat 7: G3TR3KTF1SH (2.00 in chips)
vicmitch: posts small blind 0.01
MarditZion: posts big blind 0.02
*** HOLE CARDS ***
Dealt to kanococo [3h 7s]
kanococo: folds
otaldojamal: folds
G3TR3KTF1SH: folds
SoBrokeAF is disconnected
SQuest: raises 0.03 to 0.05
SoBrokeAF has reconnected
SoBrokeAF: raises 0.11 to 0.16
vicmitch: folds
MarditZion: folds
SQuest: calls 0.11
*** FLOP *** [Tc Td 5h]
SQuest: checks
SoBrokeAF: bets 0.10
SQuest: calls 0.10
*** TURN *** [Tc Td 5h] [Jh]
SQuest: checks
SoBrokeAF: bets 0.26
SQuest: folds
Uncalled bet (0.26) returned to SoBrokeAF
SoBrokeAF collected 0.52 from pot
SoBrokeAF: doesn't show hand
*** SUMMARY ***
Total pot 0.55 | Rake 0.03
Board [ Tc Td 5h Jh ]
Game ended: 2025/09/02 21:26:13 GMT
Seat 1: SQuest folded on the Turn
Seat 2: SoBrokeAF (button) collected (0.52)
Seat 3: vicmitch (small blind) folded before Flop
Seat 4: MarditZion (big blind) folded before Flop
Seat 5: kanococo folded before Flop (didn't bet)
Seat 6: otaldojamal folded before Flop (didn't bet)
Seat 7: G3TR3KTF1SH folded before Flop (didn't bet)

CoinPoker Hand #291250934: Hold'em No Limit (0.01/0.02 ) 2025/09/02 21:26:15 GMT
Table 'NL ₮2 I' 7-max Seat #3 is the button
Seat 1: SQuest (2.00 in chips)
Seat 2: SoBrokeAF (2.26 in chips)
Seat 3: vicmitch (3.67 in chips)
Seat 4: MarditZion (2.01 in chips)
Seat 5: kanococo (2.23 in chips)
Seat 6: otaldojamal (3.43 in chips)
Seat 7: G3TR3KTF1SH (2.00 in chips)
MarditZion: posts small blind 0.01
kanococo: posts big blind 0.02
*** HOLE CARDS ***
Dealt to kanococo [5c Qc]
otaldojamal: folds
G3TR3KTF1SH: folds
SQuest: raises 0.04 to 0.06
SoBrokeAF: raises 0.12 to 0.18
vicmitch: folds
MarditZion: folds
kanococo: folds
SQuest: calls 0.12
*** FLOP *** [Ac 7h Ks]
SQuest: checks
SoBrokeAF: bets 0.12
SQuest: calls 0.12
*** TURN *** [Ac 7h Ks] [2h]
SQuest: checks
SoBrokeAF: bets 0.30
SQuest: folds
Uncalled bet (0.30) returned to SoBrokeAF
SoBrokeAF collected 0.60 from pot
SoBrokeAF: doesn't show hand
*** SUMMARY ***
Total pot 0.63 | Rake 0.03
Board [ Ac 7h Ks 2h ]
Game ended: 2025/09/02 21:27:11 GMT
Seat 1: SQuest folded on the Turn
Seat 2: SoBrokeAF collected (0.60)
Seat 3: vicmitch (button) folded before Flop (didn't bet)
Seat 4: MarditZion (small blind) folded before Flop
Seat 5: kanococo (big blind) folded before Flop
Seat 6: otaldojamal folded before Flop (didn't bet)
Seat 7: G3TR3KTF1SH folded before Flop (didn't bet)

CoinPoker Hand #291251292: Hold'em No Limit (0.01/0.02 ) 2025/09/02 21:27:13 GMT
Table 'NL ₮2 I' 7-max Seat #4 is the button
Seat 1: SQuest (2.00 in chips)
Seat 2: SoBrokeAF (2.56 in chips)
Seat 3: vicmitch (3.67 in chips)
Seat 4: MarditZion (2.00 in chips)
Seat 5: kanococo (2.21 in chips)
Seat 6: otaldojamal (3.43 in chips)
Seat 7: G3TR3KTF1SH (2.00 in chips)
kanococo: posts small blind 0.01
otaldojamal: posts big blind 0.02
*** HOLE CARDS ***
Dealt to kanococo [Ts 6c]
G3TR3KTF1SH: folds
SQuest: folds
SoBrokeAF: folds
vicmitch: folds
MarditZion: folds
kanococo: raises 0.04 to 0.06
otaldojamal: calls 0.04
*** FLOP *** [4h Ks Jc]
kanococo: checks
otaldojamal: bets 0.03
kanococo: folds
Uncalled bet (0.03) returned to otaldojamal
otaldojamal collected 0.11 from pot
otaldojamal: doesn't show hand
*** SUMMARY ***
Total pot 0.12 | Rake 0.01
Board [ 4h Ks Jc ]
Game ended: 2025/09/02 21:27:59 GMT
Seat 1: SQuest folded before Flop (didn't bet)
Seat 2: SoBrokeAF folded before Flop (didn't bet)
Seat 3: vicmitch folded before Flop (didn't bet)
Seat 4: MarditZion (button) folded before Flop (didn't bet)
Seat 5: kanococo (small blind) folded on the Flop
Seat 6: otaldojamal (big blind) collected (0.11)
Seat 7: G3TR3KTF1SH folded before Flop (didn't bet)

CoinPoker Hand #291251678: Hold'em No Limit (0.01/0.02 ) 2025/09/02 21:28:01 GMT
Table 'NL ₮2 I' 7-max Seat #5 is the button
Seat 1: SQuest (2.00 in chips)
Seat 2: SoBrokeAF (2.56 in chips)
Seat 3: vicmitch (3.67 in chips)
Seat 4: MarditZion (2.00 in chips)
Seat 5: kanococo (2.15 in chips)
Seat 6: otaldojamal (3.48 in chips)
Seat 7: G3TR3KTF1SH (2.00 in chips)
otaldojamal: posts small blind 0.01
G3TR3KTF1SH: posts big blind 0.02
*** HOLE CARDS ***
Dealt to kanococo [Ad Qd]
SQuest: folds
SoBrokeAF: folds
vicmitch: calls 0.02
MarditZion: folds
kanococo: raises 0.08 to 0.10
otaldojamal: folds
G3TR3KTF1SH: raises 0.26 to 0.36
vicmitch: folds
kanococo has timed out
kanococo activated time-bank (60 seconds)
kanococo: calls 0.26
*** FLOP *** [3h Qc 4d]
G3TR3KTF1SH: checks
kanococo: bets 0.35
G3TR3KTF1SH: raises 0.35 to 0.70
kanococo: calls 0.35
*** TURN *** [3h Qc 4d] [3d]
G3TR3KTF1SH: bets 0.94 and is all-in
kanococo: calls 0.94
*** RIVER *** [3h Qc 4d 3d] [Kc]
*** SHOW DOWN ***
G3TR3KTF1SH: shows [As Ks] (two pairs, Kings and Threes)
kanococo: shows [Ad Qd] (two pairs, Queens and Threes)
G3TR3KTF1SH collected 3.83 from pot
*** SUMMARY ***
Total pot 4.03 | Rake 0.20
Board [ 3h Qc 4d 3d Kc ]
Game ended: 2025/09/02 21:29:26 GMT
Seat 1: SQuest folded before Flop (didn't bet)
Seat 2: SoBrokeAF folded before Flop (didn't bet)
Seat 3: vicmitch folded before Flop
Seat 4: MarditZion folded before Flop (didn't bet)
Seat 5: kanococo (button) showed [Ad Qd]
Seat 6: otaldojamal (small blind) folded before Flop
Seat 7: G3TR3KTF1SH (big blind) showed [As Ks] and won (3.83) with two pairs, Kings and Threes

CoinPoker Hand #291252229: Hold'em No Limit (0.01/0.02 ) 2025/09/02 21:29:28 GMT
Table 'NL ₮2 I' 7-max Seat #6 is the button
Seat 1: SQuest (2.00 in chips)
Seat 2: SoBrokeAF (2.56 in chips)
Seat 3: vicmitch (3.65 in chips)
Seat 4: MarditZion (2.00 in chips)
Seat 5: kanococo (0.15 in chips)
Seat 6: otaldojamal (3.47 in chips)
Seat 7: G3TR3KTF1SH (3.83 in chips)
G3TR3KTF1SH: posts small blind 0.01
SQuest: didn't post big blind
SoBrokeAF: posts big blind 0.02
*** HOLE CARDS ***
Dealt to kanococo [2h 8h]
vicmitch: folds
MarditZion: folds
kanococo: calls 0.02
otaldojamal: folds
G3TR3KTF1SH: calls 0.01
SoBrokeAF: checks
*** FLOP *** [9h 3h 9d]
G3TR3KTF1SH: checks
SoBrokeAF: checks
kanococo: bets 0.13 and is all-in
G3TR3KTF1SH: calls 0.13
SoBrokeAF: folds
*** TURN *** [9h 3h 9d] [8d]
*** RIVER *** [9h 3h 9d 8d] [7h]
*** SHOW DOWN ***
kanococo: shows [2h 8h] (a flush, Nine high)
G3TR3KTF1SH: shows [9c Td] (three of kind, Nines)
kanococo collected 0.30 from pot
*** SUMMARY ***
Total pot 0.32 | Rake 0.02
Board [ 9h 3h 9d 8d 7h ]
Game ended: 2025/09/02 21:30:24 GMT
Seat 1: SQuest folded before Flop (didn't bet)
Seat 2: SoBrokeAF (big blind) folded on the Flop
Seat 3: vicmitch folded before Flop (didn't bet)
Seat 4: MarditZion folded before Flop (didn't bet)
Seat 5: kanococo showed [2h 8h] and won (0.30) with a flush, Nine high
Seat 6: otaldojamal (button) folded before Flop (didn't bet)
Seat 7: G3TR3KTF1SH (small blind) showed [9c Td]

CoinPoker Hand #291252584: Hold'em No Limit (0.01/0.02 ) 2025/09/02 21:30:26 GMT
Table 'NL ₮2 I' 7-max Seat #7 is the button
Seat 1: rRubbB (2.00 in chips)
Seat 2: SoBrokeAF (2.54 in chips)
Seat 3: vicmitch (3.65 in chips)
Seat 4: MarditZion (2.00 in chips)
Seat 5: kanococo (0.30 in chips)
Seat 6: otaldojamal (3.47 in chips)
Seat 7: G3TR3KTF1SH (3.68 in chips)
SoBrokeAF: posts small blind 0.01
vicmitch: posts big blind 0.02
rRubbB: posts big blind 0.02
*** HOLE CARDS ***
Dealt to kanococo [7c 4d]
MarditZion: folds
kanococo: folds
otaldojamal: folds
G3TR3KTF1SH: folds
rRubbB: checks
SoBrokeAF: calls 0.01
vicmitch: checks
*** FLOP *** [Ah 3s 6h]
rRubbB: checks
SoBrokeAF: checks
vicmitch: checks
*** TURN *** [Ah 3s 6h] [Ts]
rRubbB: bets 0.08
SoBrokeAF: folds
vicmitch: calls 0.08
*** RIVER *** [Ah 3s 6h Ts] [Ks]
rRubbB: bets 0.24
vicmitch: calls 0.24
*** SHOW DOWN ***
rRubbB: shows [6s 5s] (a flush, King high)
vicmitch: mucks hand
rRubbB collected 0.66 from pot
*** SUMMARY ***
Total pot 0.70 | Rake 0.04
Board [ Ah 3s 6h Ts Ks ]
Game ended: 2025/09/02 21:31:31 GMT
Seat 1: rRubbB showed [6s 5s] and won (0.66) with a flush, King high
Seat 2: SoBrokeAF (small blind) folded on the Turn
Seat 3: vicmitch (big blind) mucked
Seat 4: MarditZion folded before Flop (didn't bet)
Seat 5: kanococo folded before Flop (didn't bet)
Seat 6: otaldojamal folded before Flop (didn't bet)
Seat 7: G3TR3KTF1SH (button) folded before Flop (didn't bet)

CoinPoker Hand #291253189: Hold'em No Limit (0.01/0.02 ) 2025/09/02 21:31:34 GMT
Table 'NL ₮2 I' 7-max Seat #2 is the button
Seat 1: rRubbB (2.32 in chips)
Seat 2: SoBrokeAF (2.52 in chips)
Seat 3: vicmitch (3.31 in chips)
Seat 4: MarditZion (2.00 in chips)
Seat 5: kanococo (0.30 in chips)
Seat 6: otaldojamal (3.47 in chips)
Seat 7: G3TR3KTF1SH (3.68 in chips)
vicmitch: posts small blind 0.01
MarditZion: posts big blind 0.02
*** HOLE CARDS ***
Dealt to kanococo [6s Js]
kanococo: raises 0.30 and is all-in
otaldojamal: folds
G3TR3KTF1SH: folds
rRubbB: folds
SoBrokeAF: folds
vicmitch: folds
MarditZion: folds
kanococo collected 0.33 from pot
kanococo: doesn't show hand
*** SUMMARY ***
Total pot 0.33 | Rake 0.00
Board [ ]
Game ended: 2025/09/02 21:31:57 GMT
Seat 1: rRubbB folded before Flop (didn't bet)
Seat 2: SoBrokeAF (button) folded before Flop (didn't bet)
Seat 3: vicmitch (small blind) folded before Flop
Seat 4: MarditZion (big blind) folded before Flop
Seat 5: kanococo collected (0.33)
Seat 6: otaldojamal folded before Flop (didn't bet)
Seat 7: G3TR3KTF1SH folded before Flop (didn't bet)

CoinPoker Hand #291253379: Hold'em No Limit (0.01/0.02 ) 2025/09/02 21:31:59 GMT
Table 'NL ₮2 I' 7-max Seat #3 is the button
Seat 1: rRubbB (2.32 in chips)
Seat 2: SoBrokeAF (2.52 in chips)
Seat 3: vicmitch (3.30 in chips)
Seat 4: MarditZion (1.98 in chips)
Seat 5: kanococo (0.33 in chips)
Seat 6: otaldojamal (3.47 in chips)
Seat 7: G3TR3KTF1SH (3.68 in chips)
MarditZion: posts small blind 0.01
kanococo: posts big blind 0.02
*** HOLE CARDS ***
Dealt to kanococo [Ad Jh]
otaldojamal: folds
G3TR3KTF1SH: folds
rRubbB: raises 0.04 to 0.06
SoBrokeAF: folds
vicmitch: raises 0.16 to 0.22
MarditZion: folds
kanococo: raises 0.31 and is all-in
rRubbB: folds
vicmitch: calls 0.11
*** FLOP *** [Jd 3s As]
*** TURN *** [Jd 3s As] [7c]
*** RIVER *** [Jd 3s As 7c] [4h]
*** SHOW DOWN ***
kanococo: shows [Ad Jh] (two pairs, Aces and Jacks)
vicmitch: shows [Qs Ac] (a pair of Aces)
kanococo collected 0.69 from pot
*** SUMMARY ***
Total pot 0.73 | Rake 0.04
Board [ Jd 3s As 7c 4h ]
Game ended: 2025/09/02 21:32:40 GMT
Seat 1: rRubbB folded before Flop
Seat 2: SoBrokeAF folded before Flop (didn't bet)
Seat 3: vicmitch (button) showed [Qs Ac]
Seat 4: MarditZion (small blind) folded before Flop
Seat 5: kanococo (big blind) showed [Ad Jh] and won (0.69) with two pairs, Aces and Jacks
Seat 6: otaldojamal folded before Flop (didn't bet)
Seat 7: G3TR3KTF1SH folded before Flop (didn't bet)

CoinPoker Hand #291253630: Hold'em No Limit (0.01/0.02 ) 2025/09/02 21:32:42 GMT
Table 'NL ₮2 I' 7-max Seat #4 is the button
Seat 1: rRubbB (2.26 in chips)
Seat 2: SoBrokeAF (2.52 in chips)
Seat 3: vicmitch (2.97 in chips)
Seat 4: MarditZion (1.97 in chips)
Seat 5: kanococo (0.69 in chips)
Seat 6: otaldojamal (3.47 in chips)
Seat 7: G3TR3KTF1SH (3.68 in chips)
kanococo: posts small blind 0.01
otaldojamal: posts big blind 0.02
*** HOLE CARDS ***
Dealt to kanococo [4h 2d]
G3TR3KTF1SH: folds
rRubbB: folds
SoBrokeAF has timed out
SoBrokeAF activated time-bank (60 seconds)
SoBrokeAF: folds
vicmitch: calls 0.02
MarditZion: raises 0.04 to 0.06
kanococo: folds
otaldojamal: folds
vicmitch: calls 0.04
*** FLOP *** [Ac 2h 8s]
vicmitch: checks
MarditZion: bets 0.07
vicmitch: folds
Uncalled bet (0.07) returned to MarditZion
MarditZion collected 0.14 from pot
MarditZion: doesn't show hand
*** SUMMARY ***
Total pot 0.15 | Rake 0.01
Board [ Ac 2h 8s ]
Game ended: 2025/09/02 21:33:28 GMT
Seat 1: rRubbB folded before Flop (didn't bet)
Seat 2: SoBrokeAF folded before Flop (didn't bet)
Seat 3: vicmitch folded on the Flop
Seat 4: MarditZion (button) collected (0.14)
Seat 5: kanococo (small blind) folded before Flop
Seat 6: otaldojamal (big blind) folded before Flop
Seat 7: G3TR3KTF1SH folded before Flop (didn't bet)

CoinPoker Hand #291253969: Hold'em No Limit (0.01/0.02 ) 2025/09/02 21:33:31 GMT
Table 'NL ₮2 I' 7-max Seat #5 is the button
Seat 1: rRubbB (2.26 in chips)
Seat 2: SoBrokeAF (2.52 in chips)
Seat 3: vicmitch (2.91 in chips)
Seat 4: MarditZion (2.05 in chips)
Seat 5: kanococo (0.68 in chips)
Seat 6: otaldojamal (3.45 in chips)
Seat 7: G3TR3KTF1SH (3.68 in chips)
otaldojamal: posts small blind 0.01
G3TR3KTF1SH: posts big blind 0.02
*** HOLE CARDS ***
Dealt to kanococo [Ac 3c]
rRubbB: raises 0.04 to 0.06
SoBrokeAF: folds
vicmitch: calls 0.06
MarditZion: folds
kanococo: calls 0.06
otaldojamal: folds
G3TR3KTF1SH: raises 0.34 to 0.40
rRubbB: folds
vicmitch: calls 0.34
kanococo: folds
*** FLOP *** [Ks Ad 2h]
G3TR3KTF1SH: checks
vicmitch: checks
*** TURN *** [Ks Ad 2h] [7d]
G3TR3KTF1SH: bets 0.24
vicmitch: calls 0.24
*** RIVER *** [Ks Ad 2h 7d] [5c]
G3TR3KTF1SH: bets 1.00
vicmitch: folds
Uncalled bet (1.00) returned to G3TR3KTF1SH
G3TR3KTF1SH collected 1.34 from pot
G3TR3KTF1SH: doesn't show hand
*** SUMMARY ***
Total pot 1.41 | Rake 0.07
Board [ Ks Ad 2h 7d 5c ]
Game ended: 2025/09/02 21:34:41 GMT
Seat 1: rRubbB folded before Flop
Seat 2: SoBrokeAF folded before Flop (didn't bet)
Seat 3: vicmitch folded on the River
Seat 4: MarditZion folded before Flop (didn't bet)
Seat 5: kanococo (button) folded before Flop
Seat 6: otaldojamal (small blind) folded before Flop
Seat 7: G3TR3KTF1SH (big blind) collected (1.34)

CoinPoker Hand #291254567: Hold'em No Limit (0.01/0.02 ) 2025/09/02 21:34:44 GMT
Table 'NL ₮2 I' 7-max Seat #6 is the button
Seat 1: rRubbB (2.20 in chips)
Seat 2: SoBrokeAF (2.52 in chips)
Seat 3: vicmitch (2.27 in chips)
Seat 4: MarditZion (2.05 in chips)
Seat 5: kanococo (0.62 in chips)
Seat 6: otaldojamal (3.44 in chips)
Seat 7: G3TR3KTF1SH (4.38 in chips)
G3TR3KTF1SH: posts small blind 0.01
rRubbB: posts big blind 0.02
*** HOLE CARDS ***
Dealt to kanococo [6s Js]
SoBrokeAF: folds
vicmitch: calls 0.02
MarditZion: folds
kanococo: raises 0.62 and is all-in
otaldojamal: folds
G3TR3KTF1SH: folds
rRubbB: folds
vicmitch: calls 0.60
*** FLOP *** [Ah 6h 7s]
*** TURN *** [Ah 6h 7s] [4h]
*** RIVER *** [Ah 6h 7s 4h] [8s]
*** SHOW DOWN ***
kanococo: shows [6s Js] (a pair of Sixes)
vicmitch: shows [8d 6d] (two pairs, Eights and Sixes)
vicmitch collected 1.21 from pot
*** SUMMARY ***
Total pot 1.27 | Rake 0.06
Board [ Ah 6h 7s 4h 8s ]
Game ended: 2025/09/02 21:35:13 GMT
Seat 1: rRubbB (big blind) folded before Flop
Seat 2: SoBrokeAF folded before Flop (didn't bet)
Seat 3: vicmitch showed [8d 6d] and won (1.21) with two pairs, Eights and Sixes
Seat 4: MarditZion folded before Flop (didn't bet)
Seat 5: kanococo showed [6s Js]
Seat 6: otaldojamal (button) folded before Flop (didn't bet)
Seat 7: G3TR3KTF1SH (small blind) folded before Flop

CoinPoker Hand #291718010: Hold'em No Limit (0.01/0.02 ) 2025/09/03 22:15:44 GMT
Table 'NL ₮2 III' 7-max Seat #5 is the button
Seat 1: AladeenMF (3.37 in chips)
Seat 2: AAdem (1.01 in chips)
Seat 3: HailToTheKing (2.83 in chips)
Seat 4: kanococo (2.00 in chips)
Seat 5: pscxlt (1.88 in chips)
Seat 6: Aceinthehole (2.27 in chips)
Seat 7: ColdFish (2.03 in chips)
Aceinthehole: posts small blind 0.01
ColdFish: posts big blind 0.02
kanococo: posts big blind 0.02
*** HOLE CARDS ***
Dealt to kanococo [Ah Kh]
AladeenMF: folds
AAdem: calls 0.02
HailToTheKing: folds
kanococo: raises 0.04 to 0.06
pscxlt: folds
Aceinthehole: folds
ColdFish: folds
AAdem: calls 0.04
*** FLOP *** [9s 9d Jd]
AAdem: checks
kanococo: checks
*** TURN *** [9s 9d Jd] [Kd]
AAdem: bets 0.06
kanococo: calls 0.06
*** RIVER *** [9s 9d Jd Kd] [Jc]
AAdem: bets 0.10
kanococo: calls 0.10
*** SHOW DOWN ***
AAdem: shows [8c Ad] (two pairs, Jacks and Nines)
kanococo: shows [Ah Kh] (two pairs, Kings and Jacks)
kanococo collected 0.45 from pot
*** SUMMARY ***
Total pot 0.47 | Rake 0.02
Board [ 9s 9d Jd Kd Jc ]
Game ended: 2025/09/03 22:16:46 GMT
Seat 1: AladeenMF folded before Flop (didn't bet)
Seat 2: AAdem showed [8c Ad]
Seat 3: HailToTheKing folded before Flop (didn't bet)
Seat 4: kanococo showed [Ah Kh] and won (0.45) with two pairs, Kings and Jacks
Seat 5: pscxlt (button) folded before Flop (didn't bet)
Seat 6: Aceinthehole (small blind) folded before Flop
Seat 7: ColdFish (big blind) folded before Flop

CoinPoker Hand #291718421: Hold'em No Limit (0.01/0.02 ) 2025/09/03 22:16:48 GMT
Table 'NL ₮2 III' 7-max Seat #6 is the button
Seat 1: AladeenMF (3.37 in chips)
Seat 2: AAdem (0.79 in chips)
Seat 3: HailToTheKing (2.83 in chips)
Seat 4: kanococo (2.23 in chips)
Seat 5: pscxlt (2.00 in chips)
Seat 6: Aceinthehole (2.26 in chips)
Seat 7: ColdFish (2.01 in chips)
ColdFish: posts small blind 0.01
AladeenMF: posts big blind 0.02
*** HOLE CARDS ***
Dealt to kanococo [8c Kd]
AAdem: folds
HailToTheKing: folds
kanococo: raises 0.02 to 0.04
pscxlt: folds
Aceinthehole: folds
ColdFish: folds
AladeenMF: calls 0.02
*** FLOP *** [Jd 7d 5d]
AladeenMF: checks
kanococo: checks
*** TURN *** [Jd 7d 5d] [Ks]
AladeenMF: checks
kanococo: bets 0.04
AladeenMF: calls 0.04
*** RIVER *** [Jd 7d 5d Ks] [5h]
AladeenMF: checks
kanococo: bets 0.16
AladeenMF: folds
Uncalled bet (0.16) returned to kanococo
kanococo collected 0.16 from pot
kanococo: doesn't show hand
*** SUMMARY ***
Total pot 0.17 | Rake 0.01
Board [ Jd 7d 5d Ks 5h ]
Game ended: 2025/09/03 22:17:35 GMT
Seat 1: AladeenMF (big blind) folded on the River
Seat 2: AAdem folded before Flop (didn't bet)
Seat 3: HailToTheKing folded before Flop (didn't bet)
Seat 4: kanococo collected (0.16)
Seat 5: pscxlt folded before Flop (didn't bet)
Seat 6: Aceinthehole (button) folded before Flop (didn't bet)
Seat 7: ColdFish (small blind) folded before Flop

CoinPoker Hand #291718725: Hold'em No Limit (0.01/0.02 ) 2025/09/03 22:17:37 GMT
Table 'NL ₮2 III' 7-max Seat #7 is the button
Seat 1: AladeenMF (3.29 in chips)
Seat 2: AAdem (0.79 in chips)
Seat 3: HailToTheKing (2.83 in chips)
Seat 4: kanococo (2.31 in chips)
Seat 5: pscxlt (2.00 in chips)
Seat 6: Aceinthehole (2.26 in chips)
Seat 7: ColdFish (2.00 in chips)
AladeenMF: posts small blind 0.01
AAdem: posts big blind 0.02
*** HOLE CARDS ***
Dealt to kanococo [8d 2s]
HailToTheKing: folds
kanococo: folds
pscxlt: raises 0.03 to 0.05
Aceinthehole: folds
ColdFish: raises 0.15 to 0.20
AladeenMF: folds
AAdem: raises 0.77 and is all-in
pscxlt: folds
ColdFish: calls 0.59
*** FLOP *** [Qh Kh 7c]
*** TURN *** [Qh Kh 7c] [5d]
*** RIVER *** [Qh Kh 7c 5d] [Th]
*** SHOW DOWN ***
AAdem: shows [Js As] (a straight, Ace high)
ColdFish: shows [Qs Ks] (two pairs, Kings and Queens)
AAdem collected 1.56 from pot
*** SUMMARY ***
Total pot 1.64 | Rake 0.08
Board [ Qh Kh 7c 5d Th ]
Game ended: 2025/09/03 22:18:27 GMT
Seat 1: AladeenMF (small blind) folded before Flop
Seat 2: AAdem (big blind) showed [Js As] and won (1.56) with a straight, Ace high
Seat 3: HailToTheKing folded before Flop (didn't bet)
Seat 4: kanococo folded before Flop (didn't bet)
Seat 5: pscxlt folded before Flop
Seat 6: Aceinthehole folded before Flop (didn't bet)
Seat 7: ColdFish (button) showed [Qs Ks]

CoinPoker Hand #291719045: Hold'em No Limit (0.01/0.02 ) 2025/09/03 22:18:29 GMT
Table 'NL ₮2 III' 7-max Seat #1 is the button
Seat 1: AladeenMF (3.28 in chips)
Seat 2: AAdem (1.56 in chips)
Seat 3: HailToTheKing (2.83 in chips)
Seat 4: kanococo (2.31 in chips)
Seat 5: pscxlt (1.95 in chips)
Seat 6: Aceinthehole (2.26 in chips)
Seat 7: ColdFish (2.00 in chips)
AAdem: posts small blind 0.01
HailToTheKing: posts big blind 0.02
*** HOLE CARDS ***
Dealt to kanococo [Ks 4d]
kanococo has timed out
kanococo activated time-bank (60 seconds)
kanococo: folds
pscxlt: folds
Aceinthehole: raises 0.04 to 0.06
ColdFish: folds
AladeenMF: folds
AAdem: calls 0.05
HailToTheKing: folds
*** FLOP *** [6d 5s 5d]
AAdem: checks
Aceinthehole: bets 0.09
AAdem: calls 0.09
*** TURN *** [6d 5s 5d] [Td]
AAdem: checks
Aceinthehole: checks
*** RIVER *** [6d 5s 5d Td] [Ts]
AAdem: checks
Aceinthehole: checks
*** SHOW DOWN ***
AAdem: shows [9c 7h] (two pairs, Tens and Fives)
Aceinthehole: shows [Qs Ah] (two pairs, Tens and Fives)
Aceinthehole collected 0.30 from pot
*** SUMMARY ***
Total pot 0.32 | Rake 0.02
Board [ 6d 5s 5d Td Ts ]
Game ended: 2025/09/03 22:20:11 GMT
Seat 1: AladeenMF (button) folded before Flop (didn't bet)
Seat 2: AAdem (small blind) showed [9c 7h]
Seat 3: HailToTheKing (big blind) folded before Flop
Seat 4: kanococo folded before Flop (didn't bet)
Seat 5: pscxlt folded before Flop (didn't bet)
Seat 6: Aceinthehole showed [Qs Ah] and won (0.30) with two pairs, Tens and Fives
Seat 7: ColdFish folded before Flop (didn't bet)

CoinPoker Hand #291719666: Hold'em No Limit (0.01/0.02 ) 2025/09/03 22:20:13 GMT
Table 'NL ₮2 III' 7-max Seat #2 is the button
Seat 1: AladeenMF (3.28 in chips)
Seat 2: AAdem (1.41 in chips)
Seat 3: HailToTheKing (2.81 in chips)
Seat 4: kanococo (2.31 in chips)
Seat 5: pscxlt (2.00 in chips)
Seat 6: Aceinthehole (2.41 in chips)
Seat 7: ColdFish (2.00 in chips)
HailToTheKing: posts small blind 0.01
kanococo: posts big blind 0.02
*** HOLE CARDS ***
Dealt to kanococo [9h 8h]
pscxlt: folds
Aceinthehole: folds
ColdFish: folds
AladeenMF: folds
AAdem: calls 0.02
HailToTheKing: raises 0.07 to 0.09
kanococo: calls 0.07
AAdem: calls 0.07
*** FLOP *** [9d Ac Tc]
HailToTheKing: checks
kanococo: checks
AAdem: checks
*** TURN *** [9d Ac Tc] [5s]
HailToTheKing: checks
kanococo: bets 0.13
AAdem: calls 0.13
HailToTheKing: folds
*** RIVER *** [9d Ac Tc 5s] [3c]
kanococo: bets 0.25
AAdem: folds
Uncalled bet (0.25) returned to kanococo
kanococo collected 0.50 from pot
kanococo: doesn't show hand
*** SUMMARY ***
Total pot 0.53 | Rake 0.03
Board [ 9d Ac Tc 5s 3c ]
Game ended: 2025/09/03 22:21:29 GMT
Seat 1: AladeenMF folded before Flop (didn't bet)
Seat 2: AAdem (button) folded on the River
Seat 3: HailToTheKing (small blind) folded on the Turn
Seat 4: kanococo (big blind) collected (0.50)
Seat 5: pscxlt folded before Flop (didn't bet)
Seat 6: Aceinthehole folded before Flop (didn't bet)
Seat 7: ColdFish folded before Flop (didn't bet)

CoinPoker Hand #291720059: Hold'em No Limit (0.01/0.02 ) 2025/09/03 22:21:31 GMT
Table 'NL ₮2 III' 7-max Seat #3 is the button
Seat 1: AladeenMF (3.28 in chips)
Seat 2: AAdem (1.19 in chips)
Seat 3: HailToTheKing (2.72 in chips)
Seat 4: kanococo (2.59 in chips)
Seat 5: pscxlt (2.00 in chips)
Seat 6: Aceinthehole (2.41 in chips)
Seat 7: ColdFish (2.00 in chips)
kanococo: posts small blind 0.01
pscxlt: posts big blind 0.02
*** HOLE CARDS ***
Dealt to kanococo [Kd 2c]
Aceinthehole: folds
ColdFish: folds
AladeenMF: folds
AAdem: calls 0.02
HailToTheKing: folds
kanococo: raises 0.02 to 0.04
pscxlt: folds
AAdem: calls 0.02
*** FLOP *** [5h 4h 3c]
kanococo: checks
AAdem: checks
*** TURN *** [5h 4h 3c] [9h]
kanococo: bets 0.04
AAdem: calls 0.04
*** RIVER *** [5h 4h 3c 9h] [Qh]
kanococo: bets 0.02
AAdem: raises 0.10 to 0.12
kanococo: folds
Uncalled bet (0.10) returned to AAdem
AAdem collected 0.21 from pot
AAdem: doesn't show hand
*** SUMMARY ***
Total pot 0.22 | Rake 0.01
Board [ 5h 4h 3c 9h Qh ]
Game ended: 2025/09/03 22:22:37 GMT
Seat 1: AladeenMF folded before Flop (didn't bet)
Seat 2: AAdem collected (0.21)
Seat 3: HailToTheKing (button) folded before Flop (didn't bet)
Seat 4: kanococo (small blind) folded on the River
Seat 5: pscxlt (big blind) folded before Flop
Seat 6: Aceinthehole folded before Flop (didn't bet)
Seat 7: ColdFish folded before Flop (didn't bet)

CoinPoker Hand #291720566: Hold'em No Limit (0.01/0.02 ) 2025/09/03 22:22:40 GMT
Table 'NL ₮2 III' 7-max Seat #4 is the button
Seat 1: AladeenMF (3.28 in chips)
Seat 2: AAdem (1.30 in chips)
Seat 3: HailToTheKing (2.72 in chips)
Seat 4: kanococo (2.49 in chips)
Seat 5: pscxlt (1.98 in chips)
Seat 6: Aceinthehole (2.41 in chips)
Seat 7: ColdFish (2.00 in chips)
pscxlt: posts small blind 0.01
Aceinthehole: posts big blind 0.02
*** HOLE CARDS ***
Dealt to kanococo [6s Ah]
ColdFish: folds
AladeenMF: folds
AAdem: calls 0.02
HailToTheKing: folds
kanococo: folds
pscxlt: folds
Aceinthehole: checks
*** FLOP *** [Js 2c 6c]
Aceinthehole: checks
AAdem: bets 0.02
Aceinthehole: calls 0.02
*** TURN *** [Js 2c 6c] [Td]
Aceinthehole: checks
AAdem: bets 0.04
Aceinthehole: calls 0.04
*** RIVER *** [Js 2c 6c Td] [7h]
Aceinthehole: checks
AAdem: checks
*** SHOW DOWN ***
Aceinthehole: shows [6d 8h] (a pair of Sixes)
AAdem: mucks hand
Aceinthehole collected 0.16 from pot
*** SUMMARY ***
Total pot 0.17 | Rake 0.01
Board [ Js 2c 6c Td 7h ]
Game ended: 2025/09/03 22:23:26 GMT
Seat 1: AladeenMF folded before Flop (didn't bet)
Seat 2: AAdem mucked
Seat 3: HailToTheKing folded before Flop (didn't bet)
Seat 4: kanococo (button) folded before Flop (didn't bet)
Seat 5: pscxlt (small blind) folded before Flop
Seat 6: Aceinthehole (big blind) showed [6d 8h] and won (0.16) with a pair of Sixes
Seat 7: ColdFish folded before Flop (didn't bet)

CoinPoker Hand #291720892: Hold'em No Limit (0.01/0.02 ) 2025/09/03 22:23:28 GMT
Table 'NL ₮2 III' 7-max Seat #5 is the button
Seat 1: AladeenMF (3.28 in chips)
Seat 2: AAdem (1.22 in chips)
Seat 3: HailToTheKing (2.72 in chips)
Seat 4: kanococo (2.49 in chips)
Seat 5: pscxlt (1.99 in chips)
Seat 6: Aceinthehole (2.49 in chips) is sitting out
Seat 7: ColdFish (2.00 in chips)
ColdFish: posts small blind 0.01
AladeenMF: posts big blind 0.02
*** HOLE CARDS ***
Dealt to kanococo [Js 8s]
AAdem: folds
HailToTheKing: folds
kanococo: folds
pscxlt: raises 0.03 to 0.05
ColdFish: folds
AladeenMF: folds
pscxlt collected 0.08 from pot
pscxlt: doesn't show hand
*** SUMMARY ***
Total pot 0.08 | Rake 0.00
Board [ ]
Game ended: 2025/09/03 22:23:50 GMT
Seat 1: AladeenMF (big blind) folded before Flop
Seat 2: AAdem folded before Flop (didn't bet)
Seat 3: HailToTheKing folded before Flop (didn't bet)
Seat 4: kanococo folded before Flop (didn't bet)
Seat 5: pscxlt (button) collected (0.08)
Seat 6: Aceinthehole folded before Flop (didn't bet)
Seat 7: ColdFish (small blind) folded before Flop

CoinPoker Hand #291721008: Hold'em No Limit (0.01/0.02 ) 2025/09/03 22:23:52 GMT
Table 'NL ₮2 III' 7-max Seat #7 is the button
Seat 1: AladeenMF (3.26 in chips)
Seat 2: AAdem (1.22 in chips)
Seat 3: HailToTheKing (2.72 in chips)
Seat 4: kanococo (2.49 in chips)
Seat 5: pscxlt (2.02 in chips)
Seat 6: Aceinthehole (2.49 in chips) is sitting out
Seat 7: ColdFish (1.99 in chips)
AladeenMF: posts small blind 0.01
AAdem: posts big blind 0.02
*** HOLE CARDS ***
Dealt to kanococo [3d Jc]
HailToTheKing: raises 0.03 to 0.05
kanococo: folds
pscxlt: folds
ColdFish: folds
AladeenMF: folds
AAdem: calls 0.03
*** FLOP *** [3h 7d 9d]
AAdem: checks
HailToTheKing: checks
*** TURN *** [3h 7d 9d] [9s]
AAdem: checks
HailToTheKing: checks
*** RIVER *** [3h 7d 9d 9s] [Qs]
AAdem: checks
HailToTheKing: checks
*** SHOW DOWN ***
AAdem: shows [8h 5s] (a pair of Nines)
HailToTheKing: shows [Jd Ks] (a pair of Nines)
HailToTheKing collected 0.10 from pot
*** SUMMARY ***
Total pot 0.11 | Rake 0.01
Board [ 3h 7d 9d 9s Qs ]
Game ended: 2025/09/03 22:24:47 GMT
Seat 1: AladeenMF (small blind) folded before Flop
Seat 2: AAdem (big blind) showed [8h 5s]
Seat 3: HailToTheKing showed [Jd Ks] and won (0.10) with a pair of Nines
Seat 4: kanococo folded before Flop (didn't bet)
Seat 5: pscxlt folded before Flop (didn't bet)
Seat 6: Aceinthehole folded before Flop (didn't bet)
Seat 7: ColdFish (button) folded before Flop (didn't bet)

CoinPoker Hand #291721306: Hold'em No Limit (0.01/0.02 ) 2025/09/03 22:24:48 GMT
Table 'NL ₮2 III' 7-max Seat #1 is the button
Seat 1: AladeenMF (3.25 in chips)
Seat 2: AAdem (1.17 in chips)
Seat 3: HailToTheKing (2.77 in chips)
Seat 4: kanococo (2.49 in chips)
Seat 5: pscxlt (2.02 in chips)
Seat 6: Aceinthehole (2.49 in chips) is sitting out
Seat 7: ColdFish (2.00 in chips)
AAdem: posts small blind 0.01
HailToTheKing: posts big blind 0.02
*** HOLE CARDS ***
Dealt to kanococo [9s Jc]
kanococo: folds
pscxlt: folds
ColdFish: folds
AladeenMF: folds
AAdem: calls 0.01
HailToTheKing: raises 0.06 to 0.08
AAdem: folds
HailToTheKing collected 0.10 from pot
HailToTheKing: doesn't show hand
*** SUMMARY ***
Total pot 0.10 | Rake 0.00
Board [ ]
Game ended: 2025/09/03 22:25:18 GMT
Seat 1: AladeenMF (button) folded before Flop (didn't bet)
Seat 2: AAdem (small blind) folded before Flop
Seat 3: HailToTheKing (big blind) collected (0.10)
Seat 4: kanococo folded before Flop (didn't bet)
Seat 5: pscxlt folded before Flop (didn't bet)
Seat 6: Aceinthehole folded before Flop (didn't bet)
Seat 7: ColdFish folded before Flop (didn't bet)

CoinPoker Hand #291721485: Hold'em No Limit (0.01/0.02 ) 2025/09/03 22:25:20 GMT
Table 'NL ₮2 III' 7-max Seat #2 is the button
Seat 1: AladeenMF (3.25 in chips)
Seat 2: AAdem (1.15 in chips)
Seat 3: HailToTheKing (2.79 in chips)
Seat 4: kanococo (2.49 in chips)
Seat 5: pscxlt (2.02 in chips)
Seat 6: Aceinthehole (2.49 in chips) is sitting out
Seat 7: ColdFish (2.00 in chips)
HailToTheKing: posts small blind 0.01
kanococo: posts big blind 0.02
*** HOLE CARDS ***
Dealt to kanococo [7d Kh]
pscxlt: folds
ColdFish: folds
AladeenMF: folds
AAdem: calls 0.02
HailToTheKing: folds
kanococo: checks
*** FLOP *** [8c Qs 9d]
kanococo: checks
AAdem: checks
*** TURN *** [8c Qs 9d] [7c]
kanococo: checks
AAdem: bets 0.02
kanococo: calls 0.02
*** RIVER *** [8c Qs 9d 7c] [3h]
kanococo: bets 0.09
AAdem: calls 0.09
*** SHOW DOWN ***
kanococo: shows [7d Kh] (a pair of Sevens)
AAdem: shows [9c As] (a pair of Nines)
AAdem collected 0.26 from pot
*** SUMMARY ***
Total pot 0.27 | Rake 0.01
Board [ 8c Qs 9d 7c 3h ]
Game ended: 2025/09/03 22:26:09 GMT
Seat 1: AladeenMF folded before Flop (didn't bet)
Seat 2: AAdem (button) showed [9c As] and won (0.26) with a pair of Nines
Seat 3: HailToTheKing (small blind) folded before Flop
Seat 4: kanococo (big blind) showed [7d Kh]
Seat 5: pscxlt folded before Flop (didn't bet)
Seat 6: Aceinthehole folded before Flop (didn't bet)
Seat 7: ColdFish folded before Flop (didn't bet)

CoinPoker Hand #291721820: Hold'em No Limit (0.01/0.02 ) 2025/09/03 22:26:10 GMT
Table 'NL ₮2 III' 7-max Seat #3 is the button
Seat 1: AladeenMF (3.25 in chips)
Seat 2: AAdem (1.28 in chips)
Seat 3: HailToTheKing (2.78 in chips)
Seat 4: kanococo (2.36 in chips)
Seat 5: pscxlt (2.02 in chips)
Seat 6: Aceinthehole (2.49 in chips) is sitting out
Seat 7: ColdFish (2.00 in chips)
kanococo: posts small blind 0.01
pscxlt: posts big blind 0.02
*** HOLE CARDS ***
Dealt to kanococo [8s Kh]
ColdFish: folds
AladeenMF: folds
AAdem: calls 0.02
HailToTheKing: folds
kanococo: calls 0.01
pscxlt: checks
*** FLOP *** [9d 5c Kc]
kanococo: checks
pscxlt: bets 0.03
AAdem: calls 0.03
kanococo: raises 0.03 to 0.06
pscxlt: folds
AAdem: calls 0.03
*** TURN *** [9d 5c Kc] [7h]
kanococo: bets 0.10
AAdem: calls 0.10
*** RIVER *** [9d 5c Kc 7h] [Kd]
kanococo: bets 0.39
AAdem: calls 0.39
*** SHOW DOWN ***
kanococo: shows [8s Kh] (three of kind, Kings)
AAdem: shows [Ks Jd] (three of kind, Kings)
AAdem collected 1.13 from pot
*** SUMMARY ***
Total pot 1.19 | Rake 0.06
Board [ 9d 5c Kc 7h Kd ]
Game ended: 2025/09/03 22:27:18 GMT
Seat 1: AladeenMF folded before Flop (didn't bet)
Seat 2: AAdem showed [Ks Jd] and won (1.13) with three of kind, Kings
Seat 3: HailToTheKing (button) folded before Flop (didn't bet)
Seat 4: kanococo (small blind) showed [8s Kh]
Seat 5: pscxlt (big blind) folded on the Flop
Seat 6: Aceinthehole folded before Flop (didn't bet)
Seat 7: ColdFish folded before Flop (didn't bet)

CoinPoker Hand #291722269: Hold'em No Limit (0.01/0.02 ) 2025/09/03 22:27:20 GMT
Table 'NL ₮2 III' 7-max Seat #4 is the button
Seat 1: AladeenMF (3.25 in chips)
Seat 2: AAdem (1.84 in chips)
Seat 3: HailToTheKing (2.78 in chips)
Seat 4: kanococo (1.79 in chips)
Seat 5: pscxlt (1.97 in chips)
Seat 6: Aceinthehole (2.49 in chips) is sitting out
Seat 7: ColdFish (2.00 in chips)
pscxlt: posts small blind 0.01
ColdFish: posts big blind 0.02
*** HOLE CARDS ***
Dealt to kanococo [5d 3s]
AladeenMF: folds
AAdem: calls 0.02
HailToTheKing: folds
kanococo: folds
pscxlt: raises 0.06 to 0.08
ColdFish: folds
AAdem: calls 0.06
*** FLOP *** [4d 7h Kc]
pscxlt: bets 0.06
AAdem: folds
Uncalled bet (0.06) returned to pscxlt
pscxlt collected 0.17 from pot
pscxlt: doesn't show hand
*** SUMMARY ***
Total pot 0.18 | Rake 0.01
Board [ 4d 7h Kc ]
Game ended: 2025/09/03 22:28:03 GMT
Seat 1: AladeenMF folded before Flop (didn't bet)
Seat 2: AAdem folded on the Flop
Seat 3: HailToTheKing folded before Flop (didn't bet)
Seat 4: kanococo (button) folded before Flop (didn't bet)
Seat 5: pscxlt (small blind) collected (0.17)
Seat 6: Aceinthehole folded before Flop (didn't bet)
Seat 7: ColdFish (big blind) folded before Flop

CoinPoker Hand #291722501: Hold'em No Limit (0.01/0.02 ) 2025/09/03 22:28:05 GMT
Table 'NL ₮2 III' 7-max Seat #5 is the button
Seat 1: AladeenMF (3.25 in chips)
Seat 2: AAdem (1.76 in chips)
Seat 3: HailToTheKing (2.78 in chips)
Seat 4: kanococo (1.79 in chips)
Seat 5: pscxlt (2.06 in chips)
Seat 6: Aceinthehole (2.49 in chips) is sitting out
Seat 7: ColdFish (1.98 in chips)
ColdFish: posts small blind 0.01
AladeenMF: posts big blind 0.02
*** HOLE CARDS ***
Dealt to kanococo [6h 6d]
AAdem: folds
HailToTheKing: folds
kanococo: raises 0.04 to 0.06
pscxlt: folds
ColdFish: calls 0.05
AladeenMF: calls 0.04
*** FLOP *** [Qd 8c 6s]
ColdFish: checks
AladeenMF: checks
kanococo: bets 0.08
ColdFish: calls 0.08
AladeenMF: calls 0.08
*** TURN *** [Qd 8c 6s] [Qc]
ColdFish: checks
AladeenMF: bets 0.16
kanococo: raises 0.36 to 0.52
ColdFish: folds
AladeenMF: calls 0.36
*** RIVER *** [Qd 8c 6s Qc] [Qh]
AladeenMF: checks
kanococo: checks
*** SHOW DOWN ***
AladeenMF: shows [5d 7s] (three of kind, Queens)
kanococo: shows [6h 6d] (a full house, Queens over Sixes)
kanococo collected 1.39 from pot
*** SUMMARY ***
Total pot 1.46 | Rake 0.07
Board [ Qd 8c 6s Qc Qh ]
Game ended: 2025/09/03 22:29:08 GMT
Seat 1: AladeenMF (big blind) showed [5d 7s]
Seat 2: AAdem folded before Flop (didn't bet)
Seat 3: HailToTheKing folded before Flop (didn't bet)
Seat 4: kanococo showed [6h 6d] and won (1.39) with a full house, Queens over Sixes
Seat 5: pscxlt (button) folded before Flop (didn't bet)
Seat 6: Aceinthehole folded before Flop (didn't bet)
Seat 7: ColdFish (small blind) folded on the Turn

CoinPoker Hand #291722869: Hold'em No Limit (0.01/0.02 ) 2025/09/03 22:29:10 GMT
Table 'NL ₮2 III' 7-max Seat #7 is the button
Seat 1: AladeenMF (2.59 in chips)
Seat 2: AAdem (1.76 in chips)
Seat 3: HailToTheKing (2.78 in chips)
Seat 4: kanococo (2.52 in chips)
Seat 5: pscxlt (2.06 in chips)
Seat 6: Aceinthehole (2.49 in chips) out of hand
Seat 7: ColdFish (2.00 in chips)
AladeenMF: posts small blind 0.01
AAdem: posts big blind 0.02
*** HOLE CARDS ***
Dealt to kanococo [Qc As]
HailToTheKing: folds
kanococo: raises 0.04 to 0.06
pscxlt: folds
ColdFish: folds
AladeenMF: folds
AAdem: folds
kanococo collected 0.09 from pot
kanococo: doesn't show hand
*** SUMMARY ***
Total pot 0.09 | Rake 0.00
Board [ ]
Game ended: 2025/09/03 22:29:40 GMT
Seat 1: AladeenMF (small blind) folded before Flop
Seat 2: AAdem (big blind) folded before Flop
Seat 3: HailToTheKing folded before Flop (didn't bet)
Seat 4: kanococo collected (0.09)
Seat 5: pscxlt folded before Flop (didn't bet)
Seat 6: Aceinthehole folded before Flop (didn't bet)
Seat 7: ColdFish (button) folded before Flop (didn't bet)

CoinPoker Hand #291723030: Hold'em No Limit (0.01/0.02 ) 2025/09/03 22:29:42 GMT
Table 'NL ₮2 III' 7-max Seat #1 is the button
Seat 1: AladeenMF (2.58 in chips)
Seat 2: AAdem (1.74 in chips)
Seat 3: HailToTheKing (2.78 in chips)
Seat 4: kanococo (2.55 in chips)
Seat 5: pscxlt (2.06 in chips)
Seat 6: Aceinthehole (2.49 in chips) out of hand
Seat 7: ColdFish (2.00 in chips)
AAdem: posts small blind 0.01
HailToTheKing: posts big blind 0.02
*** HOLE CARDS ***
Dealt to kanococo [Ad 2h]
kanococo: calls 0.02
pscxlt: folds
ColdFish: raises 0.06 to 0.08
AladeenMF: folds
AAdem: folds
HailToTheKing: raises 0.12 to 0.20
kanococo: folds
ColdFish: calls 0.12
*** FLOP *** [6c 7d Ts]
HailToTheKing: bets 0.20
ColdFish: folds
Uncalled bet (0.20) returned to HailToTheKing
HailToTheKing collected 0.41 from pot
HailToTheKing: doesn't show hand
*** SUMMARY ***
Total pot 0.43 | Rake 0.02
Board [ 6c 7d Ts ]
Game ended: 2025/09/03 22:30:40 GMT
Seat 1: AladeenMF (button) folded before Flop (didn't bet)
Seat 2: AAdem (small blind) folded before Flop
Seat 3: HailToTheKing (big blind) collected (0.41)
Seat 4: kanococo folded before Flop
Seat 5: pscxlt folded before Flop (didn't bet)
Seat 6: Aceinthehole folded before Flop (didn't bet)
Seat 7: ColdFish folded on the Flop

CoinPoker Hand #291723366: Hold'em No Limit (0.01/0.02 ) 2025/09/03 22:30:41 GMT
Table 'NL ₮2 III' 7-max Seat #2 is the button
Seat 1: AladeenMF (2.58 in chips)
Seat 2: AAdem (1.73 in chips)
Seat 3: HailToTheKing (2.99 in chips)
Seat 4: kanococo (2.53 in chips)
Seat 5: pscxlt (2.06 in chips)
Seat 6: Aceinthehole (2.49 in chips) out of hand
Seat 7: ColdFish (2.00 in chips)
HailToTheKing: posts small blind 0.01
kanococo: posts big blind 0.02
*** HOLE CARDS ***
Dealt to kanococo [Th 3s]
pscxlt: folds
ColdFish: raises 0.04 to 0.06
AladeenMF: folds
AAdem: folds
HailToTheKing: folds
kanococo: calls 0.04
*** FLOP *** [7c Qs 3d]
kanococo: checks
ColdFish: bets 0.08
kanococo: calls 0.08
*** TURN *** [7c Qs 3d] [3c]
kanococo: checks
ColdFish: bets 0.18
kanococo: calls 0.18
*** RIVER *** [7c Qs 3d 3c] [Kc]
kanococo: bets 0.62
ColdFish: folds
Uncalled bet (0.62) returned to kanococo
kanococo collected 0.62 from pot
kanococo: doesn't show hand
*** SUMMARY ***
Total pot 0.65 | Rake 0.03
Board [ 7c Qs 3d 3c Kc ]
Game ended: 2025/09/03 22:31:44 GMT
Seat 1: AladeenMF folded before Flop (didn't bet)
Seat 2: AAdem (button) folded before Flop (didn't bet)
Seat 3: HailToTheKing (small blind) folded before Flop
Seat 4: kanococo (big blind) collected (0.62)
Seat 5: pscxlt folded before Flop (didn't bet)
Seat 6: Aceinthehole folded before Flop (didn't bet)
Seat 7: ColdFish folded on the River

CoinPoker Hand #291723710: Hold'em No Limit (0.01/0.02 ) 2025/09/03 22:31:46 GMT
Table 'NL ₮2 III' 7-max Seat #3 is the button
Seat 1: AladeenMF (2.58 in chips)
Seat 2: AAdem (1.73 in chips)
Seat 3: HailToTheKing (2.98 in chips)
Seat 4: kanococo (2.83 in chips)
Seat 5: pscxlt (2.06 in chips)
Seat 6: Aceinthehole (2.49 in chips) out of hand
Seat 7: ColdFish (2.00 in chips)
kanococo: posts small blind 0.01
pscxlt: posts big blind 0.02
*** HOLE CARDS ***
Dealt to kanococo [Ac Ts]
ColdFish: folds
AladeenMF: folds
AAdem: folds
HailToTheKing: raises 0.04 to 0.06
kanococo: calls 0.05
pscxlt: calls 0.04
*** FLOP *** [9h 4c Kh]
kanococo: bets 0.04
pscxlt: calls 0.04
HailToTheKing: folds
*** TURN *** [9h 4c Kh] [8h]
kanococo: checks
pscxlt: checks
*** RIVER *** [9h 4c Kh 8h] [4h]
kanococo: checks
pscxlt: checks
*** SHOW DOWN ***
kanococo: shows [Ac Ts] (a pair of Fours)
pscxlt: shows [3d Kd] (two pairs, Kings and Fours)
pscxlt collected 0.25 from pot
*** SUMMARY ***
Total pot 0.26 | Rake 0.01
Board [ 9h 4c Kh 8h 4h ]
Game ended: 2025/09/03 22:32:51 GMT
Seat 1: AladeenMF folded before Flop (didn't bet)
Seat 2: AAdem folded before Flop (didn't bet)
Seat 3: HailToTheKing (button) folded on the Flop
Seat 4: kanococo (small blind) showed [Ac Ts]
Seat 5: pscxlt (big blind) showed [3d Kd] and won (0.25) with two pairs, Kings and Fours
Seat 6: Aceinthehole folded before Flop (didn't bet)
Seat 7: ColdFish folded before Flop (didn't bet)

CoinPoker Hand #291724055: Hold'em No Limit (0.01/0.02 ) 2025/09/03 22:32:54 GMT
Table 'NL ₮2 III' 7-max Seat #4 is the button
Seat 1: AladeenMF (2.58 in chips)
Seat 2: AAdem (1.73 in chips)
Seat 3: HailToTheKing (2.92 in chips)
Seat 4: kanococo (2.73 in chips)
Seat 5: pscxlt (2.21 in chips)
Seat 6: Aceinthehole (2.49 in chips)
Seat 7: ColdFish (2.00 in chips)
pscxlt: posts small blind 0.01
Aceinthehole: posts big blind 0.02
*** HOLE CARDS ***
Dealt to kanococo [9d Kc]
ColdFish: folds
AladeenMF: folds
AAdem: folds
HailToTheKing: folds
kanococo: raises 0.04 to 0.06
pscxlt: folds
Aceinthehole: folds
kanococo collected 0.09 from pot
kanococo: doesn't show hand
*** SUMMARY ***
Total pot 0.09 | Rake 0.00
Board [ ]
Game ended: 2025/09/03 22:33:22 GMT
Seat 1: AladeenMF folded before Flop (didn't bet)
Seat 2: AAdem folded before Flop (didn't bet)
Seat 3: HailToTheKing folded before Flop (didn't bet)
Seat 4: kanococo (button) collected (0.09)
Seat 5: pscxlt (small blind) folded before Flop
Seat 6: Aceinthehole (big blind) folded before Flop
Seat 7: ColdFish folded before Flop (didn't bet)

CoinPoker Hand #291724225: Hold'em No Limit (0.01/0.02 ) 2025/09/03 22:33:25 GMT
Table 'NL ₮2 III' 7-max Seat #5 is the button
Seat 1: AladeenMF (2.58 in chips)
Seat 2: AAdem (1.73 in chips)
Seat 3: HailToTheKing (2.92 in chips)
Seat 4: kanococo (2.76 in chips)
Seat 5: pscxlt (2.20 in chips)
Seat 6: Aceinthehole (2.47 in chips)
Seat 7: ColdFish (2.00 in chips)
Aceinthehole: posts small blind 0.01
ColdFish: posts big blind 0.02
*** HOLE CARDS ***
Dealt to kanococo [5c 3s]
AladeenMF: folds
AAdem: folds
HailToTheKing: folds
kanococo: folds
pscxlt: raises 0.03 to 0.05
Aceinthehole: folds
ColdFish: folds
pscxlt collected 0.08 from pot
pscxlt: doesn't show hand
*** SUMMARY ***
Total pot 0.08 | Rake 0.00
Board [ ]
Game ended: 2025/09/03 22:33:54 GMT
Seat 1: AladeenMF folded before Flop (didn't bet)
Seat 2: AAdem folded before Flop (didn't bet)
Seat 3: HailToTheKing folded before Flop (didn't bet)
Seat 4: kanococo folded before Flop (didn't bet)
Seat 5: pscxlt (button) collected (0.08)
Seat 6: Aceinthehole (small blind) folded before Flop
Seat 7: ColdFish (big blind) folded before Flop

CoinPoker Hand #291724478: Hold'em No Limit (0.01/0.02 ) 2025/09/03 22:33:56 GMT
Table 'NL ₮2 III' 7-max Seat #6 is the button
Seat 1: AladeenMF (2.58 in chips)
Seat 2: AAdem (1.73 in chips)
Seat 3: HailToTheKing (2.92 in chips)
Seat 4: kanococo (2.76 in chips)
Seat 5: pscxlt (2.23 in chips)
Seat 6: Aceinthehole (2.46 in chips)
Seat 7: ColdFish (2.00 in chips)
ColdFish: posts small blind 0.01
AladeenMF: posts big blind 0.02
*** HOLE CARDS ***
Dealt to kanococo [9h 8d]
AAdem: calls 0.02
HailToTheKing: folds
kanococo: folds
pscxlt: raises 0.06 to 0.08
Aceinthehole: folds
ColdFish: folds
AladeenMF: folds
AAdem: folds
pscxlt collected 0.13 from pot
pscxlt: doesn't show hand
*** SUMMARY ***
Total pot 0.13 | Rake 0.00
Board [ ]
Game ended: 2025/09/03 22:34:25 GMT
Seat 1: AladeenMF (big blind) folded before Flop
Seat 2: AAdem folded before Flop
Seat 3: HailToTheKing folded before Flop (didn't bet)
Seat 4: kanococo folded before Flop (didn't bet)
Seat 5: pscxlt collected (0.13)
Seat 6: Aceinthehole (button) folded before Flop (didn't bet)
Seat 7: ColdFish (small blind) folded before Flop

CoinPoker Hand #291724657: Hold'em No Limit (0.01/0.02 ) 2025/09/03 22:34:27 GMT
Table 'NL ₮2 III' 7-max Seat #7 is the button
Seat 1: AladeenMF (2.56 in chips)
Seat 2: AAdem (1.71 in chips)
Seat 3: HailToTheKing (2.92 in chips)
Seat 4: kanococo (2.76 in chips)
Seat 5: pscxlt (2.28 in chips)
Seat 6: Aceinthehole (2.46 in chips)
Seat 7: ColdFish (1.99 in chips)
AladeenMF: posts small blind 0.01
AAdem: posts big blind 0.02
*** HOLE CARDS ***
Dealt to kanococo [Td 4s]
HailToTheKing: raises 0.03 to 0.05
kanococo: folds
pscxlt: folds
Aceinthehole: folds
ColdFish: folds
AladeenMF: folds
AAdem: calls 0.03
*** FLOP *** [9c 3c Jh]
AAdem: checks
HailToTheKing: checks
*** TURN *** [9c 3c Jh] [8h]
AAdem: checks
HailToTheKing: checks
*** RIVER *** [9c 3c Jh 8h] [As]
AAdem: checks
HailToTheKing: bets 0.06
AAdem: folds
Uncalled bet (0.06) returned to HailToTheKing
HailToTheKing collected 0.10 from pot
HailToTheKing: doesn't show hand
*** SUMMARY ***
Total pot 0.11 | Rake 0.01
Board [ 9c 3c Jh 8h As ]
Game ended: 2025/09/03 22:35:33 GMT
Seat 1: AladeenMF (small blind) folded before Flop
Seat 2: AAdem (big blind) folded on the River
Seat 3: HailToTheKing collected (0.10)
Seat 4: kanococo folded before Flop (didn't bet)
Seat 5: pscxlt folded before Flop (didn't bet)
Seat 6: Aceinthehole folded before Flop (didn't bet)
Seat 7: ColdFish (button) folded before Flop (didn't bet)

CoinPoker Hand #291725088: Hold'em No Limit (0.01/0.02 ) 2025/09/03 22:35:35 GMT
Table 'NL ₮2 III' 7-max Seat #1 is the button
Seat 1: AladeenMF (2.55 in chips)
Seat 2: AAdem (1.66 in chips)
Seat 3: HailToTheKing (2.97 in chips)
Seat 4: kanococo (2.76 in chips)
Seat 5: pscxlt (2.28 in chips)
Seat 6: Aceinthehole (2.46 in chips)
Seat 7: ColdFish (2.00 in chips)
AAdem: posts small blind 0.01
HailToTheKing: posts big blind 0.02
*** HOLE CARDS ***
Dealt to kanococo [7c Ts]
kanococo: folds
pscxlt: folds
Aceinthehole: folds
ColdFish: folds
AladeenMF: folds
AAdem: folds
HailToTheKing collected 0.03 from pot
HailToTheKing: doesn't show hand
*** SUMMARY ***
Total pot 0.03 | Rake 0.00
Board [ ]
Game ended: 2025/09/03 22:35:52 GMT
Seat 1: AladeenMF (button) folded before Flop (didn't bet)
Seat 2: AAdem (small blind) folded before Flop
Seat 3: HailToTheKing (big blind) collected (0.03)
Seat 4: kanococo folded before Flop (didn't bet)
Seat 5: pscxlt folded before Flop (didn't bet)
Seat 6: Aceinthehole folded before Flop (didn't bet)
Seat 7: ColdFish folded before Flop (didn't bet)

CoinPoker Hand #291725167: Hold'em No Limit (0.01/0.02 ) 2025/09/03 22:35:55 GMT
Table 'NL ₮2 III' 7-max Seat #2 is the button
Seat 1: AladeenMF (2.55 in chips)
Seat 2: AAdem (1.65 in chips)
Seat 3: HailToTheKing (2.98 in chips)
Seat 4: kanococo (2.76 in chips)
Seat 5: pscxlt (2.28 in chips)
Seat 6: Aceinthehole (2.46 in chips)
Seat 7: ColdFish (2.00 in chips)
HailToTheKing: posts small blind 0.01
kanococo: posts big blind 0.02
*** HOLE CARDS ***
Dealt to kanococo [6s Jc]
pscxlt: folds
Aceinthehole: folds
ColdFish: folds
AladeenMF: folds
AAdem: calls 0.02
HailToTheKing: folds
kanococo: checks
*** FLOP *** [Qs 4d 6c]
kanococo: bets 0.06
AAdem: calls 0.06
*** TURN *** [Qs 4d 6c] [Kd]
kanococo: checks
AAdem: checks
*** RIVER *** [Qs 4d 6c Kd] [Ah]
kanococo: bets 0.08
AAdem: folds
Uncalled bet (0.08) returned to kanococo
kanococo collected 0.16 from pot
kanococo: doesn't show hand
*** SUMMARY ***
Total pot 0.17 | Rake 0.01
Board [ Qs 4d 6c Kd Ah ]
Game ended: 2025/09/03 22:36:55 GMT
Seat 1: AladeenMF folded before Flop (didn't bet)
Seat 2: AAdem (button) folded on the River
Seat 3: HailToTheKing (small blind) folded before Flop
Seat 4: kanococo (big blind) collected (0.16)
Seat 5: pscxlt folded before Flop (didn't bet)
Seat 6: Aceinthehole folded before Flop (didn't bet)
Seat 7: ColdFish folded before Flop (didn't bet)

CoinPoker Hand #291725587: Hold'em No Limit (0.01/0.02 ) 2025/09/03 22:36:58 GMT
Table 'NL ₮2 III' 7-max Seat #3 is the button
Seat 1: AladeenMF (2.55 in chips)
Seat 2: AAdem (1.57 in chips)
Seat 3: HailToTheKing (2.97 in chips)
Seat 4: kanococo (2.84 in chips)
Seat 5: pscxlt (2.28 in chips)
Seat 6: Aceinthehole (2.46 in chips)
Seat 7: ColdFish (2.00 in chips)
kanococo: posts small blind 0.01
pscxlt: posts big blind 0.02
*** HOLE CARDS ***
Dealt to kanococo [3c 4c]
Aceinthehole: raises 0.04 to 0.06
ColdFish: folds
AladeenMF: folds
AAdem: folds
HailToTheKing: folds
kanococo: folds
pscxlt: folds
Aceinthehole collected 0.09 from pot
Aceinthehole: doesn't show hand
*** SUMMARY ***
Total pot 0.09 | Rake 0.00
Board [ ]
Game ended: 2025/09/03 22:37:29 GMT
Seat 1: AladeenMF folded before Flop (didn't bet)
Seat 2: AAdem folded before Flop (didn't bet)
Seat 3: HailToTheKing (button) folded before Flop (didn't bet)
Seat 4: kanococo (small blind) folded before Flop
Seat 5: pscxlt (big blind) folded before Flop
Seat 6: Aceinthehole collected (0.09)
Seat 7: ColdFish folded before Flop (didn't bet)

CoinPoker Hand #291725836: Hold'em No Limit (0.01/0.02 ) 2025/09/03 22:37:31 GMT
Table 'NL ₮2 III' 7-max Seat #4 is the button
Seat 1: AladeenMF (2.55 in chips)
Seat 2: AAdem (1.57 in chips)
Seat 3: HailToTheKing (2.97 in chips)
Seat 4: kanococo (2.83 in chips)
Seat 5: pscxlt (2.26 in chips)
Seat 6: Aceinthehole (2.49 in chips)
Seat 7: ColdFish (2.00 in chips)
pscxlt: posts small blind 0.01
Aceinthehole: posts big blind 0.02
*** HOLE CARDS ***
Dealt to kanococo [5c 2h]
ColdFish: folds
AladeenMF: folds
AAdem: calls 0.02
HailToTheKing: folds
kanococo: folds
pscxlt: calls 0.01
Aceinthehole: checks
*** FLOP *** [3c 6s 9c]
pscxlt: checks
Aceinthehole: checks
AAdem: checks
*** TURN *** [3c 6s 9c] [6d]
pscxlt: checks
Aceinthehole: checks
AAdem: checks
*** RIVER *** [3c 6s 9c 6d] [Kh]
pscxlt: checks
Aceinthehole: checks
AAdem: checks
*** SHOW DOWN ***
pscxlt: shows [9s 7s] (two pairs, Nines and Sixes)
Aceinthehole: mucks hand
AAdem: mucks hand
pscxlt collected 0.06 from pot
*** SUMMARY ***
Total pot 0.06 | Rake 0.00
Board [ 3c 6s 9c 6d Kh ]
Game ended: 2025/09/03 22:38:28 GMT
Seat 1: AladeenMF folded before Flop (didn't bet)
Seat 2: AAdem mucked
Seat 3: HailToTheKing folded before Flop (didn't bet)
Seat 4: kanococo (button) folded before Flop (didn't bet)
Seat 5: pscxlt (small blind) showed [9s 7s] and won (0.06) with two pairs, Nines and Sixes
Seat 6: Aceinthehole (big blind) mucked
Seat 7: ColdFish folded before Flop (didn't bet)

CoinPoker Hand #291726221: Hold'em No Limit (0.01/0.02 ) 2025/09/03 22:38:30 GMT
Table 'NL ₮2 III' 7-max Seat #5 is the button
Seat 1: AladeenMF (2.55 in chips)
Seat 2: AAdem (1.55 in chips)
Seat 3: HailToTheKing (2.97 in chips)
Seat 4: kanococo (2.83 in chips)
Seat 5: pscxlt (2.30 in chips)
Seat 6: Aceinthehole (2.47 in chips)
Seat 7: ColdFish (2.00 in chips)
Aceinthehole: posts small blind 0.01
ColdFish: posts big blind 0.02
*** HOLE CARDS ***
Dealt to kanococo [Ts 3c]
AladeenMF: folds
AAdem: folds
HailToTheKing: raises 0.04 to 0.06
kanococo: folds
pscxlt: folds
Aceinthehole: folds
ColdFish: folds
HailToTheKing collected 0.09 from pot
HailToTheKing: doesn't show hand
*** SUMMARY ***
Total pot 0.09 | Rake 0.00
Board [ ]
Game ended: 2025/09/03 22:38:55 GMT
Seat 1: AladeenMF folded before Flop (didn't bet)
Seat 2: AAdem folded before Flop (didn't bet)
Seat 3: HailToTheKing collected (0.09)
Seat 4: kanococo folded before Flop (didn't bet)
Seat 5: pscxlt (button) folded before Flop (didn't bet)
Seat 6: Aceinthehole (small blind) folded before Flop
Seat 7: ColdFish (big blind) folded before Flop

CoinPoker Hand #291726388: Hold'em No Limit (0.01/0.02 ) 2025/09/03 22:38:57 GMT
Table 'NL ₮2 III' 7-max Seat #6 is the button
Seat 1: AladeenMF (2.55 in chips)
Seat 2: AAdem (1.55 in chips)
Seat 3: HailToTheKing (3.00 in chips)
Seat 4: kanococo (2.83 in chips)
Seat 5: pscxlt (2.30 in chips)
Seat 6: Aceinthehole (2.46 in chips)
Seat 7: ColdFish (2.00 in chips)
ColdFish: posts small blind 0.01
AladeenMF: posts big blind 0.02
*** HOLE CARDS ***
Dealt to kanococo [Qs Tc]
AAdem: folds
HailToTheKing: raises 0.02 to 0.04
kanococo: calls 0.04
pscxlt: folds
Aceinthehole: calls 0.04
ColdFish: folds
AladeenMF: folds
*** FLOP *** [Ac 3d 4d]
HailToTheKing: checks
kanococo: bets 0.07
Aceinthehole: folds
HailToTheKing: calls 0.07
*** TURN *** [Ac 3d 4d] [Qd]
HailToTheKing: checks
kanococo: checks
*** RIVER *** [Ac 3d 4d Qd] [Ts]
HailToTheKing: checks
kanococo: bets 0.14
HailToTheKing: folds
Uncalled bet (0.14) returned to kanococo
kanococo collected 0.28 from pot
kanococo: doesn't show hand
*** SUMMARY ***
Total pot 0.29 | Rake 0.01
Board [ Ac 3d 4d Qd Ts ]
Game ended: 2025/09/03 22:40:01 GMT
Seat 1: AladeenMF (big blind) folded before Flop
Seat 2: AAdem folded before Flop (didn't bet)
Seat 3: HailToTheKing folded on the River
Seat 4: kanococo collected (0.28)
Seat 5: pscxlt folded before Flop (didn't bet)
Seat 6: Aceinthehole (button) folded on the Flop
Seat 7: ColdFish (small blind) folded before Flop

CoinPoker Hand #291726870: Hold'em No Limit (0.01/0.02 ) 2025/09/03 22:40:03 GMT
Table 'NL ₮2 III' 7-max Seat #7 is the button
Seat 1: AladeenMF (2.53 in chips)
Seat 2: AAdem (1.55 in chips)
Seat 3: HailToTheKing (2.89 in chips)
Seat 4: kanococo (3.00 in chips)
Seat 5: pscxlt (2.30 in chips)
Seat 6: Aceinthehole (2.42 in chips)
Seat 7: ColdFish (2.00 in chips)
AladeenMF: posts small blind 0.01
AAdem: posts big blind 0.02
*** HOLE CARDS ***
Dealt to kanococo [3s 6s]
HailToTheKing: folds
kanococo: folds
pscxlt: raises 0.03 to 0.05
Aceinthehole: calls 0.05
ColdFish: folds
AladeenMF: folds
AAdem: calls 0.03
*** FLOP *** [7d 9h 2d]
AAdem: checks
pscxlt: checks
Aceinthehole: checks
*** TURN *** [7d 9h 2d] [Kd]
AAdem: checks
pscxlt: bets 0.07
Aceinthehole: calls 0.07
AAdem: calls 0.07
*** RIVER *** [7d 9h 2d Kd] [5s]
AAdem: checks
pscxlt: checks
Aceinthehole: bets 0.24
AAdem: folds
pscxlt: folds
Uncalled bet (0.24) returned to Aceinthehole
Aceinthehole collected 0.35 from pot
Aceinthehole: doesn't show hand
*** SUMMARY ***
Total pot 0.37 | Rake 0.02
Board [ 7d 9h 2d Kd 5s ]
Game ended: 2025/09/03 22:41:37 GMT
Seat 1: AladeenMF (small blind) folded before Flop
Seat 2: AAdem (big blind) folded on the River
Seat 3: HailToTheKing folded before Flop (didn't bet)
Seat 4: kanococo folded before Flop (didn't bet)
Seat 5: pscxlt folded on the River
Seat 6: Aceinthehole collected (0.35)
Seat 7: ColdFish (button) folded before Flop (didn't bet)

CoinPoker Hand #291727573: Hold'em No Limit (0.01/0.02 ) 2025/09/03 22:41:39 GMT
Table 'NL ₮2 III' 7-max Seat #1 is the button
Seat 1: AladeenMF (2.52 in chips)
Seat 2: AAdem (1.43 in chips)
Seat 3: HailToTheKing (2.89 in chips)
Seat 4: kanococo (3.00 in chips)
Seat 5: pscxlt (2.18 in chips)
Seat 6: Aceinthehole (2.65 in chips)
Seat 7: ColdFish (2.00 in chips)
AAdem: posts small blind 0.01
HailToTheKing: posts big blind 0.02
*** HOLE CARDS ***
Dealt to kanococo [Ah 6h]
kanococo: raises 0.02 to 0.04
pscxlt: folds
Aceinthehole: folds
ColdFish: folds
AladeenMF: folds
AAdem: calls 0.03
HailToTheKing: calls 0.02
*** FLOP *** [7s 3c 9h]
AAdem: checks
HailToTheKing: checks
kanococo: checks
*** TURN *** [7s 3c 9h] [4h]
AAdem: checks
HailToTheKing: checks
kanococo: checks
*** RIVER *** [7s 3c 9h 4h] [Kc]
AAdem: checks
HailToTheKing: checks
kanococo: checks
*** SHOW DOWN ***
AAdem: shows [Qs Jc] (King high)
HailToTheKing: shows [3s 5s] (a pair of Threes)
kanococo: mucks hand
HailToTheKing collected 0.11 from pot
*** SUMMARY ***
Total pot 0.12 | Rake 0.01
Board [ 7s 3c 9h 4h Kc ]
Game ended: 2025/09/03 22:43:08 GMT
Seat 1: AladeenMF (button) folded before Flop (didn't bet)
Seat 2: AAdem (small blind) showed [Qs Jc]
Seat 3: HailToTheKing (big blind) showed [3s 5s] and won (0.11) with a pair of Threes
Seat 4: kanococo mucked
Seat 5: pscxlt folded before Flop (didn't bet)
Seat 6: Aceinthehole folded before Flop (didn't bet)
Seat 7: ColdFish folded before Flop (didn't bet)

CoinPoker Hand #291728026: Hold'em No Limit (0.01/0.02 ) 2025/09/03 22:43:10 GMT
Table 'NL ₮2 III' 7-max Seat #2 is the button
Seat 1: AladeenMF (2.52 in chips)
Seat 2: AAdem (1.39 in chips)
Seat 3: HailToTheKing (2.96 in chips)
Seat 4: kanococo (2.96 in chips)
Seat 5: pscxlt (2.18 in chips)
Seat 6: Aceinthehole (2.65 in chips)
Seat 7: ColdFish (2.00 in chips)
HailToTheKing: posts small blind 0.01
kanococo: posts big blind 0.02
*** HOLE CARDS ***
Dealt to kanococo [As 5d]
pscxlt: folds
Aceinthehole: folds
ColdFish: folds
AladeenMF: folds
AAdem: folds
HailToTheKing: folds
kanococo collected 0.03 from pot
kanococo: doesn't show hand
*** SUMMARY ***
Total pot 0.03 | Rake 0.00
Board [ ]
Game ended: 2025/09/03 22:43:23 GMT
Seat 1: AladeenMF folded before Flop (didn't bet)
Seat 2: AAdem (button) folded before Flop (didn't bet)
Seat 3: HailToTheKing (small blind) folded before Flop
Seat 4: kanococo (big blind) collected (0.03)
Seat 5: pscxlt folded before Flop (didn't bet)
Seat 6: Aceinthehole folded before Flop (didn't bet)
Seat 7: ColdFish folded before Flop (didn't bet)

CoinPoker Hand #291728076: Hold'em No Limit (0.01/0.02 ) 2025/09/03 22:43:25 GMT
Table 'NL ₮2 III' 7-max Seat #3 is the button
Seat 1: AladeenMF (2.52 in chips)
Seat 2: AAdem (1.39 in chips)
Seat 3: HailToTheKing (2.95 in chips)
Seat 4: kanococo (2.97 in chips)
Seat 5: pscxlt (2.18 in chips)
Seat 6: Aceinthehole (2.65 in chips)
Seat 7: ColdFish (2.00 in chips)
kanococo: posts small blind 0.01
pscxlt: posts big blind 0.02
*** HOLE CARDS ***
Dealt to kanococo [4s Tc]
Aceinthehole: folds
ColdFish: folds
AladeenMF: raises 0.04 to 0.06
AAdem: calls 0.06
HailToTheKing: folds
kanococo: folds
pscxlt: calls 0.04
*** FLOP *** [4h Jc Ac]
pscxlt: checks
AladeenMF: bets 0.04
AAdem: folds
pscxlt: calls 0.04
*** TURN *** [4h Jc Ac] [5c]
pscxlt: checks
AladeenMF: checks
*** RIVER *** [4h Jc Ac 5c] [As]
pscxlt: bets 0.06
AladeenMF: folds
Uncalled bet (0.06) returned to pscxlt
pscxlt collected 0.26 from pot
pscxlt: doesn't show hand
*** SUMMARY ***
Total pot 0.27 | Rake 0.01
Board [ 4h Jc Ac 5c As ]
Game ended: 2025/09/03 22:44:26 GMT
Seat 1: AladeenMF folded on the River
Seat 2: AAdem folded on the Flop
Seat 3: HailToTheKing (button) folded before Flop (didn't bet)
Seat 4: kanococo (small blind) folded before Flop
Seat 5: pscxlt (big blind) collected (0.26)
Seat 6: Aceinthehole folded before Flop (didn't bet)
Seat 7: ColdFish folded before Flop (didn't bet)

CoinPoker Hand #291728507: Hold'em No Limit (0.01/0.02 ) 2025/09/03 22:44:28 GMT
Table 'NL ₮2 III' 7-max Seat #4 is the button
Seat 1: AladeenMF (2.42 in chips)
Seat 2: AAdem (1.33 in chips)
Seat 3: HailToTheKing (2.95 in chips)
Seat 4: kanococo (2.96 in chips)
Seat 5: pscxlt (2.34 in chips)
Seat 6: Aceinthehole (2.65 in chips)
Seat 7: ColdFish (2.00 in chips)
pscxlt: posts small blind 0.01
Aceinthehole: posts big blind 0.02
*** HOLE CARDS ***
Dealt to kanococo [7c 6c]
ColdFish: folds
AladeenMF: folds
AAdem: calls 0.02
HailToTheKing: folds
HailToTheKing is disconnected
HailToTheKing has reconnected
kanococo: folds
pscxlt: calls 0.01
Aceinthehole: checks
*** FLOP *** [9s Kc Th]
pscxlt: checks
Aceinthehole: checks
Aceinthehole is disconnected
AAdem: checks
Aceinthehole has reconnected
*** TURN *** [9s Kc Th] [5h]
pscxlt: checks
Aceinthehole: checks
AAdem: checks
*** RIVER *** [9s Kc Th 5h] [Qh]
pscxlt: checks
Aceinthehole: checks
AAdem: checks
*** SHOW DOWN ***
pscxlt: shows [4c 4d] (a pair of Fours)
Aceinthehole: mucks hand
AAdem: mucks hand
pscxlt collected 0.06 from pot
*** SUMMARY ***
Total pot 0.06 | Rake 0.00
Board [ 9s Kc Th 5h Qh ]
Game ended: 2025/09/03 22:45:28 GMT
Seat 1: AladeenMF folded before Flop (didn't bet)
Seat 2: AAdem mucked
Seat 3: HailToTheKing folded before Flop (didn't bet)
Seat 4: kanococo (button) folded before Flop (didn't bet)
Seat 5: pscxlt (small blind) showed [4c 4d] and won (0.06) with a pair of Fours
Seat 6: Aceinthehole (big blind) mucked
Seat 7: ColdFish folded before Flop (didn't bet)

CoinPoker Hand #291729037: Hold'em No Limit (0.01/0.02 ) 2025/09/03 22:45:30 GMT
Table 'NL ₮2 III' 7-max Seat #5 is the button
Seat 1: AladeenMF (2.42 in chips)
Seat 2: AAdem (1.31 in chips)
Seat 3: HailToTheKing (2.95 in chips)
Seat 4: kanococo (2.96 in chips)
Seat 5: pscxlt (2.38 in chips)
Seat 6: Aceinthehole (2.63 in chips)
Seat 7: ColdFish (2.00 in chips)
Aceinthehole: posts small blind 0.01
ColdFish: posts big blind 0.02
*** HOLE CARDS ***
Dealt to kanococo [Ah Tc]
AladeenMF: folds
AAdem: folds
HailToTheKing: folds
kanococo: raises 0.02 to 0.04
pscxlt: folds
Aceinthehole: folds
ColdFish: folds
kanococo collected 0.07 from pot
kanococo: doesn't show hand
*** SUMMARY ***
Total pot 0.07 | Rake 0.00
Board [ ]
Game ended: 2025/09/03 22:45:50 GMT
Seat 1: AladeenMF folded before Flop (didn't bet)
Seat 2: AAdem folded before Flop (didn't bet)
Seat 3: HailToTheKing folded before Flop (didn't bet)
Seat 4: kanococo collected (0.07)
Seat 5: pscxlt (button) folded before Flop (didn't bet)
Seat 6: Aceinthehole (small blind) folded before Flop
Seat 7: ColdFish (big blind) folded before Flop

CoinPoker Hand #291729169: Hold'em No Limit (0.01/0.02 ) 2025/09/03 22:45:52 GMT
Table 'NL ₮2 III' 7-max Seat #6 is the button
Seat 1: AladeenMF (2.42 in chips)
Seat 2: AAdem (1.31 in chips)
Seat 3: HailToTheKing (2.95 in chips)
Seat 4: kanococo (2.99 in chips)
Seat 5: pscxlt (2.38 in chips)
Seat 6: Aceinthehole (2.62 in chips)
Seat 7: ColdFish (2.00 in chips)
ColdFish: posts small blind 0.01
AladeenMF: posts big blind 0.02
*** HOLE CARDS ***
Dealt to kanococo [9s Ac]
AAdem: calls 0.02
HailToTheKing: raises 0.06 to 0.08
kanococo: folds
pscxlt: folds
Aceinthehole: folds
ColdFish: folds
AladeenMF: folds
AAdem: folds
HailToTheKing collected 0.13 from pot
HailToTheKing: doesn't show hand
*** SUMMARY ***
Total pot 0.13 | Rake 0.00
Board [ ]
Game ended: 2025/09/03 22:46:16 GMT
Seat 1: AladeenMF (big blind) folded before Flop
Seat 2: AAdem folded before Flop
Seat 3: HailToTheKing collected (0.13)
Seat 4: kanococo folded before Flop (didn't bet)
Seat 5: pscxlt folded before Flop (didn't bet)
Seat 6: Aceinthehole (button) folded before Flop (didn't bet)
Seat 7: ColdFish (small blind) folded before Flop

CoinPoker Hand #291729344: Hold'em No Limit (0.01/0.02 ) 2025/09/03 22:46:18 GMT
Table 'NL ₮2 III' 7-max Seat #7 is the button
Seat 1: AladeenMF (2.40 in chips)
Seat 2: AAdem (1.29 in chips)
Seat 3: HailToTheKing (3.00 in chips)
Seat 4: kanococo (2.99 in chips)
Seat 5: pscxlt (2.38 in chips)
Seat 6: Aceinthehole (2.62 in chips)
Seat 7: ColdFish (1.99 in chips)
AladeenMF: posts small blind 0.01
AAdem: posts big blind 0.02
*** HOLE CARDS ***
Dealt to kanococo [Qh 3h]
HailToTheKing: folds
kanococo: folds
pscxlt: raises 0.03 to 0.05
Aceinthehole: folds
ColdFish: raises 0.13 to 0.18
AladeenMF: folds
AAdem: folds
pscxlt: calls 0.13
*** FLOP *** [8c Kd 8s]
pscxlt: checks
ColdFish: bets 0.12
pscxlt: folds
Uncalled bet (0.12) returned to ColdFish
ColdFish collected 0.37 from pot
ColdFish: doesn't show hand
*** SUMMARY ***
Total pot 0.39 | Rake 0.02
Board [ 8c Kd 8s ]
Game ended: 2025/09/03 22:47:20 GMT
Seat 1: AladeenMF (small blind) folded before Flop
Seat 2: AAdem (big blind) folded before Flop
Seat 3: HailToTheKing folded before Flop (didn't bet)
Seat 4: kanococo folded before Flop (didn't bet)
Seat 5: pscxlt folded on the Flop
Seat 6: Aceinthehole folded before Flop (didn't bet)
Seat 7: ColdFish (button) collected (0.37)

CoinPoker Hand #291729648: Hold'em No Limit (0.01/0.02 ) 2025/09/03 22:47:22 GMT
Table 'NL ₮2 III' 7-max Seat #1 is the button
Seat 1: AladeenMF (2.39 in chips)
Seat 2: AAdem (1.27 in chips)
Seat 3: HailToTheKing (3.00 in chips)
Seat 4: kanococo (2.99 in chips)
Seat 5: pscxlt (2.20 in chips)
Seat 6: Aceinthehole (2.62 in chips)
Seat 7: ColdFish (2.18 in chips)
AAdem: posts small blind 0.01
HailToTheKing: posts big blind 0.02
*** HOLE CARDS ***
Dealt to kanococo [9h Ks]
kanococo: raises 0.02 to 0.04
pscxlt: folds
Aceinthehole: calls 0.04
ColdFish: folds
AladeenMF: folds
AAdem: calls 0.03
HailToTheKing: raises 0.08 to 0.12
kanococo: calls 0.08
Aceinthehole: calls 0.08
AAdem: folds
*** FLOP *** [Jh Kc 3s]
HailToTheKing: bets 0.14
kanococo: calls 0.14
Aceinthehole: calls 0.14
*** TURN *** [Jh Kc 3s] [3c]
HailToTheKing: checks
kanococo: bets 0.39
Aceinthehole: folds
HailToTheKing: folds
Uncalled bet (0.39) returned to kanococo
kanococo collected 0.78 from pot
kanococo: doesn't show hand
*** SUMMARY ***
Total pot 0.82 | Rake 0.04
Board [ Jh Kc 3s 3c ]
Game ended: 2025/09/03 22:48:24 GMT
Seat 1: AladeenMF (button) folded before Flop (didn't bet)
Seat 2: AAdem (small blind) folded before Flop
Seat 3: HailToTheKing (big blind) folded on the Turn
Seat 4: kanococo collected (0.78)
Seat 5: pscxlt folded before Flop (didn't bet)
Seat 6: Aceinthehole folded on the Turn
Seat 7: ColdFish folded before Flop (didn't bet)

CoinPoker Hand #291730048: Hold'em No Limit (0.01/0.02 ) 2025/09/03 22:48:27 GMT
Table 'NL ₮2 III' 7-max Seat #2 is the button
Seat 1: AladeenMF (2.39 in chips)
Seat 2: AAdem (1.23 in chips)
Seat 3: HailToTheKing (2.74 in chips)
Seat 4: kanococo (3.51 in chips)
Seat 5: pscxlt (2.20 in chips)
Seat 6: Aceinthehole (2.36 in chips)
Seat 7: ColdFish (2.18 in chips)
HailToTheKing: posts small blind 0.01
kanococo: posts big blind 0.02
*** HOLE CARDS ***
Dealt to kanococo [3s 3h]
pscxlt: folds
Aceinthehole: raises 0.04 to 0.06
ColdFish: folds
AladeenMF: folds
AAdem: folds
HailToTheKing: folds
kanococo: calls 0.04
*** FLOP *** [Ad 8s Ah]
kanococo: bets 0.06
Aceinthehole: raises 0.16 to 0.22
kanococo has timed out
kanococo activated time-bank (56 seconds)
kanococo: folds
Uncalled bet (0.16) returned to Aceinthehole
Aceinthehole collected 0.24 from pot
Aceinthehole: doesn't show hand
*** SUMMARY ***
Total pot 0.25 | Rake 0.01
Board [ Ad 8s Ah ]
Game ended: 2025/09/03 22:49:33 GMT
Seat 1: AladeenMF folded before Flop (didn't bet)
Seat 2: AAdem (button) folded before Flop (didn't bet)
Seat 3: HailToTheKing (small blind) folded before Flop
Seat 4: kanococo (big blind) folded on the Flop
Seat 5: pscxlt folded before Flop (didn't bet)
Seat 6: Aceinthehole collected (0.24)
Seat 7: ColdFish folded before Flop (didn't bet)

CoinPoker Hand #291730471: Hold'em No Limit (0.01/0.02 ) 2025/09/03 22:49:35 GMT
Table 'NL ₮2 III' 7-max Seat #3 is the button
Seat 1: AladeenMF (2.39 in chips)
Seat 2: AAdem (1.23 in chips)
Seat 3: HailToTheKing (2.73 in chips)
Seat 4: kanococo (3.39 in chips)
Seat 5: pscxlt (2.20 in chips)
Seat 6: Aceinthehole (2.48 in chips)
Seat 7: ColdFish (2.18 in chips)
kanococo: posts small blind 0.01
pscxlt: posts big blind 0.02
*** HOLE CARDS ***
Dealt to kanococo [2s 7h]
Aceinthehole: folds
ColdFish: raises 0.04 to 0.06
AladeenMF: folds
AAdem: folds
HailToTheKing: folds
kanococo: folds
pscxlt: folds
ColdFish collected 0.09 from pot
ColdFish: doesn't show hand
*** SUMMARY ***
Total pot 0.09 | Rake 0.00
Board [ ]
Game ended: 2025/09/03 22:50:03 GMT
Seat 1: AladeenMF folded before Flop (didn't bet)
Seat 2: AAdem folded before Flop (didn't bet)
Seat 3: HailToTheKing (button) folded before Flop (didn't bet)
Seat 4: kanococo (small blind) folded before Flop
Seat 5: pscxlt (big blind) folded before Flop
Seat 6: Aceinthehole folded before Flop (didn't bet)
Seat 7: ColdFish collected (0.09)

CoinPoker Hand #291730678: Hold'em No Limit (0.01/0.02 ) 2025/09/03 22:50:05 GMT
Table 'NL ₮2 III' 7-max Seat #4 is the button
Seat 1: AladeenMF (2.39 in chips)
Seat 2: AAdem (1.23 in chips)
Seat 3: HailToTheKing (2.73 in chips)
Seat 4: kanococo (3.38 in chips)
Seat 5: pscxlt (2.18 in chips)
Seat 6: Aceinthehole (2.48 in chips)
Seat 7: ColdFish (2.21 in chips)
pscxlt: posts small blind 0.01
Aceinthehole: posts big blind 0.02
*** HOLE CARDS ***
Dealt to kanococo [8h 4h]
ColdFish: folds
AladeenMF: folds
AAdem: folds
HailToTheKing: raises 0.04 to 0.06
kanococo: folds
pscxlt: calls 0.05
Aceinthehole: folds
*** FLOP *** [7c Jc 7s]
pscxlt: checks
HailToTheKing: checks
*** TURN *** [7c Jc 7s] [Qh]
pscxlt: checks
HailToTheKing: bets 0.08
pscxlt: folds
Uncalled bet (0.08) returned to HailToTheKing
HailToTheKing collected 0.13 from pot
HailToTheKing: doesn't show hand
*** SUMMARY ***
Total pot 0.14 | Rake 0.01
Board [ 7c Jc 7s Qh ]
Game ended: 2025/09/03 22:51:12 GMT
Seat 1: AladeenMF folded before Flop (didn't bet)
Seat 2: AAdem folded before Flop (didn't bet)
Seat 3: HailToTheKing collected (0.13)
Seat 4: kanococo (button) folded before Flop (didn't bet)
Seat 5: pscxlt (small blind) folded on the Turn
Seat 6: Aceinthehole (big blind) folded before Flop
Seat 7: ColdFish folded before Flop (didn't bet)

CoinPoker Hand #291731078: Hold'em No Limit (0.01/0.02 ) 2025/09/03 22:51:14 GMT
Table 'NL ₮2 III' 7-max Seat #5 is the button
Seat 1: AladeenMF (2.39 in chips)
Seat 2: AAdem (1.23 in chips)
Seat 3: HailToTheKing (2.80 in chips)
Seat 4: kanococo (3.38 in chips)
Seat 5: pscxlt (2.12 in chips)
Seat 6: Aceinthehole (2.46 in chips)
Seat 7: ColdFish (2.21 in chips)
Aceinthehole: posts small blind 0.01
ColdFish: posts big blind 0.02
*** HOLE CARDS ***
Dealt to kanococo [Jh 9c]
AladeenMF: folds
AAdem: folds
HailToTheKing: folds
kanococo: raises 0.02 to 0.04
pscxlt: folds
Aceinthehole: folds
ColdFish: folds
kanococo collected 0.07 from pot
kanococo: doesn't show hand
*** SUMMARY ***
Total pot 0.07 | Rake 0.00
Board [ ]
Game ended: 2025/09/03 22:51:45 GMT
Seat 1: AladeenMF folded before Flop (didn't bet)
Seat 2: AAdem folded before Flop (didn't bet)
Seat 3: HailToTheKing folded before Flop (didn't bet)
Seat 4: kanococo collected (0.07)
Seat 5: pscxlt (button) folded before Flop (didn't bet)
Seat 6: Aceinthehole (small blind) folded before Flop
Seat 7: ColdFish (big blind) folded before Flop

CoinPoker Hand #291731240: Hold'em No Limit (0.01/0.02 ) 2025/09/03 22:51:47 GMT
Table 'NL ₮2 III' 7-max Seat #6 is the button
Seat 1: AladeenMF (2.39 in chips)
Seat 2: AAdem (1.23 in chips)
Seat 3: HailToTheKing (2.80 in chips)
Seat 4: kanococo (3.41 in chips)
Seat 5: pscxlt (2.12 in chips)
Seat 6: Aceinthehole (2.45 in chips)
Seat 7: ColdFish (2.19 in chips)
ColdFish: posts small blind 0.01
AladeenMF: posts big blind 0.02
*** HOLE CARDS ***
Dealt to kanococo [9h 4h]
AAdem: folds
HailToTheKing: folds
kanococo: folds
pscxlt: folds
Aceinthehole: raises 0.03 to 0.05
ColdFish: folds
AladeenMF: folds
Aceinthehole collected 0.08 from pot
Aceinthehole: doesn't show hand
*** SUMMARY ***
Total pot 0.08 | Rake 0.00
Board [ ]
Game ended: 2025/09/03 22:52:18 GMT
Seat 1: AladeenMF (big blind) folded before Flop
Seat 2: AAdem folded before Flop (didn't bet)
Seat 3: HailToTheKing folded before Flop (didn't bet)
Seat 4: kanococo folded before Flop (didn't bet)
Seat 5: pscxlt folded before Flop (didn't bet)
Seat 6: Aceinthehole (button) collected (0.08)
Seat 7: ColdFish (small blind) folded before Flop

CoinPoker Hand #291731505: Hold'em No Limit (0.01/0.02 ) 2025/09/03 22:52:20 GMT
Table 'NL ₮2 III' 7-max Seat #7 is the button
Seat 1: AladeenMF (2.37 in chips)
Seat 2: AAdem (1.23 in chips)
Seat 3: HailToTheKing (2.80 in chips)
Seat 4: kanococo (3.41 in chips)
Seat 5: pscxlt (2.12 in chips)
Seat 6: Aceinthehole (2.48 in chips)
Seat 7: ColdFish (2.18 in chips)
AladeenMF: posts small blind 0.01
AAdem: posts big blind 0.02
*** HOLE CARDS ***
Dealt to kanococo [Ad 8s]
HailToTheKing: folds
kanococo: folds
pscxlt: folds
Aceinthehole: folds
ColdFish: folds
AladeenMF: folds
AAdem collected 0.03 from pot
AAdem: doesn't show hand
*** SUMMARY ***
Total pot 0.03 | Rake 0.00
Board [ ]
Game ended: 2025/09/03 22:52:50 GMT
Seat 1: AladeenMF (small blind) folded before Flop
Seat 2: AAdem (big blind) collected (0.03)
Seat 3: HailToTheKing folded before Flop (didn't bet)
Seat 4: kanococo folded before Flop (didn't bet)
Seat 5: pscxlt folded before Flop (didn't bet)
Seat 6: Aceinthehole folded before Flop (didn't bet)
Seat 7: ColdFish (button) folded before Flop (didn't bet)

CoinPoker Hand #291764751: Hold'em No Limit (0.01/0.02 ) 2025/09/04 00:56:03 GMT
Table 'NL ₮2 IV' 7-max Seat #4 is the button
Seat 1: Rocky27 (2.00 in chips)
Seat 3: kanococo (2.00 in chips) out of hand
Seat 4: yonmon (1.97 in chips)
Seat 5: KiMiPhantom (0.83 in chips)
Seat 6: JT0 (2.00 in chips)
Seat 7: chakhssin (2.00 in chips) out of hand
KiMiPhantom: posts small blind 0.01
JT0: posts big blind 0.02
Rocky27: posts big blind 0.02
*** HOLE CARDS ***
Rocky27: checks
yonmon: folds
KiMiPhantom: folds
JT0: checks
*** FLOP *** [3c 4s 6c]
JT0: checks
Rocky27: bets 0.02
JT0: raises 0.10 to 0.12
Rocky27: raises 0.12 to 0.24
JT0: calls 0.12
*** TURN *** [3c 4s 6c] [Qh]
JT0: checks
Rocky27: bets 0.19
JT0: calls 0.19
*** RIVER *** [3c 4s 6c Qh] [Ad]
JT0: checks
Rocky27: bets 0.43
JT0: folds
Uncalled bet (0.43) returned to Rocky27
Rocky27 collected 0.86 from pot
Rocky27: doesn't show hand
*** SUMMARY ***
Total pot 0.91 | Rake 0.05
Board [ 3c 4s 6c Qh Ad ]
Game ended: 2025/09/04 00:57:38 GMT
Seat 1: Rocky27 collected (0.86)
Seat 3: kanococo folded before Flop (didn't bet)
Seat 4: yonmon (button) folded before Flop (didn't bet)
Seat 5: KiMiPhantom (small blind) folded before Flop
Seat 6: JT0 (big blind) folded on the River
Seat 7: chakhssin folded before Flop (didn't bet)

CoinPoker Hand #291765018: Hold'em No Limit (0.01/0.02 ) 2025/09/04 00:57:40 GMT
Table 'NL ₮2 IV' 7-max Seat #5 is the button
Seat 1: Rocky27 (2.41 in chips)
Seat 3: kanococo (2.00 in chips)
Seat 4: yonmon (1.97 in chips)
Seat 5: KiMiPhantom (0.82 in chips)
Seat 6: JT0 (2.00 in chips)
Seat 7: chakhssin (2.00 in chips)
JT0: posts small blind 0.01
chakhssin: posts big blind 0.02
kanococo: posts big blind 0.02
*** HOLE CARDS ***
Dealt to kanococo [4d 6d]
Rocky27: folds
kanococo: checks
yonmon: folds
KiMiPhantom: raises 0.02 to 0.04
JT0: folds
chakhssin: calls 0.02
kanococo: calls 0.02
*** FLOP *** [2h 5c 3h]
chakhssin: checks
kanococo: bets 0.06
KiMiPhantom: calls 0.06
chakhssin: raises 0.14 to 0.20
kanococo: calls 0.14
KiMiPhantom: raises 0.72 and is all-in
chakhssin: raises 1.76 and is all-in
kanococo: calls 1.76 and is all-in
*** TURN *** [2h 5c 3h] [Ad]
*** RIVER *** [2h 5c 3h Ad] [6h]
*** SHOW DOWN ***
chakhssin: shows [8c 8s] (a pair of Eights)
kanococo: shows [4d 6d] (a straight, Six high)
kanococo collected 2.28 from side-pot 1
KiMiPhantom: shows [Th Jh] (a flush, Jack high)
KiMiPhantom collected 2.35 from pot
*** SUMMARY ***
Total pot 4.83 | Rake 0.20
Board [ 2h 5c 3h Ad 6h ]
Game ended: 2025/09/04 00:59:08 GMT
Seat 1: Rocky27 folded before Flop (didn't bet)
Seat 3: kanococo showed [4d 6d] and won (2.28) with a straight, Six high
Seat 4: yonmon folded before Flop (didn't bet)
Seat 5: KiMiPhantom (button) showed [Th Jh] and won (2.35) with a flush, Jack high
Seat 6: JT0 (small blind) folded before Flop
Seat 7: chakhssin (big blind) showed [8c 8s]

CoinPoker Hand #291765212: Hold'em No Limit (0.01/0.02 ) 2025/09/04 00:59:09 GMT
Table 'NL ₮2 IV' 7-max Seat #6 is the button
Seat 1: Thwingfish (0.91 in chips)
Seat 3: kanococo (2.28 in chips)
Seat 4: yonmon (1.97 in chips)
Seat 5: KiMiPhantom (2.35 in chips)
Seat 6: JT0 (1.99 in chips)
Seat 7: chakhssin (2.00 in chips)
chakhssin: posts small blind 0.01
Thwingfish: posts big blind 0.02
*** HOLE CARDS ***
Dealt to kanococo [3c Jh]
kanococo: folds
yonmon: folds
KiMiPhantom: raises 0.02 to 0.04
JT0: folds
chakhssin: folds
Thwingfish: folds
KiMiPhantom collected 0.07 from pot
KiMiPhantom: doesn't show hand
*** SUMMARY ***
Total pot 0.07 | Rake 0.00
Board [ ]
Game ended: 2025/09/04 00:59:26 GMT
Seat 1: Thwingfish (big blind) folded before Flop
Seat 3: kanococo folded before Flop (didn't bet)
Seat 4: yonmon folded before Flop (didn't bet)
Seat 5: KiMiPhantom collected (0.07)
Seat 6: JT0 (button) folded before Flop (didn't bet)
Seat 7: chakhssin (small blind) folded before Flop

CoinPoker Hand #291765254: Hold'em No Limit (0.01/0.02 ) 2025/09/04 00:59:27 GMT
Table 'NL ₮2 IV' 7-max Seat #7 is the button
Seat 1: Thwingfish (0.89 in chips)
Seat 3: kanococo (2.28 in chips)
Seat 4: yonmon (1.97 in chips)
Seat 5: KiMiPhantom (2.38 in chips)
Seat 6: JT0 (2.00 in chips)
Seat 7: chakhssin (1.99 in chips)
Thwingfish: posts small blind 0.01
kanococo: posts big blind 0.02
*** HOLE CARDS ***
Dealt to kanococo [4d 2s]
yonmon: raises 0.02 to 0.04
KiMiPhantom: folds
JT0: folds
chakhssin: folds
Thwingfish: calls 0.03
kanococo: folds
*** FLOP *** [8s 5c 7c]
Thwingfish: checks
yonmon: checks
*** TURN *** [8s 5c 7c] [8d]
Thwingfish: checks
yonmon: bets 0.04
Thwingfish: folds
Uncalled bet (0.04) returned to yonmon
yonmon collected 0.09 from pot
yonmon: doesn't show hand
*** SUMMARY ***
Total pot 0.10 | Rake 0.01
Board [ 8s 5c 7c 8d ]
Game ended: 2025/09/04 01:00:19 GMT
Seat 1: Thwingfish (small blind) folded on the Turn
Seat 3: kanococo (big blind) folded before Flop
Seat 4: yonmon collected (0.09)
Seat 5: KiMiPhantom folded before Flop (didn't bet)
Seat 6: JT0 folded before Flop (didn't bet)
Seat 7: chakhssin (button) folded before Flop (didn't bet)

CoinPoker Hand #291765368: Hold'em No Limit (0.01/0.02 ) 2025/09/04 01:00:21 GMT
Table 'NL ₮2 IV' 7-max Seat #1 is the button
Seat 1: Thwingfish (0.85 in chips)
Seat 3: kanococo (2.26 in chips)
Seat 4: yonmon (2.02 in chips)
Seat 5: KiMiPhantom (2.38 in chips)
Seat 6: JT0 (2.00 in chips)
Seat 7: chakhssin (2.00 in chips)
kanococo: posts small blind 0.01
yonmon: posts big blind 0.02
*** HOLE CARDS ***
Dealt to kanococo [Tc 7h]
KiMiPhantom: folds
JT0: folds
chakhssin: raises 0.03 to 0.05
Thwingfish: calls 0.05
kanococo: folds
yonmon: folds
*** FLOP *** [9d 6h 8h]
chakhssin: bets 0.06
Thwingfish: folds
Uncalled bet (0.06) returned to chakhssin
chakhssin collected 0.12 from pot
chakhssin: doesn't show hand
*** SUMMARY ***
Total pot 0.13 | Rake 0.01
Board [ 9d 6h 8h ]
Game ended: 2025/09/04 01:01:04 GMT
Seat 1: Thwingfish (button) folded on the Flop
Seat 3: kanococo (small blind) folded before Flop
Seat 4: yonmon (big blind) folded before Flop
Seat 5: KiMiPhantom folded before Flop (didn't bet)
Seat 6: JT0 folded before Flop (didn't bet)
Seat 7: chakhssin collected (0.12)

CoinPoker Hand #291765487: Hold'em No Limit (0.01/0.02 ) 2025/09/04 01:01:06 GMT
Table 'NL ₮2 IV' 7-max Seat #3 is the button
Seat 1: Thwingfish (0.80 in chips)
Seat 2: Rocky27 (2.41 in chips)
Seat 3: kanococo (2.25 in chips)
Seat 4: yonmon (2.00 in chips)
Seat 6: JT0 (2.00 in chips)
Seat 7: chakhssin (2.07 in chips)
yonmon: posts small blind 0.01
JT0: posts big blind 0.02
Rocky27: posts big blind 0.02
*** HOLE CARDS ***
Dealt to kanococo [9c Js]
chakhssin: folds
Thwingfish: folds
Rocky27: raises 0.02 to 0.04
kanococo: calls 0.04
yonmon: folds
JT0: calls 0.02
*** FLOP *** [Ad 3h Ks]
JT0: checks
Rocky27: bets 0.04
kanococo: folds
JT0: calls 0.04
*** TURN *** [Ad 3h Ks] [6s]
JT0: checks
Rocky27: bets 0.06
JT0: calls 0.06
*** RIVER *** [Ad 3h Ks 6s] [2c]
JT0: checks
Rocky27: bets 0.12
JT0: calls 0.12
*** SHOW DOWN ***
Rocky27: shows [6c Ac] (two pairs, Aces and Sixes)
JT0: mucks hand
Rocky27 collected 0.54 from pot
*** SUMMARY ***
Total pot 0.57 | Rake 0.03
Board [ Ad 3h Ks 6s 2c ]
Game ended: 2025/09/04 01:02:30 GMT
Seat 1: Thwingfish folded before Flop (didn't bet)
Seat 2: Rocky27 showed [6c Ac] and won (0.54) with two pairs, Aces and Sixes
Seat 3: kanococo (button) folded on the Flop
Seat 4: yonmon (small blind) folded before Flop
Seat 6: JT0 (big blind) mucked
Seat 7: chakhssin folded before Flop (didn't bet)

CoinPoker Hand #291765687: Hold'em No Limit (0.01/0.02 ) 2025/09/04 01:02:32 GMT
Table 'NL ₮2 IV' 7-max Seat #4 is the button
Seat 1: Thwingfish (0.80 in chips)
Seat 2: Rocky27 (2.69 in chips)
Seat 3: kanococo (2.21 in chips)
Seat 4: yonmon (1.99 in chips)
Seat 5: akaps (0.98 in chips)
Seat 6: JT0 (2.00 in chips)
Seat 7: chakhssin (2.07 in chips)
JT0: posts small blind 0.01
chakhssin: posts big blind 0.02
akaps: posts big blind 0.02
*** HOLE CARDS ***
Dealt to kanococo [Qs Jc]
Thwingfish: folds
Rocky27: folds
kanococo: raises 0.02 to 0.04
yonmon: folds
akaps: calls 0.02
JT0: folds
chakhssin: calls 0.02
*** FLOP *** [Th 6h 8c]
akaps: checks
chakhssin: checks
kanococo: checks
*** TURN *** [Th 6h 8c] [Jd]
akaps: checks
chakhssin: bets 0.12
kanococo: calls 0.12
akaps: folds
*** RIVER *** [Th 6h 8c Jd] [9s]
chakhssin: checks
kanococo: bets 0.35
chakhssin has timed out
chakhssin activated time-bank (60 seconds)
chakhssin: folds
Uncalled bet (0.35) returned to kanococo
kanococo collected 0.35 from pot
kanococo: doesn't show hand
*** SUMMARY ***
Total pot 0.37 | Rake 0.02
Board [ Th 6h 8c Jd 9s ]
Game ended: 2025/09/04 01:04:27 GMT
Seat 1: Thwingfish folded before Flop (didn't bet)
Seat 2: Rocky27 folded before Flop (didn't bet)
Seat 3: kanococo collected (0.35)
Seat 4: yonmon (button) folded before Flop (didn't bet)
Seat 5: akaps folded on the Turn
Seat 6: JT0 (small blind) folded before Flop
Seat 7: chakhssin (big blind) folded on the River

CoinPoker Hand #291766188: Hold'em No Limit (0.01/0.02 ) 2025/09/04 01:04:29 GMT
Table 'NL ₮2 IV' 7-max Seat #6 is the button
Seat 1: Thwingfish (0.80 in chips)
Seat 2: lh99 (2.00 in chips)
Seat 3: kanococo (2.40 in chips)
Seat 4: yonmon (1.99 in chips)
Seat 5: akaps (0.94 in chips)
Seat 6: JT0 (1.99 in chips)
Seat 7: chakhssin (2.00 in chips)
chakhssin: posts small blind 0.01
Thwingfish: posts big blind 0.02
lh99: posts big blind 0.02
*** HOLE CARDS ***
Dealt to kanococo [Jd 4d]
lh99: checks
kanococo: folds
yonmon: calls 0.02
akaps: folds
JT0: folds
chakhssin: calls 0.01
Thwingfish: checks
*** FLOP *** [2s 4h 3c]
chakhssin: checks
Thwingfish: checks
lh99: checks
yonmon: checks
*** TURN *** [2s 4h 3c] [7c]
chakhssin: checks
Thwingfish: checks
lh99: checks
yonmon: checks
*** RIVER *** [2s 4h 3c 7c] [2c]
chakhssin: checks
Thwingfish: checks
lh99: checks
yonmon: checks
*** SHOW DOWN ***
chakhssin: shows [8d Ah] (a pair of Twos)
Thwingfish: mucks hand
lh99: shows [9s 3h] (two pairs, Threes and Twos)
yonmon: mucks hand
lh99 collected 0.08 from pot
*** SUMMARY ***
Total pot 0.08 | Rake 0.00
Board [ 2s 4h 3c 7c 2c ]
Game ended: 2025/09/04 01:05:34 GMT
Seat 1: Thwingfish (big blind) mucked
Seat 2: lh99 showed [9s 3h] and won (0.08) with two pairs, Threes and Twos
Seat 3: kanococo folded before Flop (didn't bet)
Seat 4: yonmon mucked
Seat 5: akaps folded before Flop (didn't bet)
Seat 6: JT0 (button) folded before Flop (didn't bet)
Seat 7: chakhssin (small blind) showed [8d Ah]

CoinPoker Hand #291766463: Hold'em No Limit (0.01/0.02 ) 2025/09/04 01:05:36 GMT
Table 'NL ₮2 IV' 7-max Seat #7 is the button
Seat 1: Thwingfish (0.78 in chips)
Seat 2: lh99 (2.06 in chips)
Seat 3: kanococo (2.40 in chips)
Seat 4: yonmon (1.97 in chips)
Seat 5: akaps (0.94 in chips) is sitting out
Seat 6: JT0 (2.00 in chips)
Seat 7: chakhssin (2.00 in chips)
Thwingfish: posts small blind 0.01
lh99: posts big blind 0.02
*** HOLE CARDS ***
Dealt to kanococo [3s Ad]
kanococo: folds
yonmon: folds
JT0: folds
chakhssin: folds
Thwingfish: raises 0.02 to 0.04
lh99: calls 0.02
*** FLOP *** [6h Jc Jh]
Thwingfish: checks
lh99: checks
*** TURN *** [6h Jc Jh] [4d]
Thwingfish: checks
lh99: bets 0.04
Thwingfish: folds
Uncalled bet (0.04) returned to lh99
lh99 collected 0.08 from pot
lh99: doesn't show hand
*** SUMMARY ***
Total pot 0.08 | Rake 0.00
Board [ 6h Jc Jh 4d ]
Game ended: 2025/09/04 01:06:15 GMT
Seat 1: Thwingfish (small blind) folded on the Turn
Seat 2: lh99 (big blind) collected (0.08)
Seat 3: kanococo folded before Flop (didn't bet)
Seat 4: yonmon folded before Flop (didn't bet)
Seat 5: akaps folded before Flop (didn't bet)
Seat 6: JT0 folded before Flop (didn't bet)
Seat 7: chakhssin (button) folded before Flop (didn't bet)

CoinPoker Hand #292616889: Tournament #1366116, ₮0.20 Sat to ₮2 Takedown, 10 Seats GTD Hold'em No Limit (60/120 ante 15 play) 2025/09/05 21:21:04 GMT
Table '5' 7-max Seat #6 is the button
Seat 1: cris1986 (5377 in chips)
Seat 2: BigAspirations (3132 in chips)
Seat 3: kanococo (5000 in chips)
Seat 4: DannyR47 (3420 in chips)
Seat 6: ololoyez (4749 in chips)
Seat 7: mal1k (7707 in chips)
cris1986: posts the ante 15
BigAspirations: posts the ante 15
kanococo: posts the ante 15
DannyR47: posts the ante 15
ololoyez: posts the ante 15
mal1k: posts the ante 15
mal1k: posts small blind 60
cris1986: posts big blind 120
*** HOLE CARDS ***
Dealt to kanococo [7d 4h]
BigAspirations has timed out
BigAspirations activated time-bank (30 seconds)
BigAspirations: raises 120 to 240
kanococo: folds
DannyR47: raises 3405 and is all-in
ololoyez: folds
mal1k: folds
cris1986: folds
BigAspirations: calls 2877 and is all-in
Uncalled bet (288) returned to DannyR47
*** FLOP *** [3d Ad Tc]
*** TURN *** [3d Ad Tc] [Qd]
*** RIVER *** [3d Ad Tc Qd] [3h]
*** SHOW DOWN ***
DannyR47: shows [Jh As] (two pairs, Aces and Threes)
BigAspirations: shows [9d 9h] (two pairs, Nines and Threes)
DannyR47 collected 6504 from pot
*** SUMMARY ***
Total pot 6504 | Rake 0
Board [ 3d Ad Tc Qd 3h ]
Game ended: 2025/09/05 21:21:39 GMT
Seat 1: cris1986 (big blind) folded before Flop
Seat 2: BigAspirations showed [9d 9h]
Seat 3: kanococo folded before Flop
Seat 4: DannyR47 showed [Jh As] and won (6504) with two pairs, Aces and Threes
Seat 6: ololoyez (button) folded before Flop
Seat 7: mal1k (small blind) folded before Flop

CoinPoker Hand #292617093: Tournament #1366116, ₮0.20 Sat to ₮2 Takedown, 10 Seats GTD Hold'em No Limit (60/120 ante 15 play) 2025/09/05 21:21:40 GMT
Table '5' 7-max Seat #7 is the button
Seat 1: cris1986 (5242 in chips)
Seat 3: kanococo (4985 in chips)
Seat 4: DannyR47 (6792 in chips)
Seat 6: ololoyez (4734 in chips)
Seat 7: mal1k (7632 in chips)
cris1986: posts the ante 15
kanococo: posts the ante 15
DannyR47: posts the ante 15
ololoyez: posts the ante 15
mal1k: posts the ante 15
cris1986: posts small blind 60
kanococo: posts big blind 120
*** HOLE CARDS ***
Dealt to kanococo [4s 8d]
DannyR47: folds
ololoyez: raises 120 to 240
mal1k has timed out
mal1k activated time-bank (13 seconds)
mal1k: folds
cris1986: calls 180
kanococo: calls 120
*** FLOP *** [2s 2d 6h]
cris1986: bets 397
kanococo: folds
ololoyez: calls 397
*** TURN *** [2s 2d 6h] [3c]
cris1986: checks
ololoyez: checks
*** RIVER *** [2s 2d 6h 3c] [9c]
cris1986: checks
ololoyez: bets 1191
cris1986: calls 1191
*** SHOW DOWN ***
ololoyez: shows [Qs Ad] (a pair of Twos)
cris1986: shows [Td 6d] (two pairs, Sixes and Twos)
cris1986 collected 3971 from pot
*** SUMMARY ***
Total pot 3971 | Rake 0
Board [ 2s 2d 6h 3c 9c ]
Game ended: 2025/09/05 21:22:44 GMT
Seat 1: cris1986 (small blind) showed [Td 6d] and won (3971) with two pairs, Sixes and Twos
Seat 3: kanococo (big blind) folded on the Flop
Seat 4: DannyR47 folded before Flop
Seat 6: ololoyez showed [Qs Ad]
Seat 7: mal1k (button) folded before Flop

CoinPoker Hand #292617590: Tournament #1366116, ₮0.20 Sat to ₮2 Takedown, 10 Seats GTD Hold'em No Limit (60/120 ante 15 play) 2025/09/05 21:22:44 GMT
Table '5' 7-max Seat #1 is the button
Seat 1: cris1986 (7370 in chips)
Seat 3: kanococo (4730 in chips)
Seat 4: DannyR47 (6777 in chips)
Seat 5: jafarbw (4998 in chips) is sitting out
Seat 6: ololoyez (2891 in chips)
Seat 7: mal1k (7617 in chips)
cris1986: posts the ante 15
kanococo: posts the ante 15
DannyR47: posts the ante 15
jafarbw: posts the ante 15
ololoyez: posts the ante 15
mal1k: posts the ante 15
kanococo: posts small blind 60
DannyR47: posts big blind 120
*** HOLE CARDS ***
Dealt to kanococo [8c 7d]
jafarbw: folds
ololoyez: folds
mal1k: folds
cris1986: calls 120
kanococo: raises 120 to 240
DannyR47: calls 120
cris1986: calls 120
*** FLOP *** [Ad 2h Qh]
kanococo: checks
DannyR47: bets 360
cris1986: calls 360
kanococo: folds
*** TURN *** [Ad 2h Qh] [2d]
DannyR47: bets 480
cris1986: calls 480
*** RIVER *** [Ad 2h Qh 2d] [Js]
DannyR47: bets 840
cris1986: raises 1320 to 2160
DannyR47: calls 1320
*** SHOW DOWN ***
cris1986: shows [2s Qs] (a full house, Twos over Queens)
DannyR47: mucks hand
cris1986 collected 6810 from pot
*** SUMMARY ***
Total pot 6810 | Rake 0
Board [ Ad 2h Qh 2d Js ]
Game ended: 2025/09/05 21:24:01 GMT
Seat 1: cris1986 (button) showed [2s Qs] and won (6810) with a full house, Twos over Queens
Seat 3: kanococo (small blind) folded on the Flop
Seat 4: DannyR47 (big blind) mucked
Seat 5: jafarbw folded before Flop
Seat 6: ololoyez folded before Flop
Seat 7: mal1k folded before Flop

CoinPoker Hand #292618013: Tournament #1366116, ₮0.20 Sat to ₮2 Takedown, 10 Seats GTD Hold'em No Limit (60/120 ante 15 play) 2025/09/05 21:24:01 GMT
Table '5' 7-max Seat #3 is the button
Seat 1: cris1986 (10925 in chips)
Seat 3: kanococo (4475 in chips)
Seat 4: DannyR47 (3522 in chips)
Seat 5: jafarbw (4983 in chips) is sitting out
Seat 6: ololoyez (2876 in chips)
Seat 7: mal1k (7602 in chips)
cris1986: posts the ante 15
kanococo: posts the ante 15
DannyR47: posts the ante 15
jafarbw: posts the ante 15
ololoyez: posts the ante 15
mal1k: posts the ante 15
DannyR47: posts small blind 60
jafarbw: posts big blind 120
*** HOLE CARDS ***
Dealt to kanococo [9d 3s]
jafarbw has reconnected
ololoyez: folds
mal1k has timed out
mal1k activated time-bank (9 seconds)
mal1k: folds
cris1986: calls 120
kanococo: folds
DannyR47: calls 60
jafarbw: folds
*** FLOP *** [Jd 8d Qs]
DannyR47: bets 3387 and is all-in
cris1986: folds
Uncalled bet (3387) returned to DannyR47
DannyR47 collected 450 from pot
DannyR47: doesn't show hand
*** SUMMARY ***
Total pot 450 | Rake 0
Board [ Jd 8d Qs ]
Game ended: 2025/09/05 21:24:53 GMT
Seat 1: cris1986 folded on the Flop
Seat 3: kanococo (button) folded before Flop
Seat 4: DannyR47 (small blind) collected (450)
Seat 5: jafarbw (big blind) folded before Flop
Seat 6: ololoyez folded before Flop
Seat 7: mal1k folded before Flop

CoinPoker Hand #292618390: Tournament #1366116, ₮0.20 Sat to ₮2 Takedown, 10 Seats GTD Hold'em No Limit (60/120 ante 15 play) 2025/09/05 21:24:53 GMT
Table '5' 7-max Seat #4 is the button
Seat 1: cris1986 (10790 in chips)
Seat 3: kanococo (4460 in chips)
Seat 4: DannyR47 (3837 in chips)
Seat 5: jafarbw (4848 in chips)
Seat 6: ololoyez (2861 in chips)
Seat 7: mal1k (7587 in chips)
cris1986: posts the ante 15
kanococo: posts the ante 15
DannyR47: posts the ante 15
jafarbw: posts the ante 15
ololoyez: posts the ante 15
mal1k: posts the ante 15
jafarbw: posts small blind 60
ololoyez: posts big blind 120
*** HOLE CARDS ***
Dealt to kanococo [Qd Jh]
mal1k: folds
cris1986: folds
kanococo: raises 240 to 360
DannyR47: folds
jafarbw: folds
ololoyez: calls 240
*** FLOP *** [8s 2h 8h]
ololoyez: checks
kanococo: bets 435
ololoyez: calls 435
*** TURN *** [8s 2h 8h] [Js]
ololoyez: checks
kanococo: checks
*** RIVER *** [8s 2h 8h Js] [8c]
ololoyez: checks
F3TA has reconnected
kanococo: bets 3650 and is all-in
ololoyez: folds
Uncalled bet (3650) returned to kanococo
kanococo collected 1740 from pot
kanococo: doesn't show hand
*** SUMMARY ***
Total pot 1740 | Rake 0
Board [ 8s 2h 8h Js 8c ]
Game ended: 2025/09/05 21:25:59 GMT
Seat 1: cris1986 folded before Flop
Seat 3: kanococo collected (1740)
Seat 4: DannyR47 (button) folded before Flop
Seat 5: jafarbw (small blind) folded before Flop
Seat 6: ololoyez (big blind) folded on the River
Seat 7: mal1k folded before Flop

CoinPoker Hand #292618898: Tournament #1366116, ₮0.20 Sat to ₮2 Takedown, 10 Seats GTD Hold'em No Limit (75/150 ante 19 play) 2025/09/05 21:26:04 GMT
Table '5' 7-max Seat #5 is the button
Seat 1: cris1986 (10775 in chips)
Seat 2: F3TA (5000 in chips)
Seat 3: kanococo (5390 in chips)
Seat 4: DannyR47 (3822 in chips)
Seat 5: jafarbw (4773 in chips)
Seat 6: ololoyez (2051 in chips)
Seat 7: mal1k (7572 in chips)
cris1986: posts the ante 19
F3TA: posts the ante 19
kanococo: posts the ante 19
DannyR47: posts the ante 19
jafarbw: posts the ante 19
ololoyez: posts the ante 19
mal1k: posts the ante 19
ololoyez: posts small blind 75
mal1k: posts big blind 150
*** HOLE CARDS ***
Dealt to kanococo [6s 9s]
cris1986: calls 150
F3TA: folds
kanococo: folds
DannyR47: calls 150
jafarbw has timed out
jafarbw: folds
ololoyez has timed out
ololoyez activated time-bank (30 seconds)
ololoyez: calls 75
mal1k: checks
*** FLOP *** [3c 3h Td]
ololoyez: checks
mal1k: checks
cris1986: checks
DannyR47: checks
*** TURN *** [3c 3h Td] [Ts]
ololoyez: checks
mal1k has timed out
mal1k: checks
cris1986: checks
DannyR47: checks
*** RIVER *** [3c 3h Td Ts] [4s]
ololoyez: checks
mal1k: checks
cris1986: checks
DannyR47: bets 900
ololoyez: folds
mal1k: folds
cris1986: folds
Uncalled bet (900) returned to DannyR47
DannyR47 collected 733 from pot
DannyR47: doesn't show hand
*** SUMMARY ***
Total pot 733 | Rake 0
Board [ 3c 3h Td Ts 4s ]
Game ended: 2025/09/05 21:27:44 GMT
Seat 1: cris1986 folded on the River
Seat 2: F3TA folded before Flop
Seat 3: kanococo folded before Flop
Seat 4: DannyR47 collected (733)
Seat 5: jafarbw (button) folded before Flop
Seat 6: ololoyez (small blind) folded on the River
Seat 7: mal1k (big blind) folded on the River

CoinPoker Hand #292619514: Tournament #1366116, ₮0.20 Sat to ₮2 Takedown, 10 Seats GTD Hold'em No Limit (75/150 ante 19 play) 2025/09/05 21:27:45 GMT
Table '5' 7-max Seat #6 is the button
Seat 1: cris1986 (10606 in chips)
Seat 2: F3TA (4981 in chips)
Seat 3: kanococo (5371 in chips)
Seat 4: DannyR47 (4386 in chips)
Seat 5: jafarbw (4754 in chips)
Seat 6: ololoyez (1882 in chips)
Seat 7: mal1k (7403 in chips)
cris1986: posts the ante 19
F3TA: posts the ante 19
kanococo: posts the ante 19
DannyR47: posts the ante 19
jafarbw: posts the ante 19
ololoyez: posts the ante 19
mal1k: posts the ante 19
mal1k: posts small blind 75
cris1986: posts big blind 150
*** HOLE CARDS ***
Dealt to kanococo [7s 9h]
F3TA: calls 150
kanococo: folds
DannyR47: folds
jafarbw: folds
ololoyez: folds
mal1k: calls 75
cris1986: checks
*** FLOP *** [Tc Ts 4d]
mal1k: checks
cris1986: checks
F3TA: checks
*** TURN *** [Tc Ts 4d] [Ks]
mal1k: checks
cris1986: bets 150
F3TA: folds
mal1k: folds
Uncalled bet (150) returned to cris1986
cris1986 collected 583 from pot
cris1986: doesn't show hand
*** SUMMARY ***
Total pot 583 | Rake 0
Board [ Tc Ts 4d Ks ]
Game ended: 2025/09/05 21:28:36 GMT
Seat 1: cris1986 (big blind) collected (583)
Seat 2: F3TA folded on the Turn
Seat 3: kanococo folded before Flop
Seat 4: DannyR47 folded before Flop
Seat 5: jafarbw folded before Flop
Seat 6: ololoyez (button) folded before Flop
Seat 7: mal1k (small blind) folded on the Turn

CoinPoker Hand #292619933: Tournament #1366116, ₮0.20 Sat to ₮2 Takedown, 10 Seats GTD Hold'em No Limit (75/150 ante 19 play) 2025/09/05 21:28:37 GMT
Table '5' 7-max Seat #7 is the button
Seat 1: cris1986 (11020 in chips)
Seat 2: F3TA (4812 in chips)
Seat 3: kanococo (5352 in chips)
Seat 4: DannyR47 (4367 in chips)
Seat 5: jafarbw (4735 in chips)
Seat 6: ololoyez (1863 in chips)
Seat 7: mal1k (7234 in chips)
cris1986: posts the ante 19
F3TA: posts the ante 19
kanococo: posts the ante 19
DannyR47: posts the ante 19
jafarbw: posts the ante 19
ololoyez: posts the ante 19
mal1k: posts the ante 19
cris1986: posts small blind 75
F3TA: posts big blind 150
*** HOLE CARDS ***
Dealt to kanococo [7h 2c]
kanococo: folds
DannyR47: folds
jafarbw: folds
ololoyez: raises 1844 and is all-in
mal1k has timed out
mal1k: folds
cris1986: calls 1769
F3TA: folds
*** FLOP *** [Jd Ks Qc]
*** TURN *** [Jd Ks Qc] [Tc]
*** RIVER *** [Jd Ks Qc Tc] [8s]
*** SHOW DOWN ***
ololoyez: shows [Ac 3h] (a straight, Ace high)
cris1986: shows [Kh 7c] (a pair of Kings)
ololoyez collected 3971 from pot
*** SUMMARY ***
Total pot 3971 | Rake 0
Board [ Jd Ks Qc Tc 8s ]
Game ended: 2025/09/05 21:29:25 GMT
Seat 1: cris1986 (small blind) showed [Kh 7c]
Seat 2: F3TA (big blind) folded before Flop
Seat 3: kanococo folded before Flop
Seat 4: DannyR47 folded before Flop
Seat 5: jafarbw folded before Flop
Seat 6: ololoyez showed [Ac 3h] and won (3971) with a straight, Ace high
Seat 7: mal1k (button) folded before Flop

CoinPoker Hand #292620186: Tournament #1366116, ₮0.20 Sat to ₮2 Takedown, 10 Seats GTD Hold'em No Limit (75/150 ante 19 play) 2025/09/05 21:29:25 GMT
Table '5' 7-max Seat #1 is the button
Seat 1: cris1986 (9157 in chips)
Seat 2: F3TA (4643 in chips)
Seat 3: kanococo (5333 in chips)
Seat 4: DannyR47 (4348 in chips)
Seat 5: jafarbw (4716 in chips)
Seat 6: ololoyez (3971 in chips)
Seat 7: mal1k (7215 in chips)
cris1986: posts the ante 19
F3TA: posts the ante 19
kanococo: posts the ante 19
DannyR47: posts the ante 19
jafarbw: posts the ante 19
ololoyez: posts the ante 19
mal1k: posts the ante 19
F3TA: posts small blind 75
kanococo: posts big blind 150
*** HOLE CARDS ***
Dealt to kanococo [5h 4c]
DannyR47 has timed out
DannyR47 activated time-bank (19 seconds)
DannyR47: folds
jafarbw: folds
ololoyez: raises 150 to 300
mal1k: raises 300 to 600
cris1986: folds
F3TA: folds
kanococo: calls 450
ololoyez: raises 3652 and is all-in
mal1k: raises 6596 and is all-in
kanococo: folds
Uncalled bet (3244) returned to mal1k
*** FLOP *** [Td 3h 3c]
*** TURN *** [Td 3h 3c] [4h]
*** RIVER *** [Td 3h 3c 4h] [Th]
*** SHOW DOWN ***
mal1k: shows [Kd Js] (two pairs, Tens and Threes)
ololoyez: shows [6c 6s] (two pairs, Tens and Sixes)
ololoyez collected 8712 from pot
*** SUMMARY ***
Total pot 8712 | Rake 0
Board [ Td 3h 3c 4h Th ]
Game ended: 2025/09/05 21:30:44 GMT
Seat 1: cris1986 (button) folded before Flop
Seat 2: F3TA (small blind) folded before Flop
Seat 3: kanococo (big blind) folded before Flop
Seat 4: DannyR47 folded before Flop
Seat 5: jafarbw folded before Flop
Seat 6: ololoyez showed [6c 6s] and won (8712) with two pairs, Tens and Sixes
Seat 7: mal1k showed [Kd Js]

CoinPoker Hand #292620677: Tournament #1366116, ₮0.20 Sat to ₮2 Takedown, 10 Seats GTD Hold'em No Limit (100/200 ante 25 play) 2025/09/05 21:30:49 GMT
Table '5' 7-max Seat #2 is the button
Seat 1: cris1986 (9138 in chips)
Seat 2: F3TA (4549 in chips)
Seat 3: kanococo (4714 in chips)
Seat 4: DannyR47 (4329 in chips)
Seat 5: jafarbw (4697 in chips)
Seat 6: ololoyez (8712 in chips)
Seat 7: mal1k (3244 in chips)
cris1986: posts the ante 25
F3TA: posts the ante 25
kanococo: posts the ante 25
DannyR47: posts the ante 25
jafarbw: posts the ante 25
ololoyez: posts the ante 25
mal1k: posts the ante 25
kanococo: posts small blind 100
DannyR47: posts big blind 200
*** HOLE CARDS ***
Dealt to kanococo [Jh Ac]
jafarbw has timed out
jafarbw: folds
ololoyez: raises 200 to 400
mal1k: raises 3219 and is all-in
cris1986: folds
F3TA: folds
kanococo: calls 3119
DannyR47 has timed out
DannyR47 activated time-bank (5 seconds)
DannyR47 has timed out
DannyR47: folds
ololoyez: raises 8287 and is all-in
kanococo: calls 1470 and is all-in
Uncalled bet (3998) returned to ololoyez
*** FLOP *** [4d Js 3c]
*** TURN *** [4d Js 3c] [8d]
*** RIVER *** [4d Js 3c 8d] [3d]
*** SHOW DOWN ***
ololoyez: shows [Kh Kd] (two pairs, Kings and Threes)
kanococo: shows [Jh Ac] (two pairs, Jacks and Threes)
ololoyez collected 2940 from side-pot 1
mal1k: shows [Qs 2s] (a pair of Threes)
ololoyez collected 10032 from pot
*** SUMMARY ***
Total pot 12972 | Rake 0
Board [ 4d Js 3c 8d 3d ]
Game ended: 2025/09/05 21:31:55 GMT
Seat 1: cris1986 folded before Flop
Seat 2: F3TA (button) folded before Flop
Seat 3: kanococo (small blind) showed [Jh Ac]
Seat 4: DannyR47 (big blind) folded before Flop
Seat 5: jafarbw folded before Flop
Seat 6: ololoyez showed [Kh Kd] and won (12972) with two pairs, Kings and Threes
Seat 7: mal1k showed [Qs 2s]

CoinPoker Hand #292661478: Hold'em No Limit (0.01/0.02 ) 2025/09/05 23:25:11 GMT
Table 'NL ₮2 VI' 7-max Seat #1 is the button
Seat 1: DarGeo (2.31 in chips)
Seat 2: D3ATHANG3L (0.90 in chips)
Seat 3: AladeenMF (2.00 in chips)
Seat 4: WINvsWIN (2.00 in chips)
Seat 5: bruvsky (2.00 in chips)
Seat 6: kanococo (2.00 in chips)
Seat 7: G3TR3KTF1SH (2.00 in chips)
D3ATHANG3L: posts small blind 0.01
AladeenMF: posts big blind 0.02
kanococo: posts big blind 0.02
G3TR3KTF1SH: posts big blind 0.02
*** HOLE CARDS ***
Dealt to kanococo [4c 8h]
WINvsWIN: folds
bruvsky: raises 0.06 to 0.08
kanococo: folds
G3TR3KTF1SH: folds
DarGeo: folds
D3ATHANG3L: folds
AladeenMF: calls 0.06
*** FLOP *** [Qd 9c 2h]
AladeenMF: checks
bruvsky: bets 0.08
AladeenMF: folds
Uncalled bet (0.08) returned to bruvsky
bruvsky collected 0.20 from pot
bruvsky: doesn't show hand
*** SUMMARY ***
Total pot 0.21 | Rake 0.01
Board [ Qd 9c 2h ]
Game ended: 2025/09/05 23:25:48 GMT
Seat 1: DarGeo (button) folded before Flop (didn't bet)
Seat 2: D3ATHANG3L (small blind) folded before Flop
Seat 3: AladeenMF (big blind) folded on the Flop
Seat 4: WINvsWIN folded before Flop (didn't bet)
Seat 5: bruvsky collected (0.20)
Seat 6: kanococo folded before Flop
Seat 7: G3TR3KTF1SH folded before Flop

CoinPoker Hand #292661704: Hold'em No Limit (0.01/0.02 ) 2025/09/05 23:25:50 GMT
Table 'NL ₮2 VI' 7-max Seat #2 is the button
Seat 1: DarGeo (2.31 in chips)
Seat 2: D3ATHANG3L (0.89 in chips)
Seat 3: AladeenMF (2.00 in chips)
Seat 4: WINvsWIN (2.00 in chips)
Seat 5: bruvsky (2.12 in chips)
Seat 6: kanococo (1.98 in chips)
Seat 7: G3TR3KTF1SH (1.98 in chips)
AladeenMF: posts small blind 0.01
WINvsWIN: posts big blind 0.02
*** HOLE CARDS ***
Dealt to kanococo [2s Qd]
bruvsky: folds
kanococo: folds
G3TR3KTF1SH: folds
DarGeo: folds
D3ATHANG3L: folds
AladeenMF: folds
WINvsWIN collected 0.03 from pot
WINvsWIN: doesn't show hand
*** SUMMARY ***
Total pot 0.03 | Rake 0.00
Board [ ]
Game ended: 2025/09/05 23:26:06 GMT
Seat 1: DarGeo folded before Flop (didn't bet)
Seat 2: D3ATHANG3L (button) folded before Flop (didn't bet)
Seat 3: AladeenMF (small blind) folded before Flop
Seat 4: WINvsWIN (big blind) collected (0.03)
Seat 5: bruvsky folded before Flop (didn't bet)
Seat 6: kanococo folded before Flop (didn't bet)
Seat 7: G3TR3KTF1SH folded before Flop (didn't bet)

CoinPoker Hand #292661791: Hold'em No Limit (0.01/0.02 ) 2025/09/05 23:26:08 GMT
Table 'NL ₮2 VI' 7-max Seat #3 is the button
Seat 1: DarGeo (2.31 in chips)
Seat 2: D3ATHANG3L (0.89 in chips)
Seat 3: AladeenMF (2.00 in chips)
Seat 4: WINvsWIN (2.01 in chips)
Seat 5: bruvsky (2.12 in chips)
Seat 6: kanococo (1.98 in chips)
Seat 7: G3TR3KTF1SH (2.00 in chips)
WINvsWIN: posts small blind 0.01
bruvsky: posts big blind 0.02
*** HOLE CARDS ***
Dealt to kanococo [2c 8c]
kanococo: folds
G3TR3KTF1SH: raises 0.03 to 0.05
DarGeo: folds
D3ATHANG3L: folds
AladeenMF: folds
WINvsWIN: folds
bruvsky: folds
G3TR3KTF1SH collected 0.08 from pot
G3TR3KTF1SH: doesn't show hand
*** SUMMARY ***
Total pot 0.08 | Rake 0.00
Board [ ]
Game ended: 2025/09/05 23:26:24 GMT
Seat 1: DarGeo folded before Flop (didn't bet)
Seat 2: D3ATHANG3L folded before Flop (didn't bet)
Seat 3: AladeenMF (button) folded before Flop (didn't bet)
Seat 4: WINvsWIN (small blind) folded before Flop
Seat 5: bruvsky (big blind) folded before Flop
Seat 6: kanococo folded before Flop (didn't bet)
Seat 7: G3TR3KTF1SH collected (0.08)

CoinPoker Hand #292661879: Hold'em No Limit (0.01/0.02 ) 2025/09/05 23:26:26 GMT
Table 'NL ₮2 VI' 7-max Seat #4 is the button
Seat 1: DarGeo (2.31 in chips)
Seat 2: D3ATHANG3L (0.89 in chips)
Seat 3: AladeenMF (2.00 in chips)
Seat 4: WINvsWIN (2.00 in chips)
Seat 5: bruvsky (2.10 in chips)
Seat 6: kanococo (1.98 in chips)
Seat 7: G3TR3KTF1SH (2.03 in chips)
bruvsky: posts small blind 0.01
kanococo: posts big blind 0.02
*** HOLE CARDS ***
Dealt to kanococo [Kd 7c]
G3TR3KTF1SH: folds
DarGeo: raises 0.06 to 0.08
D3ATHANG3L: folds
AladeenMF: raises 0.35 to 0.43
WINvsWIN: folds
bruvsky: folds
kanococo: folds
DarGeo: folds
AladeenMF collected 0.54 from pot
AladeenMF: doesn't show hand
*** SUMMARY ***
Total pot 0.54 | Rake 0.00
Board [ ]
Game ended: 2025/09/05 23:26:55 GMT
Seat 1: DarGeo folded before Flop
Seat 2: D3ATHANG3L folded before Flop (didn't bet)
Seat 3: AladeenMF collected (0.54)
Seat 4: WINvsWIN (button) folded before Flop (didn't bet)
Seat 5: bruvsky (small blind) folded before Flop
Seat 6: kanococo (big blind) folded before Flop
Seat 7: G3TR3KTF1SH folded before Flop (didn't bet)

CoinPoker Hand #292662031: Hold'em No Limit (0.01/0.02 ) 2025/09/05 23:26:57 GMT
Table 'NL ₮2 VI' 7-max Seat #5 is the button
Seat 1: DarGeo (2.23 in chips)
Seat 2: D3ATHANG3L (0.89 in chips)
Seat 3: AladeenMF (2.11 in chips)
Seat 4: WINvsWIN (2.00 in chips)
Seat 5: bruvsky (2.09 in chips)
Seat 6: kanococo (1.96 in chips)
Seat 7: G3TR3KTF1SH (2.03 in chips)
kanococo: posts small blind 0.01
G3TR3KTF1SH: posts big blind 0.02
*** HOLE CARDS ***
Dealt to kanococo [6d 4h]
DarGeo: folds
D3ATHANG3L: calls 0.02
AladeenMF: folds
WINvsWIN: folds
bruvsky: raises 0.04 to 0.06
kanococo: folds
G3TR3KTF1SH: calls 0.04
D3ATHANG3L: calls 0.04
*** FLOP *** [2s Qd 8h]
G3TR3KTF1SH: checks
D3ATHANG3L: checks
bruvsky: checks
*** TURN *** [2s Qd 8h] [3s]
G3TR3KTF1SH: checks
D3ATHANG3L: checks
bruvsky: checks
*** RIVER *** [2s Qd 8h 3s] [Tc]
G3TR3KTF1SH: checks
D3ATHANG3L: checks
bruvsky: checks
*** SHOW DOWN ***
G3TR3KTF1SH: shows [Ac 8c] (a pair of Eights)
D3ATHANG3L: mucks hand
bruvsky: mucks hand
G3TR3KTF1SH collected 0.18 from pot
*** SUMMARY ***
Total pot 0.19 | Rake 0.01
Board [ 2s Qd 8h 3s Tc ]
Game ended: 2025/09/05 23:27:45 GMT
Seat 1: DarGeo folded before Flop (didn't bet)
Seat 2: D3ATHANG3L mucked
Seat 3: AladeenMF folded before Flop (didn't bet)
Seat 4: WINvsWIN folded before Flop (didn't bet)
Seat 5: bruvsky (button) mucked
Seat 6: kanococo (small blind) folded before Flop
Seat 7: G3TR3KTF1SH (big blind) showed [Ac 8c] and won (0.18) with a pair of Eights

CoinPoker Hand #292662234: Hold'em No Limit (0.01/0.02 ) 2025/09/05 23:27:47 GMT
Table 'NL ₮2 VI' 7-max Seat #6 is the button
Seat 1: DarGeo (2.23 in chips)
Seat 2: D3ATHANG3L (0.83 in chips)
Seat 3: AladeenMF (2.11 in chips)
Seat 4: WINvsWIN (2.00 in chips)
Seat 5: bruvsky (2.03 in chips)
Seat 6: kanococo (1.95 in chips)
Seat 7: G3TR3KTF1SH (2.15 in chips)
G3TR3KTF1SH: posts small blind 0.01
DarGeo: posts big blind 0.02
*** HOLE CARDS ***
Dealt to kanococo [8d 7c]
D3ATHANG3L: calls 0.02
AladeenMF: folds
WINvsWIN: folds
bruvsky: folds
kanococo: raises 0.06 to 0.08
G3TR3KTF1SH: folds
DarGeo: folds
D3ATHANG3L: calls 0.06
*** FLOP *** [3s Qs 7d]
D3ATHANG3L: checks
kanococo: checks
*** TURN *** [3s Qs 7d] [2c]
D3ATHANG3L: checks
kanococo: bets 0.09
D3ATHANG3L: folds
Uncalled bet (0.09) returned to kanococo
kanococo collected 0.18 from pot
kanococo: doesn't show hand
*** SUMMARY ***
Total pot 0.19 | Rake 0.01
Board [ 3s Qs 7d 2c ]
Game ended: 2025/09/05 23:28:38 GMT
Seat 1: DarGeo (big blind) folded before Flop
Seat 2: D3ATHANG3L folded on the Turn
Seat 3: AladeenMF folded before Flop (didn't bet)
Seat 4: WINvsWIN folded before Flop (didn't bet)
Seat 5: bruvsky folded before Flop (didn't bet)
Seat 6: kanococo (button) collected (0.18)
Seat 7: G3TR3KTF1SH (small blind) folded before Flop

CoinPoker Hand #292662456: Hold'em No Limit (0.01/0.02 ) 2025/09/05 23:28:40 GMT
Table 'NL ₮2 VI' 7-max Seat #7 is the button
Seat 1: DarGeo (2.21 in chips)
Seat 2: D3ATHANG3L (0.75 in chips)
Seat 3: AladeenMF (2.11 in chips)
Seat 4: WINvsWIN (2.00 in chips)
Seat 5: bruvsky (2.03 in chips)
Seat 6: kanococo (2.05 in chips)
Seat 7: G3TR3KTF1SH (2.14 in chips)
DarGeo: posts small blind 0.01
D3ATHANG3L: posts big blind 0.02
*** HOLE CARDS ***
Dealt to kanococo [As Kc]
AladeenMF: raises 0.03 to 0.05
WINvsWIN: folds
bruvsky: folds
kanococo: raises 0.05 to 0.10
G3TR3KTF1SH: folds
DarGeo: folds
D3ATHANG3L: folds
AladeenMF: raises 2.06 and is all-in
kanococo has timed out
kanococo activated time-bank (60 seconds)
kanococo: folds
AladeenMF collected 2.24 from pot
AladeenMF: doesn't show hand
*** SUMMARY ***
Total pot 2.24 | Rake 0.00
Board [ ]
Game ended: 2025/09/05 23:29:27 GMT
Seat 1: DarGeo (small blind) folded before Flop
Seat 2: D3ATHANG3L (big blind) folded before Flop
Seat 3: AladeenMF collected (2.24)
Seat 4: WINvsWIN folded before Flop (didn't bet)
Seat 5: bruvsky folded before Flop (didn't bet)
Seat 6: kanococo folded before Flop
Seat 7: G3TR3KTF1SH (button) folded before Flop (didn't bet)

CoinPoker Hand #292662727: Hold'em No Limit (0.01/0.02 ) 2025/09/05 23:29:29 GMT
Table 'NL ₮2 VI' 7-max Seat #1 is the button
Seat 1: DarGeo (2.20 in chips)
Seat 2: D3ATHANG3L (0.73 in chips)
Seat 3: AladeenMF (2.24 in chips)
Seat 4: WINvsWIN (2.00 in chips)
Seat 5: bruvsky (2.03 in chips)
Seat 6: kanococo (1.95 in chips)
Seat 7: G3TR3KTF1SH (2.14 in chips)
D3ATHANG3L: posts small blind 0.01
AladeenMF: posts big blind 0.02
*** HOLE CARDS ***
Dealt to kanococo [Tc 7h]
WINvsWIN: folds
bruvsky: folds
kanococo: folds
G3TR3KTF1SH: folds
DarGeo: raises 0.04 to 0.06
D3ATHANG3L: folds
AladeenMF: calls 0.04
*** FLOP *** [9h 5s Kd]
AladeenMF: checks
DarGeo: bets 0.06
AladeenMF: folds
Uncalled bet (0.06) returned to DarGeo
DarGeo collected 0.12 from pot
DarGeo: doesn't show hand
*** SUMMARY ***
Total pot 0.13 | Rake 0.01
Board [ 9h 5s Kd ]
Game ended: 2025/09/05 23:30:13 GMT
Seat 1: DarGeo (button) collected (0.12)
Seat 2: D3ATHANG3L (small blind) folded before Flop
Seat 3: AladeenMF (big blind) folded on the Flop
Seat 4: WINvsWIN folded before Flop (didn't bet)
Seat 5: bruvsky folded before Flop (didn't bet)
Seat 6: kanococo folded before Flop (didn't bet)
Seat 7: G3TR3KTF1SH folded before Flop (didn't bet)

CoinPoker Hand #292662972: Hold'em No Limit (0.01/0.02 ) 2025/09/05 23:30:15 GMT
Table 'NL ₮2 VI' 7-max Seat #2 is the button
Seat 1: DarGeo (2.26 in chips)
Seat 2: D3ATHANG3L (0.72 in chips)
Seat 3: AladeenMF (2.18 in chips)
Seat 4: WINvsWIN (2.00 in chips)
Seat 5: bruvsky (2.03 in chips)
Seat 6: kanococo (1.95 in chips)
Seat 7: G3TR3KTF1SH (2.14 in chips)
AladeenMF: posts small blind 0.01
WINvsWIN: posts big blind 0.02
*** HOLE CARDS ***
Dealt to kanococo [Ac 8c]
bruvsky: folds
kanococo has timed out
kanococo activated time-bank (58 seconds)
kanococo: raises 0.06 to 0.08
G3TR3KTF1SH: folds
DarGeo: folds
D3ATHANG3L: folds
AladeenMF: folds
WINvsWIN: calls 0.06
*** FLOP *** [Qh 6s 7c]
WINvsWIN: checks
kanococo: checks
*** TURN *** [Qh 6s 7c] [2c]
WINvsWIN: bets 0.12
kanococo: calls 0.12
*** RIVER *** [Qh 6s 7c 2c] [Qc]
WINvsWIN: bets 0.10
kanococo: raises 1.75 and is all-in
WINvsWIN: folds
Uncalled bet (1.65) returned to kanococo
kanococo collected 0.59 from pot
kanococo: doesn't show hand
*** SUMMARY ***
Total pot 0.61 | Rake 0.02
Board [ Qh 6s 7c 2c Qc ]
Game ended: 2025/09/05 23:31:33 GMT
Seat 1: DarGeo folded before Flop (didn't bet)
Seat 2: D3ATHANG3L (button) folded before Flop (didn't bet)
Seat 3: AladeenMF (small blind) folded before Flop
Seat 4: WINvsWIN (big blind) folded on the River
Seat 5: bruvsky folded before Flop (didn't bet)
Seat 6: kanococo collected (0.59)
Seat 7: G3TR3KTF1SH folded before Flop (didn't bet)

CoinPoker Hand #292663332: Hold'em No Limit (0.01/0.02 ) 2025/09/05 23:31:35 GMT
Table 'NL ₮2 VI' 7-max Seat #3 is the button
Seat 1: DarGeo (2.26 in chips)
Seat 2: D3ATHANG3L (0.72 in chips)
Seat 3: AladeenMF (2.17 in chips)
Seat 4: WINvsWIN (2.00 in chips)
Seat 5: bruvsky (2.03 in chips)
Seat 6: kanococo (2.24 in chips)
Seat 7: G3TR3KTF1SH (2.14 in chips)
WINvsWIN: posts small blind 0.01
bruvsky: posts big blind 0.02
*** HOLE CARDS ***
Dealt to kanococo [4s As]
kanococo: folds
G3TR3KTF1SH: folds
DarGeo: raises 0.06 to 0.08
D3ATHANG3L: folds
AladeenMF: folds
WINvsWIN: folds
bruvsky: raises 0.16 to 0.24
DarGeo has timed out
DarGeo activated time-bank (54 seconds)
DarGeo: raises 0.49 to 0.73
bruvsky: folds
DarGeo collected 0.98 from pot
DarGeo: doesn't show hand
*** SUMMARY ***
Total pot 0.98 | Rake 0.00
Board [ ]
Game ended: 2025/09/05 23:32:52 GMT
Seat 1: DarGeo collected (0.98)
Seat 2: D3ATHANG3L folded before Flop (didn't bet)
Seat 3: AladeenMF (button) folded before Flop (didn't bet)
Seat 4: WINvsWIN (small blind) folded before Flop
Seat 5: bruvsky (big blind) folded before Flop
Seat 6: kanococo folded before Flop (didn't bet)
Seat 7: G3TR3KTF1SH folded before Flop (didn't bet)

CoinPoker Hand #292663726: Hold'em No Limit (0.01/0.02 ) 2025/09/05 23:32:55 GMT
Table 'NL ₮2 VI' 7-max Seat #4 is the button
Seat 1: DarGeo (2.51 in chips)
Seat 2: D3ATHANG3L (0.72 in chips)
Seat 3: AladeenMF (2.17 in chips)
Seat 4: WINvsWIN (1.99 in chips)
Seat 5: bruvsky (1.79 in chips)
Seat 6: kanococo (2.24 in chips)
Seat 7: G3TR3KTF1SH (2.14 in chips)
bruvsky: posts small blind 0.01
kanococo: posts big blind 0.02
*** HOLE CARDS ***
Dealt to kanococo [2h Ad]
G3TR3KTF1SH: folds
DarGeo: folds
D3ATHANG3L: folds
AladeenMF: folds
WINvsWIN: folds
bruvsky: calls 0.01
kanococo: raises 0.06 to 0.08
bruvsky: calls 0.06
*** FLOP *** [8h 9h 7c]
bruvsky: checks
kanococo: checks
*** TURN *** [8h 9h 7c] [4s]
bruvsky: bets 0.06
kanococo has timed out
kanococo activated time-bank (57 seconds)
kanococo: calls 0.06
*** RIVER *** [8h 9h 7c 4s] [Kd]
bruvsky: bets 0.20
kanococo: calls 0.20
*** SHOW DOWN ***
bruvsky: shows [5s 7s] (a pair of Sevens)
kanococo: mucks hand
bruvsky collected 0.65 from pot
*** SUMMARY ***
Total pot 0.68 | Rake 0.03
Board [ 8h 9h 7c 4s Kd ]
Game ended: 2025/09/05 23:34:08 GMT
Seat 1: DarGeo folded before Flop (didn't bet)
Seat 2: D3ATHANG3L folded before Flop (didn't bet)
Seat 3: AladeenMF folded before Flop (didn't bet)
Seat 4: WINvsWIN (button) folded before Flop (didn't bet)
Seat 5: bruvsky (small blind) showed [5s 7s] and won (0.65) with a pair of Sevens
Seat 6: kanococo (big blind) mucked
Seat 7: G3TR3KTF1SH folded before Flop (didn't bet)

CoinPoker Hand #292664181: Hold'em No Limit (0.01/0.02 ) 2025/09/05 23:34:10 GMT
Table 'NL ₮2 VI' 7-max Seat #5 is the button
Seat 1: DarGeo (2.51 in chips)
Seat 2: D3ATHANG3L (0.72 in chips)
Seat 3: AladeenMF (2.17 in chips)
Seat 4: WINvsWIN (2.00 in chips)
Seat 5: bruvsky (2.10 in chips)
Seat 6: kanococo (1.90 in chips)
Seat 7: G3TR3KTF1SH (2.14 in chips)
kanococo: posts small blind 0.01
G3TR3KTF1SH: posts big blind 0.02
*** HOLE CARDS ***
Dealt to kanococo [Kd 6h]
DarGeo: folds
D3ATHANG3L: calls 0.02
AladeenMF: raises 0.15 to 0.17
WINvsWIN: folds
bruvsky: folds
kanococo: calls 0.16
G3TR3KTF1SH: folds
D3ATHANG3L: folds
*** FLOP *** [5h Jd Ah]
kanococo: checks
AladeenMF: bets 0.10
kanococo: folds
Uncalled bet (0.10) returned to AladeenMF
AladeenMF collected 0.36 from pot
AladeenMF: doesn't show hand
*** SUMMARY ***
Total pot 0.38 | Rake 0.02
Board [ 5h Jd Ah ]
Game ended: 2025/09/05 23:35:11 GMT
Seat 1: DarGeo folded before Flop (didn't bet)
Seat 2: D3ATHANG3L folded before Flop
Seat 3: AladeenMF collected (0.36)
Seat 4: WINvsWIN folded before Flop (didn't bet)
Seat 5: bruvsky (button) folded before Flop (didn't bet)
Seat 6: kanococo (small blind) folded on the Flop
Seat 7: G3TR3KTF1SH (big blind) folded before Flop

CoinPoker Hand #292664532: Hold'em No Limit (0.01/0.02 ) 2025/09/05 23:35:13 GMT
Table 'NL ₮2 VI' 7-max Seat #6 is the button
Seat 1: DarGeo (2.51 in chips)
Seat 2: D3ATHANG3L (0.70 in chips)
Seat 3: AladeenMF (2.36 in chips)
Seat 4: WINvsWIN (2.00 in chips)
Seat 5: bruvsky (2.10 in chips)
Seat 6: kanococo (1.73 in chips)
Seat 7: G3TR3KTF1SH (2.12 in chips)
G3TR3KTF1SH: posts small blind 0.01
DarGeo: posts big blind 0.02
*** HOLE CARDS ***
Dealt to kanococo [Qh Jd]
D3ATHANG3L: calls 0.02
AladeenMF: folds
WINvsWIN: folds
bruvsky: folds
kanococo: raises 0.06 to 0.08
G3TR3KTF1SH: calls 0.07
DarGeo: folds
D3ATHANG3L: calls 0.06
*** FLOP *** [9s Tc Td]
G3TR3KTF1SH: checks
D3ATHANG3L: checks
kanococo: checks
*** TURN *** [9s Tc Td] [Th]
G3TR3KTF1SH: checks
D3ATHANG3L: checks
kanococo: bets 0.12
G3TR3KTF1SH: folds
D3ATHANG3L: calls 0.12
*** RIVER *** [9s Tc Td Th] [2d]
D3ATHANG3L: bets 0.50 and is all-in
kanococo: calls 0.50
*** SHOW DOWN ***
D3ATHANG3L: shows [Ts Kd] (four of a kind, Tens)
kanococo: shows [Qh Jd] (three of kind, Tens)
D3ATHANG3L collected 1.42 from pot
*** SUMMARY ***
Total pot 1.50 | Rake 0.08
Board [ 9s Tc Td Th 2d ]
Game ended: 2025/09/05 23:36:27 GMT
Seat 1: DarGeo (big blind) folded before Flop
Seat 2: D3ATHANG3L showed [Ts Kd] and won (1.42) with four of a kind, Tens
Seat 3: AladeenMF folded before Flop (didn't bet)
Seat 4: WINvsWIN folded before Flop (didn't bet)
Seat 5: bruvsky folded before Flop (didn't bet)
Seat 6: kanococo (button) showed [Qh Jd]
Seat 7: G3TR3KTF1SH (small blind) folded on the Turn

CoinPoker Hand #292664832: Hold'em No Limit (0.01/0.02 ) 2025/09/05 23:36:29 GMT
Table 'NL ₮2 VI' 7-max Seat #7 is the button
Seat 1: DarGeo (2.49 in chips)
Seat 2: D3ATHANG3L (1.42 in chips)
Seat 3: AladeenMF (2.36 in chips)
Seat 4: WINvsWIN (2.00 in chips)
Seat 5: bruvsky (2.10 in chips)
Seat 6: kanococo (1.03 in chips)
Seat 7: G3TR3KTF1SH (2.04 in chips)
DarGeo: posts small blind 0.01
D3ATHANG3L: posts big blind 0.02
*** HOLE CARDS ***
Dealt to kanococo [8c 4s]
AladeenMF: folds
WINvsWIN: raises 0.02 to 0.04
bruvsky: folds
kanococo: folds
G3TR3KTF1SH: calls 0.04
DarGeo: raises 0.12 to 0.16
D3ATHANG3L: folds
WINvsWIN: calls 0.12
G3TR3KTF1SH: calls 0.12
*** FLOP *** [2d 8d 6h]
DarGeo: checks
WINvsWIN: bets 0.22
G3TR3KTF1SH: calls 0.22
DarGeo: calls 0.22
*** TURN *** [2d 8d 6h] [3d]
DarGeo: checks
WINvsWIN: checks
G3TR3KTF1SH: bets 0.55
DarGeo has timed out
DarGeo activated time-bank (33 seconds)
DarGeo: raises 2.11 and is all-in
WINvsWIN: folds
G3TR3KTF1SH has timed out
G3TR3KTF1SH activated time-bank (60 seconds)
G3TR3KTF1SH: folds
Uncalled bet (1.56) returned to DarGeo
DarGeo collected 2.20 from pot
DarGeo: doesn't show hand
*** SUMMARY ***
Total pot 2.26 | Rake 0.06
Board [ 2d 8d 6h 3d ]
Game ended: 2025/09/05 23:38:50 GMT
Seat 1: DarGeo (small blind) collected (2.20)
Seat 2: D3ATHANG3L (big blind) folded before Flop
Seat 3: AladeenMF folded before Flop (didn't bet)
Seat 4: WINvsWIN folded on the Turn
Seat 5: bruvsky folded before Flop (didn't bet)
Seat 6: kanococo folded before Flop (didn't bet)
Seat 7: G3TR3KTF1SH (button) folded on the Turn

CoinPoker Hand #292665597: Hold'em No Limit (0.01/0.02 ) 2025/09/05 23:38:52 GMT
Table 'NL ₮2 VI' 7-max Seat #1 is the button
Seat 1: DarGeo (3.76 in chips)
Seat 2: Junesba (1.99 in chips)
Seat 3: AladeenMF (2.36 in chips)
Seat 4: WINvsWIN (2.00 in chips)
Seat 5: bruvsky (2.10 in chips)
Seat 6: kanococo (1.03 in chips)
Seat 7: G3TR3KTF1SH (2.00 in chips)
Junesba: posts small blind 0.01
AladeenMF: posts big blind 0.02
*** HOLE CARDS ***
Dealt to kanococo [Jc 3d]
WINvsWIN: folds
bruvsky: folds
kanococo: folds
G3TR3KTF1SH: folds
DarGeo: folds
Junesba has timed out
Junesba activated time-bank (60 seconds)
Junesba: folds
AladeenMF collected 0.03 from pot
AladeenMF: doesn't show hand
*** SUMMARY ***
Total pot 0.03 | Rake 0.00
Board [ ]
Game ended: 2025/09/05 23:39:34 GMT
Seat 1: DarGeo (button) folded before Flop (didn't bet)
Seat 2: Junesba (small blind) folded before Flop
Seat 3: AladeenMF (big blind) collected (0.03)
Seat 4: WINvsWIN folded before Flop (didn't bet)
Seat 5: bruvsky folded before Flop (didn't bet)
Seat 6: kanococo folded before Flop (didn't bet)
Seat 7: G3TR3KTF1SH folded before Flop (didn't bet)

CoinPoker Hand #292665818: Hold'em No Limit (0.01/0.02 ) 2025/09/05 23:39:36 GMT
Table 'NL ₮2 VI' 7-max Seat #2 is the button
Seat 1: DarGeo (3.76 in chips)
Seat 2: Junesba (2.00 in chips)
Seat 3: AladeenMF (2.37 in chips)
Seat 4: WINvsWIN (2.00 in chips)
Seat 5: bruvsky (2.10 in chips)
Seat 6: kanococo (1.03 in chips)
Seat 7: G3TR3KTF1SH (2.00 in chips)
AladeenMF: posts small blind 0.01
WINvsWIN: posts big blind 0.02
*** HOLE CARDS ***
Dealt to kanococo [3d 9d]
bruvsky: raises 0.04 to 0.06
kanococo: folds
G3TR3KTF1SH: folds
DarGeo: folds
Junesba: folds
AladeenMF has timed out
AladeenMF activated time-bank (60 seconds)
AladeenMF: folds
WINvsWIN: folds
bruvsky collected 0.09 from pot
bruvsky: doesn't show hand
*** SUMMARY ***
Total pot 0.09 | Rake 0.00
Board [ ]
Game ended: 2025/09/05 23:40:25 GMT
Seat 1: DarGeo folded before Flop (didn't bet)
Seat 2: Junesba (button) folded before Flop (didn't bet)
Seat 3: AladeenMF (small blind) folded before Flop
Seat 4: WINvsWIN (big blind) folded before Flop
Seat 5: bruvsky collected (0.09)
Seat 6: kanococo folded before Flop (didn't bet)
Seat 7: G3TR3KTF1SH folded before Flop (didn't bet)

CoinPoker Hand #292666062: Hold'em No Limit (0.01/0.02 ) 2025/09/05 23:40:27 GMT
Table 'NL ₮2 VI' 7-max Seat #3 is the button
Seat 1: DarGeo (3.76 in chips)
Seat 2: Junesba (2.00 in chips)
Seat 3: AladeenMF (2.36 in chips)
Seat 4: WINvsWIN (2.00 in chips)
Seat 5: bruvsky (2.13 in chips)
Seat 6: kanococo (1.03 in chips)
Seat 7: G3TR3KTF1SH (2.00 in chips)
WINvsWIN: posts small blind 0.01
bruvsky: posts big blind 0.02
*** HOLE CARDS ***
Dealt to kanococo [Ad Kh]
kanococo: raises 0.06 to 0.08
G3TR3KTF1SH: folds
DarGeo: raises 0.20 to 0.28
Junesba: folds
AladeenMF: folds
WINvsWIN: folds
bruvsky: folds
kanococo: calls 0.20
*** FLOP *** [Qs 2h 7h]
kanococo: bets 0.06
DarGeo: calls 0.06
*** TURN *** [Qs 2h 7h] [Ts]
kanococo: checks
DarGeo: checks
*** RIVER *** [Qs 2h 7h Ts] [As]
kanococo: bets 0.69 and is all-in
DarGeo has timed out
DarGeo activated time-bank (19 seconds)
DarGeo: calls 0.69
*** SHOW DOWN ***
kanococo: shows [Ad Kh] (a pair of Aces)
DarGeo: shows [Kc Ac] (a pair of Aces)
kanococo collected 1.00 from pot
DarGeo collected 0.99 from pot
*** SUMMARY ***
Total pot 2.09 | Rake 0.10
Board [ Qs 2h 7h Ts As ]
Game ended: 2025/09/05 23:42:17 GMT
Seat 1: DarGeo showed [Kc Ac] and won (0.99) with a pair of Aces
Seat 2: Junesba folded before Flop (didn't bet)
Seat 3: AladeenMF (button) folded before Flop (didn't bet)
Seat 4: WINvsWIN (small blind) folded before Flop
Seat 5: bruvsky (big blind) folded before Flop
Seat 6: kanococo showed [Ad Kh] and won (1.00) with a pair of Aces
Seat 7: G3TR3KTF1SH folded before Flop (didn't bet)

CoinPoker Hand #292666665: Hold'em No Limit (0.01/0.02 ) 2025/09/05 23:42:19 GMT
Table 'NL ₮2 VI' 7-max Seat #4 is the button
Seat 1: DarGeo (3.72 in chips)
Seat 2: Junesba (2.00 in chips)
Seat 3: AladeenMF (2.36 in chips)
Seat 4: Gstacks (2.00 in chips) out of hand
Seat 5: bruvsky (2.11 in chips)
Seat 6: kanococo (1.00 in chips)
Seat 7: G3TR3KTF1SH (2.00 in chips)
bruvsky: posts small blind 0.01
kanococo: posts big blind 0.02
*** HOLE CARDS ***
Dealt to kanococo [2s 4c]
G3TR3KTF1SH: folds
DarGeo: raises 0.06 to 0.08
Junesba: folds
AladeenMF: folds
bruvsky: folds
kanococo: folds
DarGeo collected 0.11 from pot
DarGeo: doesn't show hand
*** SUMMARY ***
Total pot 0.11 | Rake 0.00
Board [ ]
Game ended: 2025/09/05 23:42:40 GMT
Seat 1: DarGeo collected (0.11)
Seat 2: Junesba folded before Flop (didn't bet)
Seat 3: AladeenMF folded before Flop (didn't bet)
Seat 4: Gstacks (button) folded before Flop (didn't bet)
Seat 5: bruvsky (small blind) folded before Flop
Seat 6: kanococo (big blind) folded before Flop
Seat 7: G3TR3KTF1SH folded before Flop (didn't bet)

CoinPoker Hand #292666791: Hold'em No Limit (0.01/0.02 ) 2025/09/05 23:42:42 GMT
Table 'NL ₮2 VI' 7-max Seat #5 is the button
Seat 1: DarGeo (3.75 in chips)
Seat 2: Junesba (2.00 in chips)
Seat 3: AladeenMF (2.36 in chips)
Seat 4: Gstacks (2.00 in chips) out of hand
Seat 5: bruvsky (2.10 in chips)
Seat 6: kanococo (0.98 in chips)
Seat 7: G3TR3KTF1SH (2.00 in chips)
kanococo: posts small blind 0.01
G3TR3KTF1SH: posts big blind 0.02
*** HOLE CARDS ***
Dealt to kanococo [Kd 9d]
DarGeo: folds
Junesba: raises 0.02 to 0.04
AladeenMF: folds
bruvsky: folds
kanococo: raises 0.04 to 0.08
G3TR3KTF1SH: folds
Junesba: calls 0.04
*** FLOP *** [Ks Ad 4s]
kanococo: checks
Junesba: bets 0.07
kanococo: calls 0.07
*** TURN *** [Ks Ad 4s] [5d]
kanococo: bets 0.14
Junesba has timed out
Junesba activated time-bank (59 seconds)
Junesba: raises 0.35 to 0.49
kanococo: raises 0.69 and is all-in
Junesba: calls 0.34
*** RIVER *** [Ks Ad 4s 5d] [Ts]
*** SHOW DOWN ***
kanococo: shows [Kd 9d] (a pair of Kings)
Junesba: shows [Ac 8c] (a pair of Aces)
Junesba collected 1.88 from pot
*** SUMMARY ***
Total pot 1.98 | Rake 0.10
Board [ Ks Ad 4s 5d Ts ]
Game ended: 2025/09/05 23:43:51 GMT
Seat 1: DarGeo folded before Flop (didn't bet)
Seat 2: Junesba showed [Ac 8c] and won (1.88) with a pair of Aces
Seat 3: AladeenMF folded before Flop (didn't bet)
Seat 4: Gstacks folded before Flop (didn't bet)
Seat 5: bruvsky (button) folded before Flop (didn't bet)
Seat 6: kanococo (small blind) showed [Kd 9d]
Seat 7: G3TR3KTF1SH (big blind) folded before Flop

CoinPoker Hand #293559976: Hold'em No Limit (0.01/0.02 ) 2025/09/07 20:20:15 GMT
Table 'NL ₮2 I' 7-max Seat #6 is the button
Seat 1: AJHPoker (2.00 in chips)
Seat 2: Fatallica (1.88 in chips)
Seat 3: kanococo (2.00 in chips)
Seat 5: Permaban (2.00 in chips)
Seat 6: ColdFish (2.44 in chips)
AJHPoker: posts small blind 0.01
Fatallica: posts big blind 0.02
kanococo: posts big blind 0.02
*** HOLE CARDS ***
Dealt to kanococo [9h Ts]
kanococo: checks
Permaban: folds
ColdFish: folds
AJHPoker: calls 0.01
Fatallica: checks
*** FLOP *** [5d Qd 6c]
AJHPoker: checks
Fatallica: checks
kanococo: checks
*** TURN *** [5d Qd 6c] [2d]
AJHPoker: bets 0.04
Fatallica: calls 0.04
kanococo has timed out
kanococo activated time-bank (60 seconds)
kanococo: folds
*** RIVER *** [5d Qd 6c 2d] [Qh]
AJHPoker: bets 0.04
Fatallica: folds
Uncalled bet (0.04) returned to AJHPoker
AJHPoker collected 0.13 from pot
AJHPoker: doesn't show hand
*** SUMMARY ***
Total pot 0.14 | Rake 0.01
Board [ 5d Qd 6c 2d Qh ]
Game ended: 2025/09/07 20:21:23 GMT
Seat 1: AJHPoker (small blind) collected (0.13)
Seat 2: Fatallica (big blind) folded on the River
Seat 3: kanococo folded on the Turn
Seat 5: Permaban folded before Flop (didn't bet)
Seat 6: ColdFish (button) folded before Flop (didn't bet)

CoinPoker Hand #293560440: Hold'em No Limit (0.01/0.02 ) 2025/09/07 20:21:25 GMT
Table 'NL ₮2 I' 7-max Seat #1 is the button
Seat 1: AJHPoker (2.07 in chips)
Seat 2: Fatallica (1.82 in chips)
Seat 3: kanococo (1.98 in chips)
Seat 5: Permaban (2.00 in chips)
Seat 6: ColdFish (2.44 in chips)
Fatallica: posts small blind 0.01
kanococo: posts big blind 0.02
*** HOLE CARDS ***
Dealt to kanococo [9c 8h]
Permaban: raises 0.03 to 0.05
ColdFish: folds
AJHPoker: folds
Fatallica: folds
kanococo: raises 0.05 to 0.10
Permaban: calls 0.05
*** FLOP *** [Th 7h 7c]
kanococo: checks
Permaban: bets 0.06
kanococo: calls 0.06
*** TURN *** [Th 7h 7c] [5c]
kanococo: checks
Permaban: checks
*** RIVER *** [Th 7h 7c 5c] [Ah]
kanococo has timed out
kanococo activated time-bank (57 seconds)
kanococo: checks
Permaban: checks
*** SHOW DOWN ***
kanococo: shows [9c 8h] (a pair of Sevens)
Permaban: shows [4h 4d] (two pairs, Sevens and Fours)
Permaban collected 0.31 from pot
*** SUMMARY ***
Total pot 0.33 | Rake 0.02
Board [ Th 7h 7c 5c Ah ]
Game ended: 2025/09/07 20:22:50 GMT
Seat 1: AJHPoker (button) folded before Flop (didn't bet)
Seat 2: Fatallica (small blind) folded before Flop
Seat 3: kanococo (big blind) showed [9c 8h]
Seat 5: Permaban showed [4h 4d] and won (0.31) with two pairs, Sevens and Fours
Seat 6: ColdFish folded before Flop (didn't bet)

CoinPoker Hand #293561071: Hold'em No Limit (0.01/0.02 ) 2025/09/07 20:22:52 GMT
Table 'NL ₮2 I' 7-max Seat #2 is the button
Seat 1: AJHPoker (2.07 in chips)
Seat 2: Fatallica (1.81 in chips)
Seat 3: kanococo (1.82 in chips)
Seat 5: Permaban (2.15 in chips)
Seat 6: ColdFish (2.44 in chips)
Seat 7: oferoza (2.00 in chips)
kanococo: posts small blind 0.01
Permaban: posts big blind 0.02
oferoza: posts big blind 0.02
*** HOLE CARDS ***
Dealt to kanococo [9c Jh]
ColdFish: folds
oferoza: checks
AJHPoker: folds
Fatallica: folds
kanococo: raises 0.02 to 0.04
Permaban: folds
oferoza: calls 0.02
*** FLOP *** [9s Kd Ks]
kanococo: checks
oferoza: checks
*** TURN *** [9s Kd Ks] [5d]
kanococo: bets 0.06
oferoza: folds
Uncalled bet (0.06) returned to kanococo
kanococo collected 0.09 from pot
kanococo: doesn't show hand
*** SUMMARY ***
Total pot 0.10 | Rake 0.01
Board [ 9s Kd Ks 5d ]
Game ended: 2025/09/07 20:23:45 GMT
Seat 1: AJHPoker folded before Flop (didn't bet)
Seat 2: Fatallica (button) folded before Flop (didn't bet)
Seat 3: kanococo (small blind) collected (0.09)
Seat 5: Permaban (big blind) folded before Flop
Seat 6: ColdFish folded before Flop (didn't bet)
Seat 7: oferoza folded on the Turn

CoinPoker Hand #293561507: Hold'em No Limit (0.01/0.02 ) 2025/09/07 20:23:47 GMT
Table 'NL ₮2 I' 7-max Seat #3 is the button
Seat 1: AJHPoker (2.07 in chips)
Seat 2: Fatallica (1.81 in chips)
Seat 3: kanococo (1.87 in chips)
Seat 4: pudah (0.80 in chips)
Seat 5: Permaban (2.13 in chips)
Seat 6: ColdFish (2.44 in chips)
Seat 7: oferoza (1.96 in chips)
Permaban: posts small blind 0.01
ColdFish: posts big blind 0.02
pudah: posts big blind 0.02
*** HOLE CARDS ***
Dealt to kanococo [3h Jc]
oferoza: folds
AJHPoker: folds
Fatallica: folds
kanococo: folds
pudah: checks
Permaban: calls 0.01
ColdFish: checks
*** FLOP *** [6h 6s Ac]
pudah: checks
Permaban: checks
ColdFish: checks
*** TURN *** [6h 6s Ac] [5c]
pudah: checks
Permaban: bets 0.02
ColdFish: calls 0.02
pudah: folds
*** RIVER *** [6h 6s Ac 5c] [Ad]
Permaban: bets 0.09
ColdFish: calls 0.09
*** SHOW DOWN ***
Permaban: shows [2d 5d] (two pairs, Aces and Sixes)
ColdFish: shows [8h 6d] (a full house, Sixes over Aces)
ColdFish collected 0.27 from pot
*** SUMMARY ***
Total pot 0.28 | Rake 0.01
Board [ 6h 6s Ac 5c Ad ]
Game ended: 2025/09/07 20:24:55 GMT
Seat 1: AJHPoker folded before Flop (didn't bet)
Seat 2: Fatallica folded before Flop (didn't bet)
Seat 3: kanococo (button) folded before Flop (didn't bet)
Seat 4: pudah folded on the Turn
Seat 5: Permaban (small blind) showed [2d 5d]
Seat 6: ColdFish (big blind) showed [8h 6d] and won (0.27) with a full house, Sixes over Aces
Seat 7: oferoza folded before Flop (didn't bet)

CoinPoker Hand #293562012: Hold'em No Limit (0.01/0.02 ) 2025/09/07 20:24:57 GMT
Table 'NL ₮2 I' 7-max Seat #5 is the button
Seat 1: AJHPoker (2.07 in chips)
Seat 2: Fatallica (1.81 in chips)
Seat 3: kanococo (1.87 in chips)
Seat 4: pudah (0.78 in chips)
Seat 5: Permaban (2.00 in chips)
Seat 6: ColdFish (2.58 in chips)
Seat 7: oferoza (1.96 in chips)
ColdFish: posts small blind 0.01
oferoza: posts big blind 0.02
*** HOLE CARDS ***
Dealt to kanococo [3d 6s]
AJHPoker: folds
Fatallica: folds
kanococo: folds
pudah: folds
Permaban: raises 0.03 to 0.05
ColdFish: folds
oferoza: folds
Permaban collected 0.08 from pot
Permaban: doesn't show hand
*** SUMMARY ***
Total pot 0.08 | Rake 0.00
Board [ ]
Game ended: 2025/09/07 20:25:28 GMT
Seat 1: AJHPoker folded before Flop (didn't bet)
Seat 2: Fatallica folded before Flop (didn't bet)
Seat 3: kanococo folded before Flop (didn't bet)
Seat 4: pudah folded before Flop (didn't bet)
Seat 5: Permaban (button) collected (0.08)
Seat 6: ColdFish (small blind) folded before Flop
Seat 7: oferoza (big blind) folded before Flop

CoinPoker Hand #293562177: Hold'em No Limit (0.01/0.02 ) 2025/09/07 20:25:30 GMT
Table 'NL ₮2 I' 7-max Seat #6 is the button
Seat 1: AJHPoker (2.07 in chips)
Seat 2: Fatallica (1.81 in chips)
Seat 3: kanococo (1.87 in chips)
Seat 4: pudah (0.78 in chips)
Seat 5: Permaban (2.03 in chips)
Seat 6: ColdFish (2.57 in chips)
Seat 7: oferoza (1.94 in chips)
oferoza: posts small blind 0.01
AJHPoker: posts big blind 0.02
*** HOLE CARDS ***
Dealt to kanococo [Qs Kc]
Fatallica: raises 0.05 to 0.07
kanococo: calls 0.07
pudah: folds
Permaban: folds
ColdFish: calls 0.07
oferoza: folds
AJHPoker: folds
*** FLOP *** [Ks Qh 4s]
Fatallica: checks
kanococo: bets 0.14
ColdFish: folds
Fatallica: calls 0.14
*** TURN *** [Ks Qh 4s] [Jd]
Fatallica: checks
kanococo: bets 0.28
Fatallica: raises 0.52 to 0.80
kanococo: calls 0.52
*** RIVER *** [Ks Qh 4s Jd] [4c]
Fatallica: bets 0.80 and is all-in
kanococo: calls 0.80
*** SHOW DOWN ***
Fatallica: shows [Kh Jh] (two pairs, Kings and Jacks)
kanococo: shows [Qs Kc] (two pairs, Kings and Queens)
kanococo collected 3.53 from pot
*** SUMMARY ***
Total pot 3.72 | Rake 0.19
Board [ Ks Qh 4s Jd 4c ]
Game ended: 2025/09/07 20:26:49 GMT
Seat 1: AJHPoker (big blind) folded before Flop
Seat 2: Fatallica showed [Kh Jh]
Seat 3: kanococo showed [Qs Kc] and won (3.53) with two pairs, Kings and Queens
Seat 4: pudah folded before Flop (didn't bet)
Seat 5: Permaban folded before Flop (didn't bet)
Seat 6: ColdFish (button) folded on the Flop
Seat 7: oferoza (small blind) folded before Flop

CoinPoker Hand #293562743: Hold'em No Limit (0.01/0.02 ) 2025/09/07 20:26:54 GMT
Table 'NL ₮2 I' 7-max Seat #7 is the button
Seat 1: AJHPoker (2.05 in chips)
Seat 3: kanococo (3.59 in chips)
Seat 4: pudah (0.78 in chips)
Seat 5: Permaban (2.03 in chips)
Seat 6: ColdFish (2.50 in chips)
Seat 7: oferoza (1.93 in chips)
AJHPoker: posts small blind 0.01
kanococo: posts big blind 0.02
*** HOLE CARDS ***
Dealt to kanococo [9d Ks]
pudah: folds
Permaban: raises 0.03 to 0.05
ColdFish: folds
oferoza: calls 0.05
AJHPoker: folds
kanococo: raises 0.07 to 0.12
Permaban: calls 0.07
oferoza: folds
*** FLOP *** [2c 7c Ah]
kanococo: checks
Permaban: bets 0.08
kanococo: calls 0.08
*** TURN *** [2c 7c Ah] [2h]
kanococo: bets 0.24
Permaban: calls 0.24
*** RIVER *** [2c 7c Ah 2h] [Ad]
kanococo: checks
Permaban: bets 1.59 and is all-in
kanococo: folds
Uncalled bet (1.59) returned to Permaban
Permaban collected 0.89 from pot
Permaban: doesn't show hand
*** SUMMARY ***
Total pot 0.94 | Rake 0.05
Board [ 2c 7c Ah 2h Ad ]
Game ended: 2025/09/07 20:28:39 GMT
Seat 1: AJHPoker (small blind) folded before Flop
Seat 3: kanococo (big blind) folded on the River
Seat 4: pudah folded before Flop (didn't bet)
Seat 5: Permaban collected (0.89)
Seat 6: ColdFish folded before Flop (didn't bet)
Seat 7: oferoza (button) folded before Flop

CoinPoker Hand #293563524: Hold'em No Limit (0.01/0.02 ) 2025/09/07 20:28:41 GMT
Table 'NL ₮2 I' 7-max Seat #1 is the button
Seat 1: AJHPoker (2.04 in chips)
Seat 2: Holy1 (0.80 in chips) out of hand
Seat 3: kanococo (3.15 in chips)
Seat 4: pudah (0.78 in chips)
Seat 5: Permaban (2.48 in chips)
Seat 6: ColdFish (2.50 in chips)
Seat 7: oferoza (1.88 in chips)
kanococo: posts small blind 0.01
pudah: posts big blind 0.02
*** HOLE CARDS ***
Dealt to kanococo [Kd 6c]
Permaban: folds
ColdFish: raises 0.04 to 0.06
oferoza has timed out
oferoza activated time-bank (60 seconds)
oferoza: calls 0.06
AJHPoker: folds
kanococo has timed out
kanococo activated time-bank (56 seconds)
kanococo: calls 0.05
pudah: raises 0.24 to 0.30
ColdFish: folds
oferoza: folds
kanococo has timed out
kanococo activated time-bank (54 seconds)
kanococo: folds
pudah collected 0.48 from pot
pudah: doesn't show hand
*** SUMMARY ***
Total pot 0.48 | Rake 0.00
Board [ ]
Game ended: 2025/09/07 20:30:22 GMT
Seat 1: AJHPoker (button) folded before Flop (didn't bet)
Seat 2: Holy1 folded before Flop (didn't bet)
Seat 3: kanococo (small blind) folded before Flop
Seat 4: pudah (big blind) collected (0.48)
Seat 5: Permaban folded before Flop (didn't bet)
Seat 6: ColdFish folded before Flop
Seat 7: oferoza folded before Flop

CoinPoker Hand #293564359: Hold'em No Limit (0.01/0.02 ) 2025/09/07 20:30:24 GMT
Table 'NL ₮2 I' 7-max Seat #3 is the button
Seat 1: AJHPoker (2.04 in chips)
Seat 2: Holy1 (0.80 in chips) out of hand
Seat 3: kanococo (3.09 in chips)
Seat 4: pudah (0.96 in chips)
Seat 5: Permaban (2.48 in chips)
Seat 6: ColdFish (2.44 in chips)
Seat 7: oferoza (1.82 in chips)
pudah: posts small blind 0.01
Permaban: posts big blind 0.02
*** HOLE CARDS ***
Dealt to kanococo [7s 9h]
ColdFish: raises 0.04 to 0.06
oferoza: folds
AJHPoker: folds
kanococo: folds
pudah: folds
Permaban: calls 0.04
*** FLOP *** [6c 4s Kd]
Permaban: checks
ColdFish: bets 0.03
Permaban: raises 0.08 to 0.11
ColdFish: calls 0.08
*** TURN *** [6c 4s Kd] [9c]
Permaban: checks
ColdFish: bets 0.18
Permaban: raises 0.37 to 0.55
ColdFish: folds
Uncalled bet (0.37) returned to Permaban
Permaban collected 0.69 from pot
Permaban: doesn't show hand
*** SUMMARY ***
Total pot 0.71 | Rake 0.02
Board [ 6c 4s Kd 9c ]
Game ended: 2025/09/07 20:31:31 GMT
Seat 1: AJHPoker folded before Flop (didn't bet)
Seat 2: Holy1 folded before Flop (didn't bet)
Seat 3: kanococo (button) folded before Flop (didn't bet)
Seat 4: pudah (small blind) folded before Flop
Seat 5: Permaban (big blind) collected (0.69)
Seat 6: ColdFish folded on the Turn
Seat 7: oferoza folded before Flop (didn't bet)

CoinPoker Hand #293564737: Hold'em No Limit (0.01/0.02 ) 2025/09/07 20:31:32 GMT
Table 'NL ₮2 I' 7-max Seat #4 is the button
Seat 1: AJHPoker (2.04 in chips)
Seat 2: Holy1 (0.80 in chips) out of hand
Seat 3: kanococo (3.09 in chips)
Seat 4: pudah (0.95 in chips)
Seat 5: Permaban (2.82 in chips)
Seat 6: ColdFish (2.09 in chips)
Seat 7: oferoza (1.82 in chips)
Permaban: posts small blind 0.01
ColdFish: posts big blind 0.02
*** HOLE CARDS ***
Dealt to kanococo [8c 7s]
oferoza: raises 0.04 to 0.06
AJHPoker: folds
kanococo: folds
pudah: calls 0.06
Permaban: folds
ColdFish: raises 0.20 to 0.26
oferoza has timed out
oferoza activated time-bank (41 seconds)
oferoza: raises 0.38 to 0.64
pudah: folds
ColdFish: folds
oferoza collected 0.97 from pot
oferoza: doesn't show hand
*** SUMMARY ***
Total pot 0.97 | Rake 0.00
Board [ ]
Game ended: 2025/09/07 20:32:42 GMT
Seat 1: AJHPoker folded before Flop (didn't bet)
Seat 2: Holy1 folded before Flop (didn't bet)
Seat 3: kanococo folded before Flop (didn't bet)
Seat 4: pudah (button) folded before Flop
Seat 5: Permaban (small blind) folded before Flop
Seat 6: ColdFish (big blind) folded before Flop
Seat 7: oferoza collected (0.97)

CoinPoker Hand #293565222: Hold'em No Limit (0.01/0.02 ) 2025/09/07 20:32:44 GMT
Table 'NL ₮2 I' 7-max Seat #5 is the button
Seat 1: AJHPoker (2.04 in chips)
Seat 2: Holy1 (0.80 in chips) out of hand
Seat 3: kanococo (3.09 in chips)
Seat 4: pudah (0.89 in chips)
Seat 5: Permaban (2.81 in chips)
Seat 6: ColdFish (2.00 in chips)
Seat 7: oferoza (2.15 in chips)
ColdFish: posts small blind 0.01
oferoza: posts big blind 0.02
*** HOLE CARDS ***
Dealt to kanococo [Td 2d]
AJHPoker: folds
kanococo: folds
pudah: raises 0.05 to 0.07
Permaban: folds
ColdFish: calls 0.06
oferoza: folds
*** FLOP *** [2h As 7d]
ColdFish: checks
pudah: checks
*** TURN *** [2h As 7d] [7h]
ColdFish: checks
pudah: checks
*** RIVER *** [2h As 7d 7h] [3s]
ColdFish: bets 0.15
pudah: folds
Uncalled bet (0.15) returned to ColdFish
ColdFish collected 0.15 from pot
ColdFish: doesn't show hand
*** SUMMARY ***
Total pot 0.16 | Rake 0.01
Board [ 2h As 7d 7h 3s ]
Game ended: 2025/09/07 20:33:34 GMT
Seat 1: AJHPoker folded before Flop (didn't bet)
Seat 2: Holy1 folded before Flop (didn't bet)
Seat 3: kanococo folded before Flop (didn't bet)
Seat 4: pudah folded on the River
Seat 5: Permaban (button) folded before Flop (didn't bet)
Seat 6: ColdFish (small blind) collected (0.15)
Seat 7: oferoza (big blind) folded before Flop

CoinPoker Hand #293565619: Hold'em No Limit (0.01/0.02 ) 2025/09/07 20:33:37 GMT
Table 'NL ₮2 I' 7-max Seat #6 is the button
Seat 1: AJHPoker (2.04 in chips)
Seat 2: Holy1 (0.80 in chips) out of hand
Seat 3: kanococo (3.09 in chips)
Seat 4: pudah (0.82 in chips)
Seat 5: Permaban (2.81 in chips)
Seat 6: ColdFish (2.08 in chips)
Seat 7: oferoza (2.13 in chips)
oferoza: posts small blind 0.01
AJHPoker: posts big blind 0.02
*** HOLE CARDS ***
Dealt to kanococo [2h Ks]
kanococo: folds
pudah: folds
Permaban: folds
ColdFish: raises 0.04 to 0.06
oferoza: folds
AJHPoker: calls 0.04
*** FLOP *** [2d Kh Ts]
AJHPoker: checks
ColdFish: bets 0.08
AJHPoker: folds
Uncalled bet (0.08) returned to ColdFish
ColdFish collected 0.12 from pot
ColdFish: doesn't show hand
*** SUMMARY ***
Total pot 0.13 | Rake 0.01
Board [ 2d Kh Ts ]
Game ended: 2025/09/07 20:34:31 GMT
Seat 1: AJHPoker (big blind) folded on the Flop
Seat 2: Holy1 folded before Flop (didn't bet)
Seat 3: kanococo folded before Flop (didn't bet)
Seat 4: pudah folded before Flop (didn't bet)
Seat 5: Permaban folded before Flop (didn't bet)
Seat 6: ColdFish (button) collected (0.12)
Seat 7: oferoza (small blind) folded before Flop

CoinPoker Hand #293566062: Hold'em No Limit (0.01/0.02 ) 2025/09/07 20:34:33 GMT
Table 'NL ₮2 I' 7-max Seat #7 is the button
Seat 1: AJHPoker (1.98 in chips)
Seat 2: Holy1 (0.80 in chips)
Seat 3: kanococo (3.09 in chips)
Seat 4: pudah (0.82 in chips)
Seat 5: Permaban (2.81 in chips)
Seat 6: ColdFish (2.14 in chips)
Seat 7: oferoza (2.12 in chips)
AJHPoker: posts small blind 0.01
Holy1: posts big blind 0.02
*** HOLE CARDS ***
Dealt to kanococo [5h Ah]
kanococo: folds
pudah: calls 0.02
Permaban: calls 0.02
ColdFish: folds
oferoza: folds
AJHPoker: calls 0.01
Holy1: checks
*** FLOP *** [As Js 4c]
AJHPoker: checks
Holy1: checks
pudah: checks
Permaban: checks
*** TURN *** [As Js 4c] [6c]
AJHPoker: checks
Holy1: checks
pudah: checks
Permaban: checks
*** RIVER *** [As Js 4c 6c] [2h]
AJHPoker: checks
Holy1: checks
pudah: checks
Permaban: checks
*** SHOW DOWN ***
AJHPoker: shows [2d Kd] (a pair of Twos)
Holy1: shows [6h 7d] (a pair of Sixes)
pudah: shows [Qh Jc] (a pair of Jacks)
Permaban: mucks hand
pudah collected 0.08 from pot
*** SUMMARY ***
Total pot 0.08 | Rake 0.00
Board [ As Js 4c 6c 2h ]
Game ended: 2025/09/07 20:35:45 GMT
Seat 1: AJHPoker (small blind) showed [2d Kd]
Seat 2: Holy1 (big blind) showed [6h 7d]
Seat 3: kanococo folded before Flop (didn't bet)
Seat 4: pudah showed [Qh Jc] and won (0.08) with a pair of Jacks
Seat 5: Permaban mucked
Seat 6: ColdFish folded before Flop (didn't bet)
Seat 7: oferoza (button) folded before Flop (didn't bet)

CoinPoker Hand #293566596: Hold'em No Limit (0.01/0.02 ) 2025/09/07 20:35:47 GMT
Table 'NL ₮2 I' 7-max Seat #1 is the button
Seat 1: AJHPoker (1.96 in chips)
Seat 2: Holy1 (0.78 in chips)
Seat 3: kanococo (3.09 in chips)
Seat 4: pudah (0.88 in chips)
Seat 5: Permaban (2.79 in chips)
Seat 6: ColdFish (2.14 in chips)
Seat 7: oferoza (2.12 in chips)
Holy1: posts small blind 0.01
kanococo: posts big blind 0.02
*** HOLE CARDS ***
Dealt to kanococo [6d Jc]
pudah: calls 0.02
Permaban: folds
ColdFish: folds
oferoza: folds
AJHPoker: folds
Holy1: folds
kanococo: raises 0.06 to 0.08
pudah: folds
kanococo collected 0.11 from pot
kanococo: doesn't show hand
*** SUMMARY ***
Total pot 0.11 | Rake 0.00
Board [ ]
Game ended: 2025/09/07 20:36:10 GMT
Seat 1: AJHPoker (button) folded before Flop (didn't bet)
Seat 2: Holy1 (small blind) folded before Flop
Seat 3: kanococo (big blind) collected (0.11)
Seat 4: pudah folded before Flop
Seat 5: Permaban folded before Flop (didn't bet)
Seat 6: ColdFish folded before Flop (didn't bet)
Seat 7: oferoza folded before Flop (didn't bet)

CoinPoker Hand #293566758: Hold'em No Limit (0.01/0.02 ) 2025/09/07 20:36:12 GMT
Table 'NL ₮2 I' 7-max Seat #2 is the button
Seat 1: AJHPoker (1.96 in chips)
Seat 2: Holy1 (0.77 in chips)
Seat 3: kanococo (3.12 in chips)
Seat 4: pudah (0.86 in chips)
Seat 5: Permaban (2.79 in chips)
Seat 6: ColdFish (2.14 in chips)
Seat 7: oferoza (2.12 in chips)
kanococo: posts small blind 0.01
pudah: posts big blind 0.02
*** HOLE CARDS ***
Dealt to kanococo [4s 6h]
Permaban: folds
ColdFish: folds
oferoza has timed out
oferoza activated time-bank (30 seconds)
oferoza: raises 0.03 to 0.05
AJHPoker: calls 0.05
Holy1: folds
kanococo: folds
pudah: folds
*** FLOP *** [6s Jh 7d]
oferoza: checks
AJHPoker: bets 0.06
oferoza has timed out
oferoza activated time-bank (28 seconds)
oferoza: folds
Uncalled bet (0.06) returned to AJHPoker
AJHPoker collected 0.12 from pot
AJHPoker: doesn't show hand
*** SUMMARY ***
Total pot 0.13 | Rake 0.01
Board [ 6s Jh 7d ]
Game ended: 2025/09/07 20:37:22 GMT
Seat 1: AJHPoker collected (0.12)
Seat 2: Holy1 (button) folded before Flop (didn't bet)
Seat 3: kanococo (small blind) folded before Flop
Seat 4: pudah (big blind) folded before Flop
Seat 5: Permaban folded before Flop (didn't bet)
Seat 6: ColdFish folded before Flop (didn't bet)
Seat 7: oferoza folded on the Flop

CoinPoker Hand #293567149: Hold'em No Limit (0.01/0.02 ) 2025/09/07 20:37:25 GMT
Table 'NL ₮2 I' 7-max Seat #3 is the button
Seat 1: AJHPoker (2.03 in chips)
Seat 2: Holy1 (0.77 in chips)
Seat 3: kanococo (3.11 in chips)
Seat 4: pudah (0.84 in chips)
Seat 5: Permaban (2.79 in chips)
Seat 6: ColdFish (2.14 in chips)
Seat 7: oferoza (2.07 in chips)
pudah: posts small blind 0.01
Permaban: posts big blind 0.02
*** HOLE CARDS ***
Dealt to kanococo [8c Ad]
ColdFish has timed out
ColdFish activated time-bank (60 seconds)
ColdFish: folds
oferoza: folds
AJHPoker: folds
Holy1: folds
kanococo: raises 0.06 to 0.08
pudah: folds
Permaban: folds
kanococo collected 0.11 from pot
kanococo: doesn't show hand
*** SUMMARY ***
Total pot 0.11 | Rake 0.00
Board [ ]
Game ended: 2025/09/07 20:37:58 GMT
Seat 1: AJHPoker folded before Flop (didn't bet)
Seat 2: Holy1 folded before Flop (didn't bet)
Seat 3: kanococo (button) collected (0.11)
Seat 4: pudah (small blind) folded before Flop
Seat 5: Permaban (big blind) folded before Flop
Seat 6: ColdFish folded before Flop (didn't bet)
Seat 7: oferoza folded before Flop (didn't bet)

CoinPoker Hand #293567431: Hold'em No Limit (0.01/0.02 ) 2025/09/07 20:38:00 GMT
Table 'NL ₮2 I' 7-max Seat #4 is the button
Seat 1: AJHPoker (2.03 in chips)
Seat 2: Holy1 (0.77 in chips)
Seat 3: kanococo (3.14 in chips)
Seat 4: pudah (0.83 in chips)
Seat 5: Permaban (2.77 in chips)
Seat 6: ColdFish (2.14 in chips)
Seat 7: oferoza (2.07 in chips)
Permaban: posts small blind 0.01
ColdFish: posts big blind 0.02
*** HOLE CARDS ***
Dealt to kanococo [9h Ah]
oferoza: folds
AJHPoker: folds
Holy1: raises 0.02 to 0.04
kanococo: raises 0.06 to 0.10
pudah: folds
Permaban: folds
ColdFish: folds
Holy1: folds
kanococo collected 0.17 from pot
kanococo: doesn't show hand
*** SUMMARY ***
Total pot 0.17 | Rake 0.00
Board [ ]
Game ended: 2025/09/07 20:38:36 GMT
Seat 1: AJHPoker folded before Flop (didn't bet)
Seat 2: Holy1 folded before Flop
Seat 3: kanococo collected (0.17)
Seat 4: pudah (button) folded before Flop (didn't bet)
Seat 5: Permaban (small blind) folded before Flop
Seat 6: ColdFish (big blind) folded before Flop
Seat 7: oferoza folded before Flop (didn't bet)

CoinPoker Hand #293567647: Hold'em No Limit (0.01/0.02 ) 2025/09/07 20:38:38 GMT
Table 'NL ₮2 I' 7-max Seat #5 is the button
Seat 1: AJHPoker (2.03 in chips)
Seat 2: Holy1 (0.73 in chips)
Seat 3: kanococo (3.21 in chips)
Seat 4: pudah (0.83 in chips)
Seat 5: Permaban (2.76 in chips)
Seat 6: ColdFish (2.12 in chips)
Seat 7: oferoza (2.07 in chips)
ColdFish: posts small blind 0.01
oferoza: posts big blind 0.02
*** HOLE CARDS ***
Dealt to kanococo [6c Ac]
AJHPoker: folds
Holy1: folds
kanococo: folds
pudah: folds
Permaban: folds
ColdFish: folds
oferoza collected 0.03 from pot
oferoza: doesn't show hand
*** SUMMARY ***
Total pot 0.03 | Rake 0.00
Board [ ]
Game ended: 2025/09/07 20:38:59 GMT
Seat 1: AJHPoker folded before Flop (didn't bet)
Seat 2: Holy1 folded before Flop (didn't bet)
Seat 3: kanococo folded before Flop (didn't bet)
Seat 4: pudah folded before Flop (didn't bet)
Seat 5: Permaban (button) folded before Flop (didn't bet)
Seat 6: ColdFish (small blind) folded before Flop
Seat 7: oferoza (big blind) collected (0.03)

CoinPoker Hand #293567820: Hold'em No Limit (0.01/0.02 ) 2025/09/07 20:39:01 GMT
Table 'NL ₮2 I' 7-max Seat #6 is the button
Seat 1: AJHPoker (2.03 in chips)
Seat 2: Holy1 (0.73 in chips)
Seat 3: kanococo (3.21 in chips)
Seat 4: pudah (0.83 in chips)
Seat 5: Permaban (2.76 in chips)
Seat 6: ColdFish (2.11 in chips)
Seat 7: oferoza (2.08 in chips)
oferoza: posts small blind 0.01
AJHPoker: posts big blind 0.02
*** HOLE CARDS ***
Dealt to kanococo [As 8h]
Holy1: folds
kanococo: folds
pudah: folds
Permaban: folds
ColdFish: folds
oferoza: raises 0.04 to 0.06
AJHPoker: folds
oferoza collected 0.08 from pot
oferoza: doesn't show hand
*** SUMMARY ***
Total pot 0.08 | Rake 0.00
Board [ ]
Game ended: 2025/09/07 20:39:40 GMT
Seat 1: AJHPoker (big blind) folded before Flop
Seat 2: Holy1 folded before Flop (didn't bet)
Seat 3: kanococo folded before Flop (didn't bet)
Seat 4: pudah folded before Flop (didn't bet)
Seat 5: Permaban folded before Flop (didn't bet)
Seat 6: ColdFish (button) folded before Flop (didn't bet)
Seat 7: oferoza (small blind) collected (0.08)

CoinPoker Hand #293568075: Hold'em No Limit (0.01/0.02 ) 2025/09/07 20:39:42 GMT
Table 'NL ₮2 I' 7-max Seat #7 is the button
Seat 1: AJHPoker (2.01 in chips)
Seat 2: Holy1 (0.73 in chips)
Seat 3: kanococo (3.21 in chips)
Seat 4: pudah (0.83 in chips)
Seat 5: Permaban (2.76 in chips)
Seat 6: ColdFish (2.11 in chips)
Seat 7: oferoza (2.10 in chips)
AJHPoker: posts small blind 0.01
Holy1: posts big blind 0.02
*** HOLE CARDS ***
Dealt to kanococo [8d Ks]
kanococo: folds
pudah: folds
Permaban: folds
ColdFish: folds
oferoza: folds
AJHPoker: raises 0.04 to 0.06
Holy1: calls 0.04
*** FLOP *** [Qc Qh Kc]
AJHPoker: bets 0.05
Holy1: calls 0.05
*** TURN *** [Qc Qh Kc] [Qs]
AJHPoker: checks
Holy1: checks
*** RIVER *** [Qc Qh Kc Qs] [Jd]
AJHPoker: checks
Holy1: checks
*** SHOW DOWN ***
AJHPoker: shows [As 2s] (three of kind, Queens)
Holy1: shows [7h 7d] (a full house, Queens over Sevens)
Holy1 collected 0.21 from pot
*** SUMMARY ***
Total pot 0.22 | Rake 0.01
Board [ Qc Qh Kc Qs Jd ]
Game ended: 2025/09/07 20:40:27 GMT
Seat 1: AJHPoker (small blind) showed [As 2s]
Seat 2: Holy1 (big blind) showed [7h 7d] and won (0.21) with a full house, Queens over Sevens
Seat 3: kanococo folded before Flop (didn't bet)
Seat 4: pudah folded before Flop (didn't bet)
Seat 5: Permaban folded before Flop (didn't bet)
Seat 6: ColdFish folded before Flop (didn't bet)
Seat 7: oferoza (button) folded before Flop (didn't bet)

CoinPoker Hand #293568435: Hold'em No Limit (0.01/0.02 ) 2025/09/07 20:40:29 GMT
Table 'NL ₮2 I' 7-max Seat #1 is the button
Seat 1: AJHPoker (1.90 in chips)
Seat 2: Holy1 (0.83 in chips)
Seat 3: kanococo (3.21 in chips)
Seat 4: pudah (0.83 in chips)
Seat 5: Permaban (2.76 in chips)
Seat 6: ColdFish (2.11 in chips)
Seat 7: oferoza (2.10 in chips)
Holy1: posts small blind 0.01
kanococo: posts big blind 0.02
*** HOLE CARDS ***
Dealt to kanococo [7h 3c]
pudah: folds
Permaban: folds
ColdFish: folds
oferoza: raises 0.02 to 0.04
AJHPoker: folds
Holy1: folds
kanococo: calls 0.02
*** FLOP *** [Qs Kd 6c]
kanococo: checks
oferoza: checks
*** TURN *** [Qs Kd 6c] [2h]
kanococo: checks
oferoza: checks
*** RIVER *** [Qs Kd 6c 2h] [Jh]
kanococo: checks
oferoza: checks
*** SHOW DOWN ***
kanococo: shows [7h 3c] (King high)
oferoza: shows [8s 7s] (King high)
oferoza collected 0.09 from pot
*** SUMMARY ***
Total pot 0.09 | Rake 0.00
Board [ Qs Kd 6c 2h Jh ]
Game ended: 2025/09/07 20:41:16 GMT
Seat 1: AJHPoker (button) folded before Flop (didn't bet)
Seat 2: Holy1 (small blind) folded before Flop
Seat 3: kanococo (big blind) showed [7h 3c]
Seat 4: pudah folded before Flop (didn't bet)
Seat 5: Permaban folded before Flop (didn't bet)
Seat 6: ColdFish folded before Flop (didn't bet)
Seat 7: oferoza showed [8s 7s] and won (0.09) with King high

CoinPoker Hand #293568757: Hold'em No Limit (0.01/0.02 ) 2025/09/07 20:41:19 GMT
Table 'NL ₮2 I' 7-max Seat #2 is the button
Seat 1: AJHPoker (1.90 in chips)
Seat 2: Holy1 (0.82 in chips)
Seat 3: kanococo (3.17 in chips)
Seat 4: pudah (0.83 in chips)
Seat 5: Permaban (2.76 in chips)
Seat 6: ColdFish (2.11 in chips)
Seat 7: oferoza (2.15 in chips)
kanococo: posts small blind 0.01
pudah: posts big blind 0.02
*** HOLE CARDS ***
Dealt to kanococo [9c 7d]
Permaban: folds
ColdFish: folds
oferoza: folds
AJHPoker: raises 0.04 to 0.06
Holy1: folds
kanococo: folds
pudah: calls 0.04
*** FLOP *** [4d 3c 3s]
pudah: checks
AJHPoker: bets 0.06
pudah: folds
Uncalled bet (0.06) returned to AJHPoker
AJHPoker collected 0.12 from pot
AJHPoker: doesn't show hand
*** SUMMARY ***
Total pot 0.13 | Rake 0.01
Board [ 4d 3c 3s ]
Game ended: 2025/09/07 20:41:52 GMT
Seat 1: AJHPoker collected (0.12)
Seat 2: Holy1 (button) folded before Flop (didn't bet)
Seat 3: kanococo (small blind) folded before Flop
Seat 4: pudah (big blind) folded on the Flop
Seat 5: Permaban folded before Flop (didn't bet)
Seat 6: ColdFish folded before Flop (didn't bet)
Seat 7: oferoza folded before Flop (didn't bet)

CoinPoker Hand #293569010: Hold'em No Limit (0.01/0.02 ) 2025/09/07 20:41:54 GMT
Table 'NL ₮2 I' 7-max Seat #3 is the button
Seat 1: AJHPoker (1.96 in chips)
Seat 2: Holy1 (0.82 in chips)
Seat 3: kanococo (3.16 in chips)
Seat 4: pudah (0.77 in chips)
Seat 5: Permaban (2.76 in chips)
Seat 6: ColdFish (2.11 in chips)
Seat 7: oferoza (2.15 in chips)
pudah: posts small blind 0.01
Permaban: posts big blind 0.02
*** HOLE CARDS ***
Dealt to kanococo [9h Ts]
ColdFish: folds
oferoza: folds
AJHPoker: folds
Holy1: raises 0.02 to 0.04
kanococo: folds
pudah: folds
Permaban: folds
Holy1 collected 0.07 from pot
Holy1: doesn't show hand
*** SUMMARY ***
Total pot 0.07 | Rake 0.00
Board [ ]
Game ended: 2025/09/07 20:42:29 GMT
Seat 1: AJHPoker folded before Flop (didn't bet)
Seat 2: Holy1 collected (0.07)
Seat 3: kanococo (button) folded before Flop (didn't bet)
Seat 4: pudah (small blind) folded before Flop
Seat 5: Permaban (big blind) folded before Flop
Seat 6: ColdFish folded before Flop (didn't bet)
Seat 7: oferoza folded before Flop (didn't bet)

CoinPoker Hand #293569260: Hold'em No Limit (0.01/0.02 ) 2025/09/07 20:42:30 GMT
Table 'NL ₮2 I' 7-max Seat #4 is the button
Seat 1: AJHPoker (1.96 in chips)
Seat 2: Holy1 (0.85 in chips)
Seat 3: kanococo (3.16 in chips)
Seat 4: pudah (0.76 in chips)
Seat 5: Permaban (2.74 in chips)
Seat 6: ColdFish (2.11 in chips)
Seat 7: oferoza (2.15 in chips)
Permaban: posts small blind 0.01
ColdFish: posts big blind 0.02
*** HOLE CARDS ***
Dealt to kanococo [Kh 5d]
oferoza: folds
AJHPoker: folds
Holy1: folds
kanococo: folds
pudah: folds
Permaban: raises 0.04 to 0.06
ColdFish: calls 0.04
*** FLOP *** [Ac Jd 7h]
Permaban: bets 0.03
ColdFish: raises 0.11 to 0.14
Permaban: folds
Uncalled bet (0.11) returned to ColdFish
ColdFish collected 0.17 from pot
ColdFish: doesn't show hand
*** SUMMARY ***
Total pot 0.18 | Rake 0.01
Board [ Ac Jd 7h ]
Game ended: 2025/09/07 20:43:20 GMT
Seat 1: AJHPoker folded before Flop (didn't bet)
Seat 2: Holy1 folded before Flop (didn't bet)
Seat 3: kanococo folded before Flop (didn't bet)
Seat 4: pudah (button) folded before Flop (didn't bet)
Seat 5: Permaban (small blind) folded on the Flop
Seat 6: ColdFish (big blind) collected (0.17)
Seat 7: oferoza folded before Flop (didn't bet)

CoinPoker Hand #293569589: Hold'em No Limit (0.01/0.02 ) 2025/09/07 20:43:22 GMT
Table 'NL ₮2 I' 7-max Seat #5 is the button
Seat 1: AJHPoker (1.96 in chips)
Seat 2: Holy1 (0.85 in chips)
Seat 3: kanococo (3.16 in chips)
Seat 4: pudah (0.76 in chips)
Seat 5: Permaban (2.65 in chips)
Seat 6: ColdFish (2.19 in chips)
Seat 7: oferoza (2.15 in chips)
ColdFish: posts small blind 0.01
oferoza: posts big blind 0.02
*** HOLE CARDS ***
Dealt to kanococo [6h 5d]
AJHPoker: folds
Holy1: folds
kanococo: folds
pudah: folds
Permaban: folds
ColdFish: raises 0.04 to 0.06
oferoza: folds
ColdFish collected 0.08 from pot
ColdFish: doesn't show hand
*** SUMMARY ***
Total pot 0.08 | Rake 0.00
Board [ ]
Game ended: 2025/09/07 20:43:52 GMT
Seat 1: AJHPoker folded before Flop (didn't bet)
Seat 2: Holy1 folded before Flop (didn't bet)
Seat 3: kanococo folded before Flop (didn't bet)
Seat 4: pudah folded before Flop (didn't bet)
Seat 5: Permaban (button) folded before Flop (didn't bet)
Seat 6: ColdFish (small blind) collected (0.08)
Seat 7: oferoza (big blind) folded before Flop

CoinPoker Hand #293569789: Hold'em No Limit (0.01/0.02 ) 2025/09/07 20:43:54 GMT
Table 'NL ₮2 I' 7-max Seat #6 is the button
Seat 1: AJHPoker (1.96 in chips)
Seat 2: Holy1 (0.85 in chips)
Seat 3: kanococo (3.16 in chips)
Seat 4: pudah (0.76 in chips)
Seat 5: Permaban (2.65 in chips)
Seat 6: ColdFish (2.21 in chips)
Seat 7: oferoza (2.13 in chips)
oferoza: posts small blind 0.01
AJHPoker: posts big blind 0.02
*** HOLE CARDS ***
Dealt to kanococo [5s Jh]
Holy1: folds
kanococo: folds
pudah: folds
Permaban: folds
ColdFish: raises 0.03 to 0.05
oferoza: folds
AJHPoker: folds
ColdFish collected 0.08 from pot
ColdFish: doesn't show hand
*** SUMMARY ***
Total pot 0.08 | Rake 0.00
Board [ ]
Game ended: 2025/09/07 20:44:26 GMT
Seat 1: AJHPoker (big blind) folded before Flop
Seat 2: Holy1 folded before Flop (didn't bet)
Seat 3: kanococo folded before Flop (didn't bet)
Seat 4: pudah folded before Flop (didn't bet)
Seat 5: Permaban folded before Flop (didn't bet)
Seat 6: ColdFish (button) collected (0.08)
Seat 7: oferoza (small blind) folded before Flop

CoinPoker Hand #293570022: Hold'em No Limit (0.01/0.02 ) 2025/09/07 20:44:28 GMT
Table 'NL ₮2 I' 7-max Seat #7 is the button
Seat 1: AJHPoker (1.94 in chips)
Seat 2: Holy1 (0.85 in chips)
Seat 3: kanococo (3.16 in chips)
Seat 4: pudah (0.76 in chips)
Seat 5: Permaban (2.65 in chips)
Seat 6: ColdFish (2.24 in chips)
Seat 7: oferoza (2.12 in chips)
AJHPoker: posts small blind 0.01
Holy1: posts big blind 0.02
*** HOLE CARDS ***
Dealt to kanococo [As Jd]
kanococo: raises 0.06 to 0.08
pudah: folds
Permaban: calls 0.08
ColdFish: calls 0.08
oferoza: folds
AJHPoker: calls 0.07
Holy1: folds
*** FLOP *** [7d 2s 9c]
AJHPoker: checks
kanococo: checks
Permaban: checks
ColdFish: checks
*** TURN *** [7d 2s 9c] [Jh]
AJHPoker: checks
kanococo: bets 0.20
Permaban: folds
ColdFish: calls 0.20
AJHPoker: calls 0.20
*** RIVER *** [7d 2s 9c Jh] [2d]
AJHPoker: checks
kanococo: bets 0.48
ColdFish: folds
AJHPoker: folds
Uncalled bet (0.48) returned to kanococo
kanococo collected 0.89 from pot
kanococo: doesn't show hand
*** SUMMARY ***
Total pot 0.94 | Rake 0.05
Board [ 7d 2s 9c Jh 2d ]
Game ended: 2025/09/07 20:45:42 GMT
Seat 1: AJHPoker (small blind) folded on the River
Seat 2: Holy1 (big blind) folded before Flop
Seat 3: kanococo collected (0.89)
Seat 4: pudah folded before Flop (didn't bet)
Seat 5: Permaban folded on the Turn
Seat 6: ColdFish folded on the River
Seat 7: oferoza (button) folded before Flop (didn't bet)

CoinPoker Hand #293570566: Hold'em No Limit (0.01/0.02 ) 2025/09/07 20:45:44 GMT
Table 'NL ₮2 I' 7-max Seat #1 is the button
Seat 1: AJHPoker (1.66 in chips)
Seat 2: Holy1 (0.83 in chips)
Seat 3: kanococo (3.77 in chips)
Seat 4: pudah (0.76 in chips)
Seat 5: Permaban (2.57 in chips)
Seat 6: ColdFish (2.00 in chips)
Seat 7: oferoza (2.12 in chips)
Holy1: posts small blind 0.01
kanococo: posts big blind 0.02
*** HOLE CARDS ***
Dealt to kanococo [3h 7s]
pudah: folds
Permaban: folds
ColdFish: raises 0.04 to 0.06
oferoza: folds
AJHPoker: folds
Holy1: folds
kanococo: calls 0.04
*** FLOP *** [9s 3s 8s]
kanococo: bets 0.06
ColdFish: folds
Uncalled bet (0.06) returned to kanococo
kanococo collected 0.12 from pot
kanococo: doesn't show hand
*** SUMMARY ***
Total pot 0.13 | Rake 0.01
Board [ 9s 3s 8s ]
Game ended: 2025/09/07 20:46:12 GMT
Seat 1: AJHPoker (button) folded before Flop (didn't bet)
Seat 2: Holy1 (small blind) folded before Flop
Seat 3: kanococo (big blind) collected (0.12)
Seat 4: pudah folded before Flop (didn't bet)
Seat 5: Permaban folded before Flop (didn't bet)
Seat 6: ColdFish folded on the Flop
Seat 7: oferoza folded before Flop (didn't bet)

CoinPoker Hand #293570775: Hold'em No Limit (0.01/0.02 ) 2025/09/07 20:46:14 GMT
Table 'NL ₮2 I' 7-max Seat #2 is the button
Seat 1: AJHPoker (1.66 in chips)
Seat 2: Holy1 (0.82 in chips)
Seat 3: kanococo (3.83 in chips)
Seat 4: pudah (0.76 in chips)
Seat 5: Permaban (2.57 in chips)
Seat 6: ColdFish (2.00 in chips)
Seat 7: oferoza (2.12 in chips)
kanococo: posts small blind 0.01
pudah: posts big blind 0.02
*** HOLE CARDS ***
Dealt to kanococo [6c 8c]
Permaban: folds
ColdFish: folds
oferoza: folds
AJHPoker: folds
Holy1: folds
kanococo: raises 0.06 to 0.08
pudah: folds
kanococo collected 0.10 from pot
kanococo: doesn't show hand
*** SUMMARY ***
Total pot 0.10 | Rake 0.00
Board [ ]
Game ended: 2025/09/07 20:46:31 GMT
Seat 1: AJHPoker folded before Flop (didn't bet)
Seat 2: Holy1 (button) folded before Flop (didn't bet)
Seat 3: kanococo (small blind) collected (0.10)
Seat 4: pudah (big blind) folded before Flop
Seat 5: Permaban folded before Flop (didn't bet)
Seat 6: ColdFish folded before Flop (didn't bet)
Seat 7: oferoza folded before Flop (didn't bet)

CoinPoker Hand #293570889: Hold'em No Limit (0.01/0.02 ) 2025/09/07 20:46:33 GMT
Table 'NL ₮2 I' 7-max Seat #3 is the button
Seat 1: AJHPoker (1.66 in chips)
Seat 2: Holy1 (0.82 in chips)
Seat 3: kanococo (3.85 in chips)
Seat 4: pudah (0.74 in chips)
Seat 5: Permaban (2.57 in chips)
Seat 6: ColdFish (2.00 in chips)
Seat 7: oferoza (2.12 in chips)
pudah: posts small blind 0.01
Permaban: posts big blind 0.02
*** HOLE CARDS ***
Dealt to kanococo [Jh 6h]
ColdFish: folds
oferoza: folds
AJHPoker: folds
Holy1: folds
kanococo: raises 0.06 to 0.08
pudah: folds
Permaban: folds
kanococo collected 0.11 from pot
kanococo: doesn't show hand
*** SUMMARY ***
Total pot 0.11 | Rake 0.00
Board [ ]
Game ended: 2025/09/07 20:46:54 GMT
Seat 1: AJHPoker folded before Flop (didn't bet)
Seat 2: Holy1 folded before Flop (didn't bet)
Seat 3: kanococo (button) collected (0.11)
Seat 4: pudah (small blind) folded before Flop
Seat 5: Permaban (big blind) folded before Flop
Seat 6: ColdFish folded before Flop (didn't bet)
Seat 7: oferoza folded before Flop (didn't bet)

CoinPoker Hand #293571038: Hold'em No Limit (0.01/0.02 ) 2025/09/07 20:46:56 GMT
Table 'NL ₮2 I' 7-max Seat #4 is the button
Seat 1: AJHPoker (1.66 in chips)
Seat 2: Holy1 (0.82 in chips)
Seat 3: kanococo (3.88 in chips)
Seat 4: pudah (0.73 in chips)
Seat 5: Permaban (2.55 in chips)
Seat 6: ColdFish (2.00 in chips)
Seat 7: oferoza (2.12 in chips)
Permaban: posts small blind 0.01
ColdFish: posts big blind 0.02
*** HOLE CARDS ***
Dealt to kanococo [Kc Ts]
oferoza: folds
AJHPoker: folds
Holy1: folds
kanococo: raises 0.06 to 0.08
pudah: folds
Permaban: folds
ColdFish: calls 0.06
*** FLOP *** [Tc Kd Th]
ColdFish: checks
kanococo: bets 0.10
ColdFish: folds
Uncalled bet (0.10) returned to kanococo
kanococo collected 0.16 from pot
kanococo: doesn't show hand
*** SUMMARY ***
Total pot 0.17 | Rake 0.01
Board [ Tc Kd Th ]
Game ended: 2025/09/07 20:47:33 GMT
Seat 1: AJHPoker folded before Flop (didn't bet)
Seat 2: Holy1 folded before Flop (didn't bet)
Seat 3: kanococo collected (0.16)
Seat 4: pudah (button) folded before Flop (didn't bet)
Seat 5: Permaban (small blind) folded before Flop
Seat 6: ColdFish (big blind) folded on the Flop
Seat 7: oferoza folded before Flop (didn't bet)

CoinPoker Hand #293571253: Hold'em No Limit (0.01/0.02 ) 2025/09/07 20:47:35 GMT
Table 'NL ₮2 I' 7-max Seat #5 is the button
Seat 1: AJHPoker (1.66 in chips)
Seat 2: Holy1 (0.82 in chips)
Seat 3: kanococo (3.96 in chips)
Seat 4: pudah (0.73 in chips)
Seat 5: Permaban (2.54 in chips)
Seat 6: ColdFish (2.00 in chips)
Seat 7: oferoza (2.12 in chips)
ColdFish: posts small blind 0.01
oferoza: posts big blind 0.02
*** HOLE CARDS ***
Dealt to kanococo [5c Ad]
AJHPoker: folds
Holy1: folds
kanococo: folds
pudah: folds
Permaban: raises 0.03 to 0.05
ColdFish: folds
oferoza: folds
Permaban collected 0.08 from pot
Permaban: doesn't show hand
*** SUMMARY ***
Total pot 0.08 | Rake 0.00
Board [ ]
Game ended: 2025/09/07 20:48:06 GMT
Seat 1: AJHPoker folded before Flop (didn't bet)
Seat 2: Holy1 folded before Flop (didn't bet)
Seat 3: kanococo folded before Flop (didn't bet)
Seat 4: pudah folded before Flop (didn't bet)
Seat 5: Permaban (button) collected (0.08)
Seat 6: ColdFish (small blind) folded before Flop
Seat 7: oferoza (big blind) folded before Flop

CoinPoker Hand #293571495: Hold'em No Limit (0.01/0.02 ) 2025/09/07 20:48:09 GMT
Table 'NL ₮2 I' 7-max Seat #6 is the button
Seat 1: AJHPoker (1.66 in chips)
Seat 2: Holy1 (0.82 in chips)
Seat 3: kanococo (3.96 in chips)
Seat 4: pudah (0.73 in chips)
Seat 5: Permaban (2.57 in chips)
Seat 6: ColdFish (1.99 in chips)
Seat 7: oferoza (2.10 in chips)
oferoza: posts small blind 0.01
AJHPoker: posts big blind 0.02
*** HOLE CARDS ***
Dealt to kanococo [7s Ac]
Holy1: folds
kanococo: folds
pudah: folds
Permaban: folds
ColdFish: folds
oferoza: folds
AJHPoker collected 0.03 from pot
AJHPoker: doesn't show hand
*** SUMMARY ***
Total pot 0.03 | Rake 0.00
Board [ ]
Game ended: 2025/09/07 20:48:29 GMT
Seat 1: AJHPoker (big blind) collected (0.03)
Seat 2: Holy1 folded before Flop (didn't bet)
Seat 3: kanococo folded before Flop (didn't bet)
Seat 4: pudah folded before Flop (didn't bet)
Seat 5: Permaban folded before Flop (didn't bet)
Seat 6: ColdFish (button) folded before Flop (didn't bet)
Seat 7: oferoza (small blind) folded before Flop

CoinPoker Hand #293571668: Hold'em No Limit (0.01/0.02 ) 2025/09/07 20:48:31 GMT
Table 'NL ₮2 I' 7-max Seat #7 is the button
Seat 1: AJHPoker (1.67 in chips)
Seat 2: Holy1 (0.82 in chips)
Seat 3: kanococo (3.96 in chips)
Seat 4: pudah (0.73 in chips)
Seat 5: Permaban (2.57 in chips)
Seat 6: ColdFish (2.00 in chips)
Seat 7: oferoza (2.09 in chips)
AJHPoker: posts small blind 0.01
Holy1: posts big blind 0.02
*** HOLE CARDS ***
Dealt to kanococo [Jh Qd]
kanococo: raises 0.06 to 0.08
pudah: folds
Permaban: folds
ColdFish: folds
oferoza: folds
AJHPoker: folds
Holy1: folds
kanococo collected 0.11 from pot
kanococo: doesn't show hand
*** SUMMARY ***
Total pot 0.11 | Rake 0.00
Board [ ]
Game ended: 2025/09/07 20:48:55 GMT
Seat 1: AJHPoker (small blind) folded before Flop
Seat 2: Holy1 (big blind) folded before Flop
Seat 3: kanococo collected (0.11)
Seat 4: pudah folded before Flop (didn't bet)
Seat 5: Permaban folded before Flop (didn't bet)
Seat 6: ColdFish folded before Flop (didn't bet)
Seat 7: oferoza (button) folded before Flop (didn't bet)

CoinPoker Hand #293571799: Hold'em No Limit (0.01/0.02 ) 2025/09/07 20:48:57 GMT
Table 'NL ₮2 I' 7-max Seat #1 is the button
Seat 1: AJHPoker (1.66 in chips)
Seat 2: Holy1 (0.80 in chips)
Seat 3: kanococo (3.99 in chips)
Seat 4: pudah (0.73 in chips)
Seat 5: Permaban (2.57 in chips)
Seat 6: ColdFish (2.00 in chips)
Seat 7: oferoza (2.09 in chips)
Holy1: posts small blind 0.01
kanococo: posts big blind 0.02
*** HOLE CARDS ***
Dealt to kanococo [9h 7c]
pudah: folds
Permaban: folds
ColdFish: folds
oferoza: raises 0.04 to 0.06
AJHPoker: folds
Holy1: folds
kanococo: calls 0.04
*** FLOP *** [Kh Ks Jh]
kanococo: checks
oferoza: checks
*** TURN *** [Kh Ks Jh] [Jd]
kanococo: checks
oferoza: checks
*** RIVER *** [Kh Ks Jh Jd] [8h]
kanococo: bets 0.06
oferoza: calls 0.06
*** SHOW DOWN ***
kanococo: shows [9h 7c] (two pairs, Kings and Jacks)
oferoza: shows [Qh Ad] (two pairs, Kings and Jacks)
oferoza collected 0.24 from pot
*** SUMMARY ***
Total pot 0.25 | Rake 0.01
Board [ Kh Ks Jh Jd 8h ]
Game ended: 2025/09/07 20:49:49 GMT
Seat 1: AJHPoker (button) folded before Flop (didn't bet)
Seat 2: Holy1 (small blind) folded before Flop
Seat 3: kanococo (big blind) showed [9h 7c]
Seat 4: pudah folded before Flop (didn't bet)
Seat 5: Permaban folded before Flop (didn't bet)
Seat 6: ColdFish folded before Flop (didn't bet)
Seat 7: oferoza showed [Qh Ad] and won (0.24) with two pairs, Kings and Jacks

CoinPoker Hand #293572081: Hold'em No Limit (0.01/0.02 ) 2025/09/07 20:49:51 GMT
Table 'NL ₮2 I' 7-max Seat #2 is the button
Seat 1: AJHPoker (2.00 in chips)
Seat 2: Holy1 (0.79 in chips)
Seat 3: kanococo (3.87 in chips)
Seat 4: pudah (0.73 in chips)
Seat 5: Permaban (2.57 in chips)
Seat 6: ColdFish (2.00 in chips)
Seat 7: oferoza (2.21 in chips)
kanococo: posts small blind 0.01
pudah: posts big blind 0.02
*** HOLE CARDS ***
Dealt to kanococo [Kh Qs]
Permaban: raises 0.03 to 0.05
ColdFish: folds
oferoza: folds
AJHPoker: folds
Holy1: folds
kanococo: calls 0.04
pudah: calls 0.03
*** FLOP *** [Kd 8d 5h]
kanococo: checks
pudah: bets 0.14
Permaban: calls 0.14
kanococo: calls 0.14
*** TURN *** [Kd 8d 5h] [5d]
kanococo: bets 0.30
pudah: folds
Permaban: calls 0.30
*** RIVER *** [Kd 8d 5h 5d] [4c]
kanococo: checks
Permaban has timed out
Permaban activated time-bank (60 seconds)
Permaban: bets 0.83
kanococo: folds
Uncalled bet (0.83) returned to Permaban
Permaban collected 1.11 from pot
Permaban: doesn't show hand
*** SUMMARY ***
Total pot 1.17 | Rake 0.06
Board [ Kd 8d 5h 5d 4c ]
Game ended: 2025/09/07 20:51:32 GMT
Seat 1: AJHPoker folded before Flop (didn't bet)
Seat 2: Holy1 (button) folded before Flop (didn't bet)
Seat 3: kanococo (small blind) folded on the River
Seat 4: pudah (big blind) folded on the Turn
Seat 5: Permaban collected (1.11)
Seat 6: ColdFish folded before Flop (didn't bet)
Seat 7: oferoza folded before Flop (didn't bet)

CoinPoker Hand #293572689: Hold'em No Limit (0.01/0.02 ) 2025/09/07 20:51:35 GMT
Table 'NL ₮2 I' 7-max Seat #3 is the button
Seat 1: AJHPoker (2.00 in chips)
Seat 2: Holy1 (0.79 in chips)
Seat 3: kanococo (3.38 in chips)
Seat 4: pudah (0.54 in chips)
Seat 5: Permaban (3.19 in chips)
Seat 6: SQuest (2.00 in chips) out of hand
Seat 7: oferoza (2.21 in chips)
pudah: posts small blind 0.01
Permaban: posts big blind 0.02
*** HOLE CARDS ***
Dealt to kanococo [Ac Kh]
oferoza: folds
AJHPoker: folds
Holy1: raises 0.02 to 0.04
kanococo has timed out
kanococo activated time-bank (49 seconds)
kanococo: raises 0.08 to 0.12
pudah: folds
Permaban: folds
Holy1: folds
kanococo collected 0.19 from pot
kanococo: doesn't show hand
*** SUMMARY ***
Total pot 0.19 | Rake 0.00
Board [ ]
Game ended: 2025/09/07 20:52:20 GMT
Seat 1: AJHPoker folded before Flop (didn't bet)
Seat 2: Holy1 folded before Flop
Seat 3: kanococo (button) collected (0.19)
Seat 4: pudah (small blind) folded before Flop
Seat 5: Permaban (big blind) folded before Flop
Seat 6: SQuest folded before Flop (didn't bet)
Seat 7: oferoza folded before Flop (didn't bet)

CoinPoker Hand #293573061: Hold'em No Limit (0.01/0.02 ) 2025/09/07 20:52:22 GMT
Table 'NL ₮2 I' 7-max Seat #4 is the button
Seat 2: Holy1 (0.75 in chips)
Seat 3: kanococo (3.45 in chips)
Seat 4: pudah (0.53 in chips)
Seat 5: Permaban (3.17 in chips)
Seat 6: SQuest (2.00 in chips)
Seat 7: oferoza (2.21 in chips)
Permaban: posts small blind 0.01
SQuest: posts big blind 0.02
*** HOLE CARDS ***
Dealt to kanococo [2d Qs]
oferoza: folds
Holy1: folds
kanococo: folds
pudah: folds
Permaban: raises 0.04 to 0.06
SQuest: raises 0.12 to 0.18
Permaban: calls 0.12
*** FLOP *** [6s 9d 2h]
Permaban: checks
SQuest: bets 0.17
Permaban: calls 0.17
*** TURN *** [6s 9d 2h] [3d]
Permaban: checks
SQuest: checks
*** RIVER *** [6s 9d 2h 3d] [5s]
Permaban has timed out
Permaban activated time-bank (53 seconds)
Permaban: bets 0.31
SQuest has timed out
SQuest activated time-bank (60 seconds)
SQuest: folds
Uncalled bet (0.31) returned to Permaban
Permaban collected 0.66 from pot
Permaban: doesn't show hand
*** SUMMARY ***
Total pot 0.70 | Rake 0.04
Board [ 6s 9d 2h 3d 5s ]
Game ended: 2025/09/07 20:54:30 GMT
Seat 2: Holy1 folded before Flop (didn't bet)
Seat 3: kanococo folded before Flop (didn't bet)
Seat 4: pudah (button) folded before Flop (didn't bet)
Seat 5: Permaban (small blind) collected (0.66)
Seat 6: SQuest (big blind) folded on the River
Seat 7: oferoza folded before Flop (didn't bet)

CoinPoker Hand #294948048: Hold'em No Limit (0.01/0.02 ) 2025/09/10 20:25:12 GMT
Table 'NL ₮2 IV' 7-max Seat #6 is the button
Seat 1: Petrov19 (3.28 in chips)
Seat 2: kanococo (2.00 in chips) out of hand
Seat 3: kleepeh (2.00 in chips)
Seat 4: cp17par (2.17 in chips)
Seat 5: MokiMoki (1.01 in chips)
Seat 6: crispzilla (2.17 in chips)
Seat 7: JT0 (2.00 in chips)
JT0: posts small blind 0.01
Petrov19: posts big blind 0.02
*** HOLE CARDS ***
kleepeh: folds
cp17par: folds
MokiMoki: folds
crispzilla: folds
JT0: folds
Petrov19 collected 0.03 from pot
Petrov19: doesn't show hand
*** SUMMARY ***
Total pot 0.03 | Rake 0.00
Board [ ]
Game ended: 2025/09/10 20:25:35 GMT
Seat 1: Petrov19 (big blind) collected (0.03)
Seat 2: kanococo folded before Flop (didn't bet)
Seat 3: kleepeh folded before Flop (didn't bet)
Seat 4: cp17par folded before Flop (didn't bet)
Seat 5: MokiMoki folded before Flop (didn't bet)
Seat 6: crispzilla (button) folded before Flop (didn't bet)
Seat 7: JT0 (small blind) folded before Flop

CoinPoker Hand #294948291: Hold'em No Limit (0.01/0.02 ) 2025/09/10 20:25:37 GMT
Table 'NL ₮2 IV' 7-max Seat #7 is the button
Seat 1: Petrov19 (3.29 in chips)
Seat 2: kanococo (2.00 in chips)
Seat 3: kleepeh (2.00 in chips)
Seat 4: cp17par (2.17 in chips)
Seat 5: MokiMoki (1.01 in chips)
Seat 6: crispzilla (2.17 in chips)
Seat 7: JT0 (2.00 in chips)
Petrov19: posts small blind 0.01
kanococo: posts big blind 0.02
*** HOLE CARDS ***
Dealt to kanococo [6d 3h]
kleepeh: folds
cp17par: folds
MokiMoki: folds
crispzilla: folds
JT0: folds
Petrov19: raises 0.02 to 0.04
kanococo: calls 0.02
*** FLOP *** [Qs Ts Ac]
Petrov19: bets 0.06
kanococo: folds
Uncalled bet (0.06) returned to Petrov19
Petrov19 collected 0.08 from pot
Petrov19: doesn't show hand
*** SUMMARY ***
Total pot 0.08 | Rake 0.00
Board [ Qs Ts Ac ]
Game ended: 2025/09/10 20:26:24 GMT
Seat 1: Petrov19 (small blind) collected (0.08)
Seat 2: kanococo (big blind) folded on the Flop
Seat 3: kleepeh folded before Flop (didn't bet)
Seat 4: cp17par folded before Flop (didn't bet)
Seat 5: MokiMoki folded before Flop (didn't bet)
Seat 6: crispzilla folded before Flop (didn't bet)
Seat 7: JT0 (button) folded before Flop (didn't bet)

CoinPoker Hand #294948871: Hold'em No Limit (0.01/0.02 ) 2025/09/10 20:26:26 GMT
Table 'NL ₮2 IV' 7-max Seat #1 is the button
Seat 1: Petrov19 (3.33 in chips)
Seat 2: kanococo (1.96 in chips)
Seat 3: kleepeh (2.00 in chips)
Seat 4: cp17par (2.17 in chips)
Seat 5: MokiMoki (1.01 in chips)
Seat 6: crispzilla (2.17 in chips)
Seat 7: JT0 (2.00 in chips)
kanococo: posts small blind 0.01
kleepeh: posts big blind 0.02
*** HOLE CARDS ***
Dealt to kanococo [4s 8c]
cp17par: folds
MokiMoki: folds
crispzilla: folds
JT0: folds
Petrov19: folds
kanococo: folds
kleepeh collected 0.03 from pot
kleepeh: doesn't show hand
*** SUMMARY ***
Total pot 0.03 | Rake 0.00
Board [ ]
Game ended: 2025/09/10 20:26:49 GMT
Seat 1: Petrov19 (button) folded before Flop (didn't bet)
Seat 2: kanococo (small blind) folded before Flop
Seat 3: kleepeh (big blind) collected (0.03)
Seat 4: cp17par folded before Flop (didn't bet)
Seat 5: MokiMoki folded before Flop (didn't bet)
Seat 6: crispzilla folded before Flop (didn't bet)
Seat 7: JT0 folded before Flop (didn't bet)

CoinPoker Hand #294949088: Hold'em No Limit (0.01/0.02 ) 2025/09/10 20:26:51 GMT
Table 'NL ₮2 IV' 7-max Seat #2 is the button
Seat 1: Petrov19 (3.33 in chips)
Seat 2: kanococo (1.95 in chips)
Seat 3: kleepeh (2.01 in chips)
Seat 4: cp17par (2.17 in chips)
Seat 5: MokiMoki (1.01 in chips)
Seat 6: crispzilla (2.17 in chips)
Seat 7: JT0 (2.00 in chips)
kleepeh: posts small blind 0.01
cp17par: didn't post big blind
MokiMoki: posts big blind 0.02
*** HOLE CARDS ***
Dealt to kanococo [3s 6d]
crispzilla: folds
JT0: folds
Petrov19: folds
kanococo: raises 0.04 to 0.06
kleepeh: folds
MokiMoki: calls 0.04
*** FLOP *** [Jc Jh 8d]
MokiMoki: checks
kanococo: bets 0.04
MokiMoki: calls 0.04
*** TURN *** [Jc Jh 8d] [3c]
MokiMoki: checks
kanococo: checks
*** RIVER *** [Jc Jh 8d 3c] [4d]
MokiMoki: checks
kanococo: checks
*** SHOW DOWN ***
MokiMoki: shows [Tc Ac] (a pair of Jacks)
kanococo: shows [3s 6d] (two pairs, Jacks and Threes)
kanococo collected 0.20 from pot
*** SUMMARY ***
Total pot 0.21 | Rake 0.01
Board [ Jc Jh 8d 3c 4d ]
Game ended: 2025/09/10 20:27:45 GMT
Seat 1: Petrov19 folded before Flop (didn't bet)
Seat 2: kanococo (button) showed [3s 6d] and won (0.20) with two pairs, Jacks and Threes
Seat 3: kleepeh (small blind) folded before Flop
Seat 4: cp17par folded before Flop (didn't bet)
Seat 5: MokiMoki (big blind) showed [Tc Ac]
Seat 6: crispzilla folded before Flop (didn't bet)
Seat 7: JT0 folded before Flop (didn't bet)

CoinPoker Hand #294949531: Hold'em No Limit (0.01/0.02 ) 2025/09/10 20:27:47 GMT
Table 'NL ₮2 IV' 7-max Seat #3 is the button
Seat 1: Petrov19 (3.33 in chips)
Seat 2: kanococo (2.05 in chips)
Seat 3: kleepeh (2.00 in chips)
Seat 5: MokiMoki (0.91 in chips)
Seat 6: crispzilla (2.17 in chips)
Seat 7: JT0 (2.00 in chips)
MokiMoki: posts small blind 0.01
crispzilla: posts big blind 0.02
*** HOLE CARDS ***
Dealt to kanococo [2c Qd]
JT0: folds
Petrov19: folds
kanococo: folds
kleepeh: folds
MokiMoki: raises 0.04 to 0.06
crispzilla: calls 0.04
*** FLOP *** [9h Kd 8s]
MokiMoki: bets 0.06
crispzilla: folds
Uncalled bet (0.06) returned to MokiMoki
MokiMoki collected 0.11 from pot
MokiMoki: doesn't show hand
*** SUMMARY ***
Total pot 0.12 | Rake 0.01
Board [ 9h Kd 8s ]
Game ended: 2025/09/10 20:28:17 GMT
Seat 1: Petrov19 folded before Flop (didn't bet)
Seat 2: kanococo folded before Flop (didn't bet)
Seat 3: kleepeh (button) folded before Flop (didn't bet)
Seat 5: MokiMoki (small blind) collected (0.11)
Seat 6: crispzilla (big blind) folded on the Flop
Seat 7: JT0 folded before Flop (didn't bet)

CoinPoker Hand #294949826: Hold'em No Limit (0.01/0.02 ) 2025/09/10 20:28:19 GMT
Table 'NL ₮2 IV' 7-max Seat #5 is the button
Seat 1: Petrov19 (3.33 in chips)
Seat 2: kanococo (2.05 in chips)
Seat 3: kleepeh (2.00 in chips)
Seat 5: MokiMoki (0.96 in chips)
Seat 6: crispzilla (2.11 in chips)
Seat 7: JT0 (2.00 in chips)
crispzilla: posts small blind 0.01
JT0: posts big blind 0.02
*** HOLE CARDS ***
Dealt to kanococo [Jc 8d]
Petrov19: folds
kanococo: folds
kleepeh: folds
MokiMoki: folds
crispzilla: folds
JT0 collected 0.03 from pot
JT0: doesn't show hand
*** SUMMARY ***
Total pot 0.03 | Rake 0.00
Board [ ]
Game ended: 2025/09/10 20:28:49 GMT
Seat 1: Petrov19 folded before Flop (didn't bet)
Seat 2: kanococo folded before Flop (didn't bet)
Seat 3: kleepeh folded before Flop (didn't bet)
Seat 5: MokiMoki (button) folded before Flop (didn't bet)
Seat 6: crispzilla (small blind) folded before Flop
Seat 7: JT0 (big blind) collected (0.03)

CoinPoker Hand #294950140: Hold'em No Limit (0.01/0.02 ) 2025/09/10 20:28:51 GMT
Table 'NL ₮2 IV' 7-max Seat #6 is the button
Seat 1: Petrov19 (3.33 in chips)
Seat 2: kanococo (2.05 in chips)
Seat 3: kleepeh (2.00 in chips)
Seat 5: MokiMoki (0.96 in chips)
Seat 6: crispzilla (2.10 in chips)
Seat 7: JT0 (2.01 in chips)
JT0: posts small blind 0.01
Petrov19: posts big blind 0.02
*** HOLE CARDS ***
Dealt to kanococo [8c As]
kanococo: folds
kleepeh: folds
MokiMoki: raises 0.04 to 0.06
crispzilla: folds
JT0: folds
Petrov19: folds
MokiMoki collected 0.09 from pot
MokiMoki: doesn't show hand
*** SUMMARY ***
Total pot 0.09 | Rake 0.00
Board [ ]
Game ended: 2025/09/10 20:29:26 GMT
Seat 1: Petrov19 (big blind) folded before Flop
Seat 2: kanococo folded before Flop (didn't bet)
Seat 3: kleepeh folded before Flop (didn't bet)
Seat 5: MokiMoki collected (0.09)
Seat 6: crispzilla (button) folded before Flop (didn't bet)
Seat 7: JT0 (small blind) folded before Flop

CoinPoker Hand #294950551: Hold'em No Limit (0.01/0.02 ) 2025/09/10 20:29:28 GMT
Table 'NL ₮2 IV' 7-max Seat #7 is the button
Seat 1: Petrov19 (3.31 in chips)
Seat 2: kanococo (2.05 in chips)
Seat 3: kleepeh (2.00 in chips)
Seat 5: MokiMoki (0.99 in chips)
Seat 6: crispzilla (2.10 in chips)
Seat 7: JT0 (2.00 in chips)
Petrov19: posts small blind 0.01
kanococo: posts big blind 0.02
*** HOLE CARDS ***
Dealt to kanococo [Ad Kc]
kleepeh: folds
MokiMoki: folds
crispzilla: raises 0.04 to 0.06
JT0: folds
Petrov19: calls 0.05
kanococo: calls 0.04
*** FLOP *** [5s 9h Ah]
Petrov19: checks
kanococo: bets 0.06
crispzilla: raises 0.14 to 0.20
Petrov19: folds
kanococo: calls 0.14
*** TURN *** [5s 9h Ah] [Kh]
kanococo: bets 0.27
crispzilla: calls 0.27
*** RIVER *** [5s 9h Ah Kh] [Ts]
kanococo: bets 1.06
crispzilla has timed out
crispzilla activated time-bank (60 seconds)
crispzilla: folds
Uncalled bet (1.06) returned to kanococo
kanococo collected 1.06 from pot
kanococo: doesn't show hand
*** SUMMARY ***
Total pot 1.12 | Rake 0.06
Board [ 5s 9h Ah Kh Ts ]
Game ended: 2025/09/10 20:30:52 GMT
Seat 1: Petrov19 (small blind) folded on the Flop
Seat 2: kanococo (big blind) collected (1.06)
Seat 3: kleepeh folded before Flop (didn't bet)
Seat 5: MokiMoki folded before Flop (didn't bet)
Seat 6: crispzilla folded on the River
Seat 7: JT0 (button) folded before Flop (didn't bet)

CoinPoker Hand #294951364: Hold'em No Limit (0.01/0.02 ) 2025/09/10 20:30:54 GMT
Table 'NL ₮2 IV' 7-max Seat #1 is the button
Seat 1: Petrov19 (3.25 in chips)
Seat 2: kanococo (2.58 in chips)
Seat 3: kleepeh (2.00 in chips)
Seat 4: Hyuk1026 (2.00 in chips)
Seat 5: MokiMoki (0.99 in chips)
Seat 6: crispzilla (2.00 in chips)
Seat 7: JT0 (2.00 in chips)
kanococo: posts small blind 0.01
kleepeh: posts big blind 0.02
Hyuk1026: posts big blind 0.02
*** HOLE CARDS ***
Dealt to kanococo [Th 8h]
kleepeh is disconnected
kleepeh has reconnected
Hyuk1026: checks
MokiMoki: folds
crispzilla: folds
JT0: folds
Petrov19: folds
kanococo: raises 0.04 to 0.06
kleepeh: folds
Hyuk1026: folds
kanococo collected 0.10 from pot
kanococo: doesn't show hand
*** SUMMARY ***
Total pot 0.10 | Rake 0.00
Board [ ]
Game ended: 2025/09/10 20:31:33 GMT
Seat 1: Petrov19 (button) folded before Flop (didn't bet)
Seat 2: kanococo (small blind) collected (0.10)
Seat 3: kleepeh (big blind) folded before Flop
Seat 4: Hyuk1026 folded before Flop
Seat 5: MokiMoki folded before Flop (didn't bet)
Seat 6: crispzilla folded before Flop (didn't bet)
Seat 7: JT0 folded before Flop (didn't bet)

CoinPoker Hand #294951640: Hold'em No Limit (0.01/0.02 ) 2025/09/10 20:31:35 GMT
Table 'NL ₮2 IV' 7-max Seat #2 is the button
Seat 1: Petrov19 (3.25 in chips)
Seat 2: kanococo (2.62 in chips)
Seat 3: kleepeh (1.98 in chips)
Seat 4: Hyuk1026 (1.98 in chips)
Seat 5: MokiMoki (0.99 in chips)
Seat 6: crispzilla (2.00 in chips)
Seat 7: JT0 (2.00 in chips)
kleepeh: posts small blind 0.01
Hyuk1026: posts big blind 0.02
*** HOLE CARDS ***
Dealt to kanococo [2d 4c]
MokiMoki: folds
crispzilla: folds
JT0: raises 0.03 to 0.05
Petrov19: folds
kanococo: folds
kleepeh: folds
Hyuk1026: folds
JT0 collected 0.08 from pot
JT0: doesn't show hand
*** SUMMARY ***
Total pot 0.08 | Rake 0.00
Board [ ]
Game ended: 2025/09/10 20:32:12 GMT
Seat 1: Petrov19 folded before Flop (didn't bet)
Seat 2: kanococo (button) folded before Flop (didn't bet)
Seat 3: kleepeh (small blind) folded before Flop
Seat 4: Hyuk1026 (big blind) folded before Flop
Seat 5: MokiMoki folded before Flop (didn't bet)
Seat 6: crispzilla folded before Flop (didn't bet)
Seat 7: JT0 collected (0.08)

CoinPoker Hand #294951957: Hold'em No Limit (0.01/0.02 ) 2025/09/10 20:32:14 GMT
Table 'NL ₮2 IV' 7-max Seat #3 is the button
Seat 1: Petrov19 (3.25 in chips)
Seat 2: kanococo (2.62 in chips)
Seat 3: kleepeh (2.00 in chips)
Seat 4: Hyuk1026 (1.96 in chips)
Seat 5: MokiMoki (0.99 in chips)
Seat 6: crispzilla (2.00 in chips)
Seat 7: JT0 (2.03 in chips)
Hyuk1026: posts small blind 0.01
MokiMoki: posts big blind 0.02
*** HOLE CARDS ***
Dealt to kanococo [Ts Qc]
crispzilla: raises 0.04 to 0.06
JT0: folds
Petrov19: folds
kanococo: folds
kleepeh: folds
Hyuk1026: folds
MokiMoki: calls 0.04
*** FLOP *** [7d 4h 4s]
MokiMoki: checks
crispzilla: bets 0.04
MokiMoki: calls 0.04
*** TURN *** [7d 4h 4s] [6d]
MokiMoki: checks
crispzilla: checks
*** RIVER *** [7d 4h 4s 6d] [Qh]
MokiMoki: bets 0.10
crispzilla: folds
Uncalled bet (0.10) returned to MokiMoki
MokiMoki collected 0.20 from pot
MokiMoki: doesn't show hand
*** SUMMARY ***
Total pot 0.21 | Rake 0.01
Board [ 7d 4h 4s 6d Qh ]
Game ended: 2025/09/10 20:33:11 GMT
Seat 1: Petrov19 folded before Flop (didn't bet)
Seat 2: kanococo folded before Flop (didn't bet)
Seat 3: kleepeh (button) folded before Flop (didn't bet)
Seat 4: Hyuk1026 (small blind) folded before Flop
Seat 5: MokiMoki (big blind) collected (0.20)
Seat 6: crispzilla folded on the River
Seat 7: JT0 folded before Flop (didn't bet)

CoinPoker Hand #294952586: Hold'em No Limit (0.01/0.02 ) 2025/09/10 20:33:13 GMT
Table 'NL ₮2 IV' 7-max Seat #4 is the button
Seat 1: Petrov19 (3.25 in chips)
Seat 2: kanococo (2.62 in chips)
Seat 3: kleepeh (2.00 in chips)
Seat 4: Hyuk1026 (1.95 in chips)
Seat 5: MokiMoki (1.09 in chips)
Seat 6: crispzilla (2.00 in chips)
Seat 7: JT0 (2.03 in chips)
MokiMoki: posts small blind 0.01
crispzilla: posts big blind 0.02
*** HOLE CARDS ***
Dealt to kanococo [Ah 3s]
JT0: folds
Petrov19: folds
kanococo: raises 0.04 to 0.06
kleepeh: folds
Hyuk1026: folds
MokiMoki: folds
crispzilla: folds
kanococo collected 0.09 from pot
kanococo: doesn't show hand
*** SUMMARY ***
Total pot 0.09 | Rake 0.00
Board [ ]
Game ended: 2025/09/10 20:33:38 GMT
Seat 1: Petrov19 folded before Flop (didn't bet)
Seat 2: kanococo collected (0.09)
Seat 3: kleepeh folded before Flop (didn't bet)
Seat 4: Hyuk1026 (button) folded before Flop (didn't bet)
Seat 5: MokiMoki (small blind) folded before Flop
Seat 6: crispzilla (big blind) folded before Flop
Seat 7: JT0 folded before Flop (didn't bet)

CoinPoker Hand #294952850: Hold'em No Limit (0.01/0.02 ) 2025/09/10 20:33:41 GMT
Table 'NL ₮2 IV' 7-max Seat #5 is the button
Seat 1: Petrov19 (3.25 in chips)
Seat 2: kanococo (2.65 in chips)
Seat 3: kleepeh (2.00 in chips)
Seat 4: Hyuk1026 (1.95 in chips)
Seat 5: MokiMoki (1.08 in chips)
Seat 6: crispzilla (2.00 in chips)
Seat 7: JT0 (2.03 in chips)
crispzilla: posts small blind 0.01
JT0: posts big blind 0.02
*** HOLE CARDS ***
Dealt to kanococo [9d 3h]
Petrov19: folds
kanococo: folds
kleepeh: folds
Hyuk1026: raises 0.04 to 0.06
MokiMoki: folds
crispzilla: raises 0.18 to 0.24
JT0: folds
Hyuk1026: raises 1.89 and is all-in
crispzilla: calls 1.71
*** FLOP *** [Jc Qc 8h]
*** TURN *** [Jc Qc 8h] [8s]
*** RIVER *** [Jc Qc 8h 8s] [6h]
*** SHOW DOWN ***
Hyuk1026: shows [Js Qd] (two pairs, Queens and Jacks)
crispzilla: shows [Ac Ah] (two pairs, Aces and Eights)
crispzilla collected 3.72 from pot
*** SUMMARY ***
Total pot 3.92 | Rake 0.20
Board [ Jc Qc 8h 8s 6h ]
Game ended: 2025/09/10 20:34:52 GMT
Seat 1: Petrov19 folded before Flop (didn't bet)
Seat 2: kanococo folded before Flop (didn't bet)
Seat 3: kleepeh folded before Flop (didn't bet)
Seat 4: Hyuk1026 showed [Js Qd]
Seat 5: MokiMoki (button) folded before Flop (didn't bet)
Seat 6: crispzilla (small blind) showed [Ac Ah] and won (3.72) with two pairs, Aces and Eights
Seat 7: JT0 (big blind) folded before Flop

CoinPoker Hand #294953538: Hold'em No Limit (0.01/0.02 ) 2025/09/10 20:34:58 GMT
Table 'NL ₮2 IV' 7-max Seat #6 is the button
Seat 1: Petrov19 (3.25 in chips)
Seat 2: kanococo (2.65 in chips)
Seat 3: kleepeh (2.00 in chips)
Seat 4: Hyuk1026 (2.00 in chips)
Seat 5: MokiMoki (1.08 in chips)
Seat 6: crispzilla (3.77 in chips)
Seat 7: JT0 (2.01 in chips)
JT0: posts small blind 0.01
Petrov19: posts big blind 0.02
*** HOLE CARDS ***
Dealt to kanococo [9c Kh]
kanococo said, "OMGGG"
kanococo: folds
kleepeh: folds
Hyuk1026: folds
MokiMoki: folds
crispzilla: folds
JT0: raises 0.04 to 0.06
Petrov19: calls 0.04
*** FLOP *** [4c 8h Js]
JT0: checks
Petrov19: checks
*** TURN *** [4c 8h Js] [Kd]
JT0: bets 0.04
Petrov19: raises 0.08 to 0.12
JT0: folds
Uncalled bet (0.08) returned to Petrov19
Petrov19 collected 0.19 from pot
Petrov19: doesn't show hand
*** SUMMARY ***
Total pot 0.20 | Rake 0.01
Board [ 4c 8h Js Kd ]
Game ended: 2025/09/10 20:36:08 GMT
Seat 1: Petrov19 (big blind) collected (0.19)
Seat 2: kanococo folded before Flop (didn't bet)
Seat 3: kleepeh folded before Flop (didn't bet)
Seat 4: Hyuk1026 folded before Flop (didn't bet)
Seat 5: MokiMoki folded before Flop (didn't bet)
Seat 6: crispzilla (button) folded before Flop (didn't bet)
Seat 7: JT0 (small blind) folded on the Turn

CoinPoker Hand #294954343: Hold'em No Limit (0.01/0.02 ) 2025/09/10 20:36:11 GMT
Table 'NL ₮2 IV' 7-max Seat #7 is the button
Seat 1: Petrov19 (3.34 in chips)
Seat 2: kanococo (2.65 in chips)
Seat 3: kleepeh (2.00 in chips)
Seat 4: Hyuk1026 (2.00 in chips)
Seat 5: MokiMoki (1.08 in chips)
Seat 6: crispzilla (3.77 in chips)
Seat 7: JT0 (2.00 in chips)
Petrov19: posts small blind 0.01
kanococo: posts big blind 0.02
*** HOLE CARDS ***
Dealt to kanococo [Ad 4h]
kleepeh: folds
Hyuk1026: folds
MokiMoki: folds
crispzilla: folds
JT0: raises 0.03 to 0.05
Petrov19: calls 0.04
kanococo: raises 0.07 to 0.12
JT0: folds
Petrov19: calls 0.07
*** FLOP *** [Ah Jh 4s]
Petrov19: checks
kanococo: bets 0.16
Petrov19: folds
Uncalled bet (0.16) returned to kanococo
kanococo collected 0.28 from pot
kanococo: doesn't show hand
*** SUMMARY ***
Total pot 0.29 | Rake 0.01
Board [ Ah Jh 4s ]
Game ended: 2025/09/10 20:36:53 GMT
Seat 1: Petrov19 (small blind) folded on the Flop
Seat 2: kanococo (big blind) collected (0.28)
Seat 3: kleepeh folded before Flop (didn't bet)
Seat 4: Hyuk1026 folded before Flop (didn't bet)
Seat 5: MokiMoki folded before Flop (didn't bet)
Seat 6: crispzilla folded before Flop (didn't bet)
Seat 7: JT0 (button) folded before Flop

CoinPoker Hand #294954800: Hold'em No Limit (0.01/0.02 ) 2025/09/10 20:36:55 GMT
Table 'NL ₮2 IV' 7-max Seat #1 is the button
Seat 1: Petrov19 (3.22 in chips)
Seat 2: kanococo (2.81 in chips)
Seat 3: kleepeh (2.00 in chips)
Seat 4: Hyuk1026 (2.00 in chips)
Seat 5: MokiMoki (1.08 in chips)
Seat 6: crispzilla (3.77 in chips)
Seat 7: JT0 (1.95 in chips)
kanococo: posts small blind 0.01
kleepeh: posts big blind 0.02
*** HOLE CARDS ***
Dealt to kanococo [2c Qh]
Hyuk1026: folds
MokiMoki: folds
crispzilla: folds
JT0: folds
Petrov19: folds
kanococo: raises 0.06 to 0.08
kleepeh: folds
kanococo collected 0.10 from pot
kanococo: doesn't show hand
*** SUMMARY ***
Total pot 0.10 | Rake 0.00
Board [ ]
Game ended: 2025/09/10 20:37:20 GMT
Seat 1: Petrov19 (button) folded before Flop (didn't bet)
Seat 2: kanococo (small blind) collected (0.10)
Seat 3: kleepeh (big blind) folded before Flop
Seat 4: Hyuk1026 folded before Flop (didn't bet)
Seat 5: MokiMoki folded before Flop (didn't bet)
Seat 6: crispzilla folded before Flop (didn't bet)
Seat 7: JT0 folded before Flop (didn't bet)

CoinPoker Hand #294955059: Hold'em No Limit (0.01/0.02 ) 2025/09/10 20:37:23 GMT
Table 'NL ₮2 IV' 7-max Seat #2 is the button
Seat 1: Petrov19 (3.22 in chips)
Seat 2: kanococo (2.83 in chips)
Seat 3: kleepeh (2.00 in chips)
Seat 4: Hyuk1026 (2.00 in chips)
Seat 5: MokiMoki (1.08 in chips)
Seat 6: crispzilla (3.77 in chips)
Seat 7: JT0 (2.00 in chips)
kleepeh: posts small blind 0.01
Hyuk1026: posts big blind 0.02
*** HOLE CARDS ***
Dealt to kanococo [4s Th]
MokiMoki: folds
crispzilla: folds
JT0: raises 0.03 to 0.05
Petrov19: folds
kanococo: folds
kleepeh: folds
Hyuk1026: folds
JT0 collected 0.08 from pot
JT0: doesn't show hand
*** SUMMARY ***
Total pot 0.08 | Rake 0.00
Board [ ]
Game ended: 2025/09/10 20:38:01 GMT
Seat 1: Petrov19 folded before Flop (didn't bet)
Seat 2: kanococo (button) folded before Flop (didn't bet)
Seat 3: kleepeh (small blind) folded before Flop
Seat 4: Hyuk1026 (big blind) folded before Flop
Seat 5: MokiMoki folded before Flop (didn't bet)
Seat 6: crispzilla folded before Flop (didn't bet)
Seat 7: JT0 collected (0.08)

CoinPoker Hand #294955443: Hold'em No Limit (0.01/0.02 ) 2025/09/10 20:38:03 GMT
Table 'NL ₮2 IV' 7-max Seat #3 is the button
Seat 1: Petrov19 (3.22 in chips)
Seat 2: kanococo (2.83 in chips)
Seat 3: kleepeh (2.00 in chips)
Seat 4: Hyuk1026 (1.98 in chips)
Seat 5: MokiMoki (1.08 in chips)
Seat 6: crispzilla (3.77 in chips)
Seat 7: JT0 (2.03 in chips)
Hyuk1026: posts small blind 0.01
MokiMoki: posts big blind 0.02
*** HOLE CARDS ***
Dealt to kanococo [9c Jh]
crispzilla: folds
JT0: folds
Petrov19: folds
kanococo: folds
kleepeh: folds
Hyuk1026: calls 0.01
MokiMoki has timed out
MokiMoki activated time-bank (60 seconds)
MokiMoki: checks
*** FLOP *** [4s 5h 5c]
Hyuk1026: bets 0.02
MokiMoki: calls 0.02
*** TURN *** [4s 5h 5c] [6h]
Hyuk1026: bets 0.04
MokiMoki: calls 0.04
*** RIVER *** [4s 5h 5c 6h] [Kc]
Hyuk1026: bets 0.10
MokiMoki: calls 0.10
*** SHOW DOWN ***
Hyuk1026: shows [Th 5s] (three of kind, Fives)
MokiMoki: mucks hand
Hyuk1026 collected 0.34 from pot
*** SUMMARY ***
Total pot 0.36 | Rake 0.02
Board [ 4s 5h 5c 6h Kc ]
Game ended: 2025/09/10 20:39:17 GMT
Seat 1: Petrov19 folded before Flop (didn't bet)
Seat 2: kanococo folded before Flop (didn't bet)
Seat 3: kleepeh (button) folded before Flop (didn't bet)
Seat 4: Hyuk1026 (small blind) showed [Th 5s] and won (0.34) with three of kind, Fives
Seat 5: MokiMoki (big blind) mucked
Seat 6: crispzilla folded before Flop (didn't bet)
Seat 7: JT0 folded before Flop (didn't bet)

CoinPoker Hand #294955979: Hold'em No Limit (0.01/0.02 ) 2025/09/10 20:39:20 GMT
Table 'NL ₮2 IV' 7-max Seat #4 is the button
Seat 1: Petrov19 (3.22 in chips)
Seat 2: kanococo (2.83 in chips)
Seat 3: kleepeh (2.00 in chips)
Seat 4: Hyuk1026 (2.14 in chips)
Seat 5: MokiMoki (0.90 in chips)
Seat 6: crispzilla (3.77 in chips)
Seat 7: JT0 (2.03 in chips)
MokiMoki: posts small blind 0.01
crispzilla: posts big blind 0.02
*** HOLE CARDS ***
Dealt to kanococo [Kd 8d]
JT0: folds
Petrov19: folds
kanococo: raises 0.06 to 0.08
kleepeh: folds
Hyuk1026: folds
MokiMoki: folds
crispzilla: raises 0.16 to 0.24
kanococo has timed out
kanococo activated time-bank (60 seconds)
kanococo: folds
crispzilla collected 0.33 from pot
crispzilla: doesn't show hand
*** SUMMARY ***
Total pot 0.33 | Rake 0.00
Board [ ]
Game ended: 2025/09/10 20:40:10 GMT
Seat 1: Petrov19 folded before Flop (didn't bet)
Seat 2: kanococo folded before Flop
Seat 3: kleepeh folded before Flop (didn't bet)
Seat 4: Hyuk1026 (button) folded before Flop (didn't bet)
Seat 5: MokiMoki (small blind) folded before Flop
Seat 6: crispzilla (big blind) collected (0.33)
Seat 7: JT0 folded before Flop (didn't bet)

CoinPoker Hand #294956733: Hold'em No Limit (0.01/0.02 ) 2025/09/10 20:40:12 GMT
Table 'NL ₮2 IV' 7-max Seat #5 is the button
Seat 1: Petrov19 (3.22 in chips)
Seat 2: kanococo (2.75 in chips)
Seat 3: kleepeh (2.00 in chips)
Seat 4: Hyuk1026 (2.14 in chips)
Seat 5: MokiMoki (0.89 in chips)
Seat 6: crispzilla (3.86 in chips)
Seat 7: JT0 (2.03 in chips)
crispzilla: posts small blind 0.01
JT0: posts big blind 0.02
*** HOLE CARDS ***
Dealt to kanococo [5s Qd]
Petrov19: folds
kanococo: folds
kleepeh: folds
Hyuk1026: calls 0.02
MokiMoki: folds
crispzilla: calls 0.01
JT0: checks
*** FLOP *** [9d 9c 9h]
crispzilla: bets 0.04
JT0: folds
Hyuk1026: calls 0.04
*** TURN *** [9d 9c 9h] [3h]
crispzilla: bets 0.10
Hyuk1026: folds
Uncalled bet (0.10) returned to crispzilla
crispzilla collected 0.13 from pot
crispzilla: doesn't show hand
*** SUMMARY ***
Total pot 0.14 | Rake 0.01
Board [ 9d 9c 9h 3h ]
Game ended: 2025/09/10 20:41:04 GMT
Seat 1: Petrov19 folded before Flop (didn't bet)
Seat 2: kanococo folded before Flop (didn't bet)
Seat 3: kleepeh folded before Flop (didn't bet)
Seat 4: Hyuk1026 folded on the Turn
Seat 5: MokiMoki (button) folded before Flop (didn't bet)
Seat 6: crispzilla (small blind) collected (0.13)
Seat 7: JT0 (big blind) folded on the Flop

CoinPoker Hand #294957255: Hold'em No Limit (0.01/0.02 ) 2025/09/10 20:41:07 GMT
Table 'NL ₮2 IV' 7-max Seat #6 is the button
Seat 1: Petrov19 (3.22 in chips)
Seat 2: kanococo (2.75 in chips)
Seat 3: kleepeh (2.00 in chips)
Seat 4: Hyuk1026 (2.08 in chips)
Seat 5: MokiMoki (0.89 in chips)
Seat 6: crispzilla (3.93 in chips)
Seat 7: JT0 (2.01 in chips)
JT0: posts small blind 0.01
Petrov19: posts big blind 0.02
*** HOLE CARDS ***
Dealt to kanococo [5c Kc]
kanococo: folds
kleepeh: folds
Hyuk1026: folds
MokiMoki: folds
crispzilla: raises 0.04 to 0.06
JT0: folds
Petrov19: folds
crispzilla collected 0.09 from pot
crispzilla: doesn't show hand
*** SUMMARY ***
Total pot 0.09 | Rake 0.00
Board [ ]
Game ended: 2025/09/10 20:41:36 GMT
Seat 1: Petrov19 (big blind) folded before Flop
Seat 2: kanococo folded before Flop (didn't bet)
Seat 3: kleepeh folded before Flop (didn't bet)
Seat 4: Hyuk1026 folded before Flop (didn't bet)
Seat 5: MokiMoki folded before Flop (didn't bet)
Seat 6: crispzilla (button) collected (0.09)
Seat 7: JT0 (small blind) folded before Flop

CoinPoker Hand #294957510: Hold'em No Limit (0.01/0.02 ) 2025/09/10 20:41:38 GMT
Table 'NL ₮2 IV' 7-max Seat #7 is the button
Seat 1: Petrov19 (3.20 in chips)
Seat 2: kanococo (2.75 in chips)
Seat 3: kleepeh (2.00 in chips)
Seat 4: Hyuk1026 (2.08 in chips)
Seat 5: MokiMoki (0.89 in chips)
Seat 6: crispzilla (3.96 in chips)
Seat 7: JT0 (2.00 in chips)
Petrov19: posts small blind 0.01
kanococo: posts big blind 0.02
*** HOLE CARDS ***
Dealt to kanococo [9c Kc]
kleepeh: folds
Hyuk1026: calls 0.02
MokiMoki: folds
crispzilla has timed out
crispzilla activated time-bank (59 seconds)
crispzilla: raises 0.06 to 0.08
JT0: folds
Petrov19: calls 0.07
kanococo: calls 0.06
Hyuk1026: folds
*** FLOP *** [8h 2s 4h]
Petrov19: checks
kanococo: checks
crispzilla: checks
*** TURN *** [8h 2s 4h] [4d]
Petrov19: bets 0.08
kanococo has timed out
kanococo activated time-bank (55 seconds)
kanococo: folds
crispzilla: folds
Uncalled bet (0.08) returned to Petrov19
Petrov19 collected 0.25 from pot
Petrov19: doesn't show hand
*** SUMMARY ***
Total pot 0.26 | Rake 0.01
Board [ 8h 2s 4h 4d ]
Game ended: 2025/09/10 20:43:02 GMT
Seat 1: Petrov19 (small blind) collected (0.25)
Seat 2: kanococo (big blind) folded on the Turn
Seat 3: kleepeh folded before Flop (didn't bet)
Seat 4: Hyuk1026 folded before Flop
Seat 5: MokiMoki folded before Flop (didn't bet)
Seat 6: crispzilla folded on the Turn
Seat 7: JT0 (button) folded before Flop (didn't bet)

CoinPoker Hand #294958413: Hold'em No Limit (0.01/0.02 ) 2025/09/10 20:43:05 GMT
Table 'NL ₮2 IV' 7-max Seat #1 is the button
Seat 1: Petrov19 (3.37 in chips)
Seat 2: kanococo (2.67 in chips)
Seat 3: kleepeh (2.00 in chips)
Seat 4: Hyuk1026 (2.06 in chips)
Seat 5: MokiMoki (0.89 in chips)
Seat 6: crispzilla (3.88 in chips)
Seat 7: JT0 (2.00 in chips)
kanococo: posts small blind 0.01
kleepeh: posts big blind 0.02
*** HOLE CARDS ***
Dealt to kanococo [8c Th]
Hyuk1026: raises 0.02 to 0.04
MokiMoki: calls 0.04
crispzilla: raises 0.08 to 0.12
JT0: folds
Petrov19: folds
kanococo: folds
kleepeh: folds
MokiMoki is disconnected
MokiMoki has reconnected
Hyuk1026: raises 0.12 to 0.24
MokiMoki has timed out
MokiMoki activated time-bank (51 seconds)
MokiMoki: folds
crispzilla: calls 0.12
*** FLOP *** [4c 6c Ts]
Hyuk1026: checks
crispzilla: checks
*** TURN *** [4c 6c Ts] [8h]
Hyuk1026: checks
crispzilla: checks
*** RIVER *** [4c 6c Ts 8h] [5s]
Hyuk1026: checks
crispzilla: checks
*** SHOW DOWN ***
Hyuk1026: shows [Jc Ks] (King high)
crispzilla: shows [Qc As] (Ace high)
crispzilla collected 0.52 from pot
*** SUMMARY ***
Total pot 0.55 | Rake 0.03
Board [ 4c 6c Ts 8h 5s ]
Game ended: 2025/09/10 20:44:14 GMT
Seat 1: Petrov19 (button) folded before Flop (didn't bet)
Seat 2: kanococo (small blind) folded before Flop
Seat 3: kleepeh (big blind) folded before Flop
Seat 4: Hyuk1026 showed [Jc Ks]
Seat 5: MokiMoki folded before Flop
Seat 6: crispzilla showed [Qc As] and won (0.52) with Ace high
Seat 7: JT0 folded before Flop (didn't bet)

CoinPoker Hand #294959178: Hold'em No Limit (0.01/0.02 ) 2025/09/10 20:44:17 GMT
Table 'NL ₮2 IV' 7-max Seat #2 is the button
Seat 1: Petrov19 (3.37 in chips)
Seat 2: kanococo (2.66 in chips)
Seat 3: kleepeh (1.98 in chips)
Seat 4: Hyuk1026 (1.82 in chips)
Seat 5: MokiMoki (0.85 in chips)
Seat 6: crispzilla (4.16 in chips)
Seat 7: JT0 (2.00 in chips)
kleepeh: posts small blind 0.01
Hyuk1026: posts big blind 0.02
*** HOLE CARDS ***
Dealt to kanococo [3h 3d]
MokiMoki: folds
crispzilla: folds
JT0: folds
Petrov19: folds
kanococo: raises 0.06 to 0.08
kleepeh: folds
Hyuk1026: folds
kanococo collected 0.11 from pot
kanococo: doesn't show hand
*** SUMMARY ***
Total pot 0.11 | Rake 0.00
Board [ ]
Game ended: 2025/09/10 20:44:45 GMT
Seat 1: Petrov19 folded before Flop (didn't bet)
Seat 2: kanococo (button) collected (0.11)
Seat 3: kleepeh (small blind) folded before Flop
Seat 4: Hyuk1026 (big blind) folded before Flop
Seat 5: MokiMoki folded before Flop (didn't bet)
Seat 6: crispzilla folded before Flop (didn't bet)
Seat 7: JT0 folded before Flop (didn't bet)

CoinPoker Hand #294959487: Hold'em No Limit (0.01/0.02 ) 2025/09/10 20:44:47 GMT
Table 'NL ₮2 IV' 7-max Seat #3 is the button
Seat 1: Petrov19 (3.37 in chips)
Seat 2: kanococo (2.69 in chips)
Seat 3: kleepeh (2.00 in chips)
Seat 4: Hyuk1026 (1.80 in chips)
Seat 5: MokiMoki (0.85 in chips)
Seat 6: crispzilla (4.16 in chips)
Seat 7: JT0 (2.00 in chips)
Hyuk1026: posts small blind 0.01
MokiMoki: posts big blind 0.02
*** HOLE CARDS ***
Dealt to kanococo [3h 9h]
crispzilla: folds
JT0: folds
Petrov19: folds
kanococo: folds
kleepeh: folds
Hyuk1026: folds
MokiMoki collected 0.03 from pot
MokiMoki: doesn't show hand
*** SUMMARY ***
Total pot 0.03 | Rake 0.00
Board [ ]
Game ended: 2025/09/10 20:45:08 GMT
Seat 1: Petrov19 folded before Flop (didn't bet)
Seat 2: kanococo folded before Flop (didn't bet)
Seat 3: kleepeh (button) folded before Flop (didn't bet)
Seat 4: Hyuk1026 (small blind) folded before Flop
Seat 5: MokiMoki (big blind) collected (0.03)
Seat 6: crispzilla folded before Flop (didn't bet)
Seat 7: JT0 folded before Flop (didn't bet)

CoinPoker Hand #294959845: Hold'em No Limit (0.01/0.02 ) 2025/09/10 20:45:11 GMT
Table 'NL ₮2 IV' 7-max Seat #4 is the button
Seat 1: Petrov19 (3.37 in chips)
Seat 2: kanococo (2.69 in chips)
Seat 3: kleepeh (2.00 in chips)
Seat 4: Hyuk1026 (1.79 in chips)
Seat 5: MokiMoki (0.86 in chips)
Seat 6: crispzilla (4.16 in chips)
Seat 7: JT0 (2.00 in chips)
MokiMoki: posts small blind 0.01
crispzilla: posts big blind 0.02
*** HOLE CARDS ***
Dealt to kanococo [8d Js]
JT0: raises 0.03 to 0.05
Petrov19: calls 0.05
kanococo: folds
kleepeh: folds
Hyuk1026: folds
MokiMoki has timed out
MokiMoki activated time-bank (47 seconds)
MokiMoki: folds
crispzilla: calls 0.03
*** FLOP *** [9h Jd 3d]
crispzilla: checks
JT0: checks
Petrov19: bets 0.07
crispzilla has timed out
crispzilla activated time-bank (60 seconds)
crispzilla: folds
JT0: folds
Uncalled bet (0.07) returned to Petrov19
Petrov19 collected 0.15 from pot
Petrov19: doesn't show hand
*** SUMMARY ***
Total pot 0.16 | Rake 0.01
Board [ 9h Jd 3d ]
Game ended: 2025/09/10 20:46:35 GMT
Seat 1: Petrov19 collected (0.15)
Seat 2: kanococo folded before Flop (didn't bet)
Seat 3: kleepeh folded before Flop (didn't bet)
Seat 4: Hyuk1026 (button) folded before Flop (didn't bet)
Seat 5: MokiMoki (small blind) folded before Flop
Seat 6: crispzilla (big blind) folded on the Flop
Seat 7: JT0 folded on the Flop

CoinPoker Hand #294960621: Hold'em No Limit (0.01/0.02 ) 2025/09/10 20:46:37 GMT
Table 'NL ₮2 IV' 7-max Seat #5 is the button
Seat 1: Petrov19 (3.47 in chips)
Seat 2: kanococo (2.69 in chips)
Seat 3: kleepeh (2.00 in chips)
Seat 4: Hyuk1026 (1.79 in chips)
Seat 5: MokiMoki (0.85 in chips)
Seat 6: crispzilla (4.11 in chips)
Seat 7: JT0 (2.00 in chips)
crispzilla: posts small blind 0.01
JT0: posts big blind 0.02
*** HOLE CARDS ***
Dealt to kanococo [9s 9c]
Petrov19: folds
kanococo: raises 0.04 to 0.06
kleepeh: folds
Hyuk1026: raises 0.06 to 0.12
MokiMoki: folds
crispzilla: folds
JT0: folds
kanococo: calls 0.06
*** FLOP *** [5d Kd Kc]
Hyuk1026 is disconnected
kanococo: bets 0.14
Hyuk1026 has reconnected
Hyuk1026: raises 0.14 to 0.28
kanococo: calls 0.14
*** TURN *** [5d Kd Kc] [6s]
kanococo: checks
Hyuk1026: bets 0.39
kanococo: folds
Uncalled bet (0.39) returned to Hyuk1026
Hyuk1026 collected 0.79 from pot
Hyuk1026: doesn't show hand
*** SUMMARY ***
Total pot 0.83 | Rake 0.04
Board [ 5d Kd Kc 6s ]
Game ended: 2025/09/10 20:47:52 GMT
Seat 1: Petrov19 folded before Flop (didn't bet)
Seat 2: kanococo folded on the Turn
Seat 3: kleepeh folded before Flop (didn't bet)
Seat 4: Hyuk1026 collected (0.79)
Seat 5: MokiMoki (button) folded before Flop (didn't bet)
Seat 6: crispzilla (small blind) folded before Flop
Seat 7: JT0 (big blind) folded before Flop

CoinPoker Hand #294961206: Hold'em No Limit (0.01/0.02 ) 2025/09/10 20:47:54 GMT
Table 'NL ₮2 IV' 7-max Seat #6 is the button
Seat 1: Petrov19 (3.47 in chips)
Seat 2: kanococo (2.29 in chips)
Seat 3: kleepeh (2.00 in chips)
Seat 4: Hyuk1026 (2.18 in chips)
Seat 5: MokiMoki (0.85 in chips)
Seat 6: crispzilla (4.10 in chips)
Seat 7: JT0 (1.98 in chips)
JT0: posts small blind 0.01
Petrov19: posts big blind 0.02
*** HOLE CARDS ***
Dealt to kanococo [Ac Qh]
kanococo: raises 0.06 to 0.08
kleepeh: folds
Hyuk1026: folds
MokiMoki: folds
crispzilla: folds
JT0: folds
Petrov19: raises 0.12 to 0.20
kanococo: calls 0.12
*** FLOP *** [7h 7s Jc]
Petrov19: bets 0.16
kanococo: raises 0.16 to 0.32
Petrov19: calls 0.16
*** TURN *** [7h 7s Jc] [Kc]
Petrov19: checks
kanococo: checks
*** RIVER *** [7h 7s Jc Kc] [Qc]
Petrov19: checks
kanococo: bets 0.62
Petrov19: calls 0.62
*** SHOW DOWN ***
kanococo: shows [Ac Qh] (two pairs, Queens and Sevens)
Petrov19: mucks hand
kanococo collected 2.18 from pot
*** SUMMARY ***
Total pot 2.29 | Rake 0.11
Board [ 7h 7s Jc Kc Qc ]
Game ended: 2025/09/10 20:49:04 GMT
Seat 1: Petrov19 (big blind) mucked
Seat 2: kanococo showed [Ac Qh] and won (2.18) with two pairs, Queens and Sevens
Seat 3: kleepeh folded before Flop (didn't bet)
Seat 4: Hyuk1026 folded before Flop (didn't bet)
Seat 5: MokiMoki folded before Flop (didn't bet)
Seat 6: crispzilla (button) folded before Flop (didn't bet)
Seat 7: JT0 (small blind) folded before Flop

CoinPoker Hand #294962014: Hold'em No Limit (0.01/0.02 ) 2025/09/10 20:49:06 GMT
Table 'NL ₮2 IV' 7-max Seat #7 is the button
Seat 1: Petrov19 (2.33 in chips)
Seat 2: kanococo (3.33 in chips)
Seat 3: kleepeh (2.00 in chips)
Seat 4: Hyuk1026 (2.18 in chips)
Seat 5: MokiMoki (0.85 in chips)
Seat 6: crispzilla (4.10 in chips)
Seat 7: JT0 (1.99 in chips)
Petrov19: posts small blind 0.01
kanococo: posts big blind 0.02
*** HOLE CARDS ***
Dealt to kanococo [9s 7c]
kleepeh has timed out
kleepeh activated time-bank (60 seconds)
kleepeh: folds
Hyuk1026: calls 0.02
MokiMoki: folds
crispzilla: raises 0.06 to 0.08
JT0: folds
Petrov19: folds
kanococo: folds
JT0 is disconnected
JT0 has reconnected
Hyuk1026: calls 0.06
*** FLOP *** [Jc Ts Kd]
Hyuk1026: checks
crispzilla: bets 0.16
Hyuk1026: folds
Uncalled bet (0.16) returned to crispzilla
crispzilla collected 0.18 from pot
crispzilla: doesn't show hand
*** SUMMARY ***
Total pot 0.19 | Rake 0.01
Board [ Jc Ts Kd ]
Game ended: 2025/09/10 20:50:15 GMT
Seat 1: Petrov19 (small blind) folded before Flop
Seat 2: kanococo (big blind) folded before Flop
Seat 3: kleepeh folded before Flop (didn't bet)
Seat 4: Hyuk1026 folded on the Flop
Seat 5: MokiMoki folded before Flop (didn't bet)
Seat 6: crispzilla collected (0.18)
Seat 7: JT0 (button) folded before Flop (didn't bet)

CoinPoker Hand #294962604: Hold'em No Limit (0.01/0.02 ) 2025/09/10 20:50:17 GMT
Table 'NL ₮2 IV' 7-max Seat #1 is the button
Seat 1: Petrov19 (2.32 in chips)
Seat 2: kanococo (3.31 in chips)
Seat 3: kleepeh (2.00 in chips)
Seat 4: Hyuk1026 (2.10 in chips)
Seat 5: MokiMoki (0.85 in chips)
Seat 6: crispzilla (4.20 in chips)
Seat 7: JT0 (2.00 in chips)
kanococo: posts small blind 0.01
kleepeh: posts big blind 0.02
*** HOLE CARDS ***
Dealt to kanococo [Ad Ah]
Hyuk1026: folds
MokiMoki: folds
crispzilla: folds
JT0: folds
Petrov19: raises 0.04 to 0.06
kanococo: raises 0.06 to 0.12
kleepeh: folds
Petrov19: calls 0.06
*** FLOP *** [4h 5c 5h]
kanococo: bets 0.16
Petrov19: folds
Uncalled bet (0.16) returned to kanococo
kanococo collected 0.25 from pot
kanococo: doesn't show hand
*** SUMMARY ***
Total pot 0.26 | Rake 0.01
Board [ 4h 5c 5h ]
Game ended: 2025/09/10 20:50:58 GMT
Seat 1: Petrov19 (button) folded on the Flop
Seat 2: kanococo (small blind) collected (0.25)
Seat 3: kleepeh (big blind) folded before Flop
Seat 4: Hyuk1026 folded before Flop (didn't bet)
Seat 5: MokiMoki folded before Flop (didn't bet)
Seat 6: crispzilla folded before Flop (didn't bet)
Seat 7: JT0 folded before Flop (didn't bet)

CoinPoker Hand #294962872: Hold'em No Limit (0.01/0.02 ) 2025/09/10 20:51:01 GMT
Table 'NL ₮2 IV' 7-max Seat #2 is the button
Seat 1: Petrov19 (2.20 in chips)
Seat 2: kanococo (3.44 in chips)
Seat 3: kleepeh (1.98 in chips)
Seat 4: Hyuk1026 (2.10 in chips)
Seat 5: MokiMoki (0.85 in chips)
Seat 6: crispzilla (4.20 in chips)
Seat 7: JT0 (2.00 in chips)
kleepeh: posts small blind 0.01
Hyuk1026: posts big blind 0.02
*** HOLE CARDS ***
Dealt to kanococo [9h Qh]
MokiMoki: folds
crispzilla: folds
JT0: folds
Petrov19: folds
kanococo: raises 0.06 to 0.08
kleepeh: folds
Hyuk1026: raises 0.08 to 0.16
kanococo: calls 0.08
*** FLOP *** [3h Kh 2d]
Hyuk1026: checks
kanococo: bets 0.18
Hyuk1026: calls 0.18
*** TURN *** [3h Kh 2d] [Ad]
Hyuk1026: checks
kanococo: checks
*** RIVER *** [3h Kh 2d Ad] [As]
Hyuk1026: checks
kanococo: checks
*** SHOW DOWN ***
Hyuk1026: shows [Jd Ac] (three of kind, Aces)
kanococo: mucks hand
Hyuk1026 collected 0.66 from pot
*** SUMMARY ***
Total pot 0.69 | Rake 0.03
Board [ 3h Kh 2d Ad As ]
Game ended: 2025/09/10 20:52:00 GMT
Seat 1: Petrov19 folded before Flop (didn't bet)
Seat 2: kanococo (button) mucked
Seat 3: kleepeh (small blind) folded before Flop
Seat 4: Hyuk1026 (big blind) showed [Jd Ac] and won (0.66) with three of kind, Aces
Seat 5: MokiMoki folded before Flop (didn't bet)
Seat 6: crispzilla folded before Flop (didn't bet)
Seat 7: JT0 folded before Flop (didn't bet)

CoinPoker Hand #294963491: Hold'em No Limit (0.01/0.02 ) 2025/09/10 20:52:02 GMT
Table 'NL ₮2 IV' 7-max Seat #3 is the button
Seat 1: Petrov19 (2.20 in chips)
Seat 2: kanococo (3.10 in chips)
Seat 3: kleepeh (1.99 in chips)
Seat 4: Hyuk1026 (2.42 in chips)
Seat 5: MokiMoki (0.85 in chips)
Seat 6: crispzilla (4.20 in chips)
Seat 7: JT0 (2.00 in chips)
Hyuk1026: posts small blind 0.01
MokiMoki: posts big blind 0.02
*** HOLE CARDS ***
Dealt to kanococo [9s Qs]
crispzilla: folds
JT0: folds
Petrov19: raises 0.02 to 0.04
kanococo: calls 0.04
kleepeh: folds
Hyuk1026: folds
MokiMoki: folds
*** FLOP *** [Jc Ac Ts]
Petrov19: bets 0.06
kanococo: calls 0.06
*** TURN *** [Jc Ac Ts] [8d]
Petrov19: checks
kanococo: bets 0.14
Petrov19: calls 0.14
*** RIVER *** [Jc Ac Ts 8d] [4h]
Petrov19: checks
kanococo: bets 0.48
Petrov19: calls 0.48
*** SHOW DOWN ***
kanococo: shows [9s Qs] (a straight, Queen high)
Petrov19: mucks hand
kanococo collected 1.40 from pot
*** SUMMARY ***
Total pot 1.47 | Rake 0.07
Board [ Jc Ac Ts 8d 4h ]
Game ended: 2025/09/10 20:53:10 GMT
Seat 1: Petrov19 mucked
Seat 2: kanococo showed [9s Qs] and won (1.40) with a straight, Queen high
Seat 3: kleepeh (button) folded before Flop (didn't bet)
Seat 4: Hyuk1026 (small blind) folded before Flop
Seat 5: MokiMoki (big blind) folded before Flop
Seat 6: crispzilla folded before Flop (didn't bet)
Seat 7: JT0 folded before Flop (didn't bet)

CoinPoker Hand #294964195: Hold'em No Limit (0.01/0.02 ) 2025/09/10 20:53:12 GMT
Table 'NL ₮2 IV' 7-max Seat #4 is the button
Seat 1: Petrov19 (2.00 in chips)
Seat 2: kanococo (3.78 in chips)
Seat 3: kleepeh (2.00 in chips)
Seat 4: Hyuk1026 (2.41 in chips)
Seat 6: crispzilla (4.20 in chips)
Seat 7: JT0 (2.00 in chips)
crispzilla: posts small blind 0.01
JT0: posts big blind 0.02
*** HOLE CARDS ***
Dealt to kanococo [Ad Kh]
Petrov19: raises 0.02 to 0.04
kanococo: raises 0.08 to 0.12
kleepeh: folds
Hyuk1026: folds
crispzilla: folds
JT0: folds
Petrov19: calls 0.08
*** FLOP *** [9c 8d Ks]
Petrov19: checks
kanococo: checks
*** TURN *** [9c 8d Ks] [Js]
Petrov19: checks
kanococo: bets 0.13
Hyuk1026 is disconnected
Petrov19: folds
Uncalled bet (0.13) returned to kanococo
kanococo collected 0.26 from pot
kanococo: doesn't show hand
*** SUMMARY ***
Total pot 0.27 | Rake 0.01
Board [ 9c 8d Ks Js ]
Game ended: 2025/09/10 20:53:46 GMT
Seat 1: Petrov19 folded on the Turn
Seat 2: kanococo collected (0.26)
Seat 3: kleepeh folded before Flop (didn't bet)
Seat 4: Hyuk1026 (button) folded before Flop (didn't bet)
Seat 6: crispzilla (small blind) folded before Flop
Seat 7: JT0 (big blind) folded before Flop

CoinPoker Hand #294964465: Hold'em No Limit (0.01/0.02 ) 2025/09/10 20:53:57 GMT
Table 'NL ₮2 IV' 7-max Seat #6 is the button
Seat 1: Petrov19 (2.00 in chips)
Seat 2: kanococo (3.92 in chips)
Seat 3: kleepeh (2.00 in chips)
Seat 4: Hyuk1026 (2.41 in chips) is sitting out
Seat 6: crispzilla (4.19 in chips)
Petrov19: posts big blind 0.02
*** HOLE CARDS ***
Dealt to kanococo [Tc 3d]
Hyuk1026 has reconnected
kanococo: folds
kleepeh: raises 0.02 to 0.04
crispzilla: folds
Petrov19: raises 0.06 to 0.10
kleepeh: folds
Petrov19 collected 0.14 from pot
Petrov19: doesn't show hand
*** SUMMARY ***
Total pot 0.14 | Rake 0.00
Board [ ]
Game ended: 2025/09/10 20:54:24 GMT
Seat 1: Petrov19 (big blind) collected (0.14)
Seat 2: kanococo folded before Flop (didn't bet)
Seat 3: kleepeh folded before Flop
Seat 4: Hyuk1026 folded before Flop (didn't bet)
Seat 6: crispzilla (button) folded before Flop (didn't bet)

CoinPoker Hand #295661817: Hold'em No Limit (0.01/0.02 ) 2025/09/12 12:21:19 GMT
Table 'NL ₮2 I' 7-max Seat #5 is the button
Seat 1: kanococo (2.00 in chips)
Seat 2: Duraes23 (2.95 in chips)
Seat 3: D3ATHANG3L (0.93 in chips) is sitting out
Seat 4: sabri (3.74 in chips)
Seat 5: ironheart (3.10 in chips)
Seat 6: GORILLAZ (2.30 in chips)
Seat 7: Nodori (2.02 in chips)
GORILLAZ: posts small blind 0.01
Nodori: posts big blind 0.02
kanococo: posts big blind 0.02
*** HOLE CARDS ***
Dealt to kanococo [8c Js]
kanococo: checks
Duraes23: folds
sabri: raises 0.04 to 0.06
ironheart: folds
GORILLAZ: folds
Nodori: folds
kanococo: calls 0.04
*** FLOP *** [Kh 4h 9c]
kanococo: checks
sabri: checks
*** TURN *** [Kh 4h 9c] [5s]
kanococo: bets 0.06
sabri: calls 0.06
*** RIVER *** [Kh 4h 9c 5s] [4s]
kanococo: checks
sabri: checks
*** SHOW DOWN ***
kanococo: shows [8c Js] (a pair of Fours)
sabri: shows [8d 8h] (two pairs, Eights and Fours)
sabri collected 0.26 from pot
*** SUMMARY ***
Total pot 0.27 | Rake 0.01
Board [ Kh 4h 9c 5s 4s ]
Game ended: 2025/09/12 12:22:10 GMT
Seat 1: kanococo showed [8c Js]
Seat 2: Duraes23 folded before Flop (didn't bet)
Seat 3: D3ATHANG3L folded before Flop (didn't bet)
Seat 4: sabri showed [8d 8h] and won (0.26) with two pairs, Eights and Fours
Seat 5: ironheart (button) folded before Flop (didn't bet)
Seat 6: GORILLAZ (small blind) folded before Flop
Seat 7: Nodori (big blind) folded before Flop

CoinPoker Hand #295662054: Hold'em No Limit (0.01/0.02 ) 2025/09/12 12:22:13 GMT
Table 'NL ₮2 I' 7-max Seat #6 is the button
Seat 1: kanococo (1.88 in chips)
Seat 2: Duraes23 (2.95 in chips)
Seat 3: D3ATHANG3L (0.93 in chips)
Seat 4: sabri (3.88 in chips)
Seat 5: ironheart (3.10 in chips)
Seat 6: GORILLAZ (2.29 in chips)
Seat 7: Nodori (2.00 in chips)
Nodori: posts small blind 0.01
kanococo: posts big blind 0.02
*** HOLE CARDS ***
Dealt to kanococo [Qh 9h]
Duraes23: folds
D3ATHANG3L: folds
sabri: folds
ironheart: raises 0.02 to 0.04
GORILLAZ: folds
Nodori: folds
kanococo: raises 0.06 to 0.10
ironheart: calls 0.06
*** FLOP *** [5h 3c 8c]
kanococo: checks
ironheart: bets 0.10
sabri is disconnected
kanococo: calls 0.10
*** TURN *** [5h 3c 8c] [9d]
kanococo: bets 0.22
sabri has reconnected
ironheart: raises 0.41 to 0.63
kanococo has timed out
kanococo activated time-bank (60 seconds)
kanococo: calls 0.41
*** RIVER *** [5h 3c 8c 9d] [Ad]
kanococo: bets 1.05 and is all-in
ironheart: calls 1.05
*** SHOW DOWN ***
kanococo: shows [Qh 9h] (a pair of Nines)
ironheart: shows [8s 9s] (two pairs, Nines and Eights)
ironheart collected 3.58 from pot
*** SUMMARY ***
Total pot 3.77 | Rake 0.19
Board [ 5h 3c 8c 9d Ad ]
Game ended: 2025/09/12 12:23:57 GMT
Seat 1: kanococo (big blind) showed [Qh 9h]
Seat 2: Duraes23 folded before Flop (didn't bet)
Seat 3: D3ATHANG3L folded before Flop (didn't bet)
Seat 4: sabri folded before Flop (didn't bet)
Seat 5: ironheart showed [8s 9s] and won (3.58) with two pairs, Nines and Eights
Seat 6: GORILLAZ (button) folded before Flop (didn't bet)
Seat 7: Nodori (small blind) folded before Flop

CoinPoker Hand #295663448: Hold'em No Limit (0.01/0.02 ) 2025/09/12 12:27:47 GMT
Table 'NL ₮2 V' 7-max Seat #3 is the button
Seat 2: ahamvasuki (0.80 in chips)
Seat 3: iWei (2.77 in chips)
Seat 4: ironheart (2.00 in chips)
Seat 5: kanococo (2.00 in chips)
Seat 7: Nodori (4.65 in chips) is sitting out
ironheart: posts small blind 0.01
kanococo: posts big blind 0.02
*** HOLE CARDS ***
Dealt to kanococo [7h 6d]
ahamvasuki: folds
iWei: folds
ironheart: folds
kanococo collected 0.03 from pot
kanococo: doesn't show hand
*** SUMMARY ***
Total pot 0.03 | Rake 0.00
Board [ ]
Game ended: 2025/09/12 12:27:54 GMT
Seat 2: ahamvasuki folded before Flop (didn't bet)
Seat 3: iWei (button) folded before Flop (didn't bet)
Seat 4: ironheart (small blind) folded before Flop
Seat 5: kanococo (big blind) collected (0.03)
Seat 7: Nodori folded before Flop (didn't bet)

CoinPoker Hand #295663505: Hold'em No Limit (0.01/0.02 ) 2025/09/12 12:27:56 GMT
Table 'NL ₮2 V' 7-max Seat #4 is the button
Seat 2: ahamvasuki (0.80 in chips)
Seat 3: iWei (2.77 in chips)
Seat 4: ironheart (2.00 in chips)
Seat 5: kanococo (2.01 in chips)
Seat 7: Nodori (4.65 in chips) is sitting out
kanococo: posts small blind 0.01
ahamvasuki: posts big blind 0.02
*** HOLE CARDS ***
Dealt to kanococo [Js Kd]
iWei: folds
ironheart: raises 0.04 to 0.06
kanococo: calls 0.05
ahamvasuki: folds
*** FLOP *** [7h 4d 5d]
kanococo: checks
ironheart: bets 0.09
kanococo: folds
Uncalled bet (0.09) returned to ironheart
ironheart collected 0.13 from pot
ironheart: doesn't show hand
*** SUMMARY ***
Total pot 0.14 | Rake 0.01
Board [ 7h 4d 5d ]
Game ended: 2025/09/12 12:28:37 GMT
Seat 2: ahamvasuki (big blind) folded before Flop
Seat 3: iWei folded before Flop (didn't bet)
Seat 4: ironheart (button) collected (0.13)
Seat 5: kanococo (small blind) folded on the Flop
Seat 7: Nodori folded before Flop (didn't bet)

CoinPoker Hand #295663665: Hold'em No Limit (0.01/0.02 ) 2025/09/12 12:28:39 GMT
Table 'NL ₮2 V' 7-max Seat #5 is the button
Seat 2: ahamvasuki (0.78 in chips)
Seat 3: iWei (2.77 in chips)
Seat 4: ironheart (2.07 in chips)
Seat 5: kanococo (1.95 in chips)
Seat 7: Nodori (4.65 in chips) is sitting out
ahamvasuki: posts small blind 0.01
iWei: didn't post big blind
ironheart: posts big blind 0.02
*** HOLE CARDS ***
Dealt to kanococo [3s 8h]
kanococo: folds
ahamvasuki: raises 0.04 to 0.06
ironheart: folds
ahamvasuki collected 0.08 from pot
ahamvasuki: doesn't show hand
*** SUMMARY ***
Total pot 0.08 | Rake 0.00
Board [ ]
Game ended: 2025/09/12 12:28:49 GMT
Seat 2: ahamvasuki (small blind) collected (0.08)
Seat 3: iWei folded before Flop (didn't bet)
Seat 4: ironheart (big blind) folded before Flop
Seat 5: kanococo (button) folded before Flop (didn't bet)
Seat 7: Nodori folded before Flop (didn't bet)

CoinPoker Hand #295663711: Hold'em No Limit (0.01/0.02 ) 2025/09/12 12:28:52 GMT
Table 'NL ₮2 V' 7-max Seat #2 is the button
Seat 1: Dozen (2.00 in chips) out of hand
Seat 2: ahamvasuki (0.80 in chips)
Seat 4: ironheart (2.05 in chips)
Seat 5: kanococo (1.95 in chips)
Seat 7: Nodori (4.65 in chips) is sitting out
ironheart: posts small blind 0.01
kanococo: posts big blind 0.02
*** HOLE CARDS ***
Dealt to kanococo [5h Js]
ahamvasuki: raises 0.04 to 0.06
ironheart has timed out
ironheart activated time-bank (60 seconds)
ironheart: folds
kanococo: folds
ahamvasuki collected 0.09 from pot
ahamvasuki: doesn't show hand
*** SUMMARY ***
Total pot 0.09 | Rake 0.00
Board [ ]
Game ended: 2025/09/12 12:29:30 GMT
Seat 1: Dozen folded before Flop (didn't bet)
Seat 2: ahamvasuki (button) collected (0.09)
Seat 4: ironheart (small blind) folded before Flop
Seat 5: kanococo (big blind) folded before Flop
Seat 7: Nodori folded before Flop (didn't bet)

CoinPoker Hand #295663836: Hold'em No Limit (0.01/0.02 ) 2025/09/12 12:29:33 GMT
Table 'NL ₮2 V' 7-max Seat #4 is the button
Seat 1: Dozen (2.00 in chips)
Seat 2: ahamvasuki (0.83 in chips)
Seat 3: MaxIQ (2.00 in chips) out of hand
Seat 4: ironheart (2.04 in chips)
Seat 5: kanococo (1.93 in chips)
Seat 7: Nodori (4.65 in chips) is sitting out
kanococo: posts small blind 0.01
Dozen: posts big blind 0.02
*** HOLE CARDS ***
Dealt to kanococo [As 5d]
ahamvasuki: folds
ironheart: folds
kanococo: raises 0.06 to 0.08
Dozen: folds
kanococo collected 0.10 from pot
kanococo: doesn't show hand
*** SUMMARY ***
Total pot 0.10 | Rake 0.00
Board [ ]
Game ended: 2025/09/12 12:29:51 GMT
Seat 1: Dozen (big blind) folded before Flop
Seat 2: ahamvasuki folded before Flop (didn't bet)
Seat 3: MaxIQ folded before Flop (didn't bet)
Seat 4: ironheart (button) folded before Flop (didn't bet)
Seat 5: kanococo (small blind) collected (0.10)
Seat 7: Nodori folded before Flop (didn't bet)

CoinPoker Hand #295663926: Hold'em No Limit (0.01/0.02 ) 2025/09/12 12:29:54 GMT
Table 'NL ₮2 V' 7-max Seat #5 is the button
Seat 1: Dozen (2.00 in chips)
Seat 2: ahamvasuki (0.83 in chips)
Seat 3: MaxIQ (2.00 in chips) out of hand
Seat 4: ironheart (2.04 in chips)
Seat 5: kanococo (1.95 in chips)
Seat 7: Nodori (4.65 in chips) is sitting out
Dozen: posts small blind 0.01
ahamvasuki: posts big blind 0.02
*** HOLE CARDS ***
Dealt to kanococo [2h 5c]
ironheart has timed out
ironheart activated time-bank (52 seconds)
ironheart: folds
kanococo: folds
Dozen: folds
ahamvasuki collected 0.03 from pot
ahamvasuki: doesn't show hand
*** SUMMARY ***
Total pot 0.03 | Rake 0.00
Board [ ]
Game ended: 2025/09/12 12:30:57 GMT
Seat 1: Dozen (small blind) folded before Flop
Seat 2: ahamvasuki (big blind) collected (0.03)
Seat 3: MaxIQ folded before Flop (didn't bet)
Seat 4: ironheart folded before Flop (didn't bet)
Seat 5: kanococo (button) folded before Flop (didn't bet)
Seat 7: Nodori folded before Flop (didn't bet)

CoinPoker Hand #295664355: Hold'em No Limit (0.01/0.02 ) 2025/09/12 12:31:00 GMT
Table 'NL ₮2 V' 7-max Seat #1 is the button
Seat 1: Dozen (2.00 in chips)
Seat 2: ahamvasuki (0.84 in chips)
Seat 3: MaxIQ (2.00 in chips)
Seat 4: ironheart (2.04 in chips)
Seat 5: kanococo (1.95 in chips)
ahamvasuki: posts small blind 0.01
MaxIQ: posts big blind 0.02
*** HOLE CARDS ***
Dealt to kanococo [Js Ac]
ironheart: folds
kanococo: raises 0.06 to 0.08
Dozen: folds
ahamvasuki: folds
MaxIQ: folds
kanococo collected 0.11 from pot
kanococo: doesn't show hand
*** SUMMARY ***
Total pot 0.11 | Rake 0.00
Board [ ]
Game ended: 2025/09/12 12:31:20 GMT
Seat 1: Dozen (button) folded before Flop (didn't bet)
Seat 2: ahamvasuki (small blind) folded before Flop
Seat 3: MaxIQ (big blind) folded before Flop
Seat 4: ironheart folded before Flop (didn't bet)
Seat 5: kanococo collected (0.11)

CoinPoker Hand #295664424: Hold'em No Limit (0.01/0.02 ) 2025/09/12 12:31:22 GMT
Table 'NL ₮2 V' 7-max Seat #2 is the button
Seat 1: Dozen (2.00 in chips)
Seat 2: ahamvasuki (0.83 in chips)
Seat 3: MaxIQ (2.00 in chips)
Seat 4: ironheart (2.04 in chips)
Seat 5: kanococo (1.98 in chips)
Seat 6: GRAF1111 (2.00 in chips) out of hand
MaxIQ: posts small blind 0.01
ironheart: posts big blind 0.02
*** HOLE CARDS ***
Dealt to kanococo [Jd Js]
kanococo: raises 0.04 to 0.06
Dozen: folds
ahamvasuki: folds
MaxIQ: calls 0.05
ironheart: folds
*** FLOP *** [Tc Ad 6c]
MaxIQ has timed out
MaxIQ activated time-bank (60 seconds)
MaxIQ: bets 0.06
kanococo: raises 0.10 to 0.16
MaxIQ: folds
Uncalled bet (0.10) returned to kanococo
kanococo collected 0.25 from pot
kanococo: doesn't show hand
*** SUMMARY ***
Total pot 0.26 | Rake 0.01
Board [ Tc Ad 6c ]
Game ended: 2025/09/12 12:32:25 GMT
Seat 1: Dozen folded before Flop (didn't bet)
Seat 2: ahamvasuki (button) folded before Flop (didn't bet)
Seat 3: MaxIQ (small blind) folded on the Flop
Seat 4: ironheart (big blind) folded before Flop
Seat 5: kanococo collected (0.25)
Seat 6: GRAF1111 folded before Flop (didn't bet)

CoinPoker Hand #295664788: Hold'em No Limit (0.01/0.02 ) 2025/09/12 12:32:28 GMT
Table 'NL ₮2 V' 7-max Seat #3 is the button
Seat 1: Dozen (2.00 in chips)
Seat 2: ahamvasuki (0.83 in chips)
Seat 3: MaxIQ (2.00 in chips)
Seat 4: ironheart (2.02 in chips)
Seat 5: kanococo (2.11 in chips)
Seat 6: GRAF1111 (2.00 in chips) out of hand
ironheart: posts small blind 0.01
kanococo: posts big blind 0.02
*** HOLE CARDS ***
Dealt to kanococo [3s 2c]
Dozen: folds
ahamvasuki: raises 0.02 to 0.04
MaxIQ: calls 0.04
ironheart has timed out
ironheart activated time-bank (21 seconds)
ironheart: folds
kanococo: calls 0.02
*** FLOP *** [8d Ad Kh]
kanococo: checks
ahamvasuki: bets 0.06
MaxIQ: calls 0.06
kanococo: folds
*** TURN *** [8d Ad Kh] [5d]
ahamvasuki: bets 0.12
MaxIQ: calls 0.12
*** RIVER *** [8d Ad Kh 5d] [5c]
ahamvasuki: bets 0.61 and is all-in
MaxIQ: calls 0.61
*** SHOW DOWN ***
ahamvasuki: shows [7d Kd] (a flush, Ace high)
MaxIQ: shows [Js Qd] (a pair of Fives)
ahamvasuki collected 1.62 from pot
*** SUMMARY ***
Total pot 1.71 | Rake 0.09
Board [ 8d Ad Kh 5d 5c ]
Game ended: 2025/09/12 12:33:56 GMT
Seat 1: Dozen folded before Flop (didn't bet)
Seat 2: ahamvasuki showed [7d Kd] and won (1.62) with a flush, Ace high
Seat 3: MaxIQ (button) showed [Js Qd]
Seat 4: ironheart (small blind) folded before Flop
Seat 5: kanococo (big blind) folded on the Flop
Seat 6: GRAF1111 folded before Flop (didn't bet)

CoinPoker Hand #295665227: Hold'em No Limit (0.01/0.02 ) 2025/09/12 12:33:59 GMT
Table 'NL ₮2 V' 7-max Seat #4 is the button
Seat 1: Dozen (2.00 in chips)
Seat 2: ahamvasuki (1.62 in chips)
Seat 3: MaxIQ (2.00 in chips) is sitting out
Seat 4: ironheart (2.01 in chips)
Seat 5: kanococo (2.07 in chips)
Seat 6: GRAF1111 (2.00 in chips)
kanococo: posts small blind 0.01
GRAF1111: posts big blind 0.02
*** HOLE CARDS ***
Dealt to kanococo [Qd 2d]
Dozen: raises 0.03 to 0.05
ahamvasuki: calls 0.05
ironheart: calls 0.05
kanococo: folds
GRAF1111: folds
*** FLOP *** [6d Kh Qc]
Dozen: checks
ahamvasuki: checks
ironheart: checks
*** TURN *** [6d Kh Qc] [Ah]
Dozen: checks
ahamvasuki: checks
ironheart: bets 0.12
Dozen: folds
ahamvasuki: folds
Uncalled bet (0.12) returned to ironheart
ironheart collected 0.17 from pot
ironheart: doesn't show hand
*** SUMMARY ***
Total pot 0.18 | Rake 0.01
Board [ 6d Kh Qc Ah ]
Game ended: 2025/09/12 12:35:10 GMT
Seat 1: Dozen folded on the Turn
Seat 2: ahamvasuki folded on the Turn
Seat 3: MaxIQ folded before Flop (didn't bet)
Seat 4: ironheart (button) collected (0.17)
Seat 5: kanococo (small blind) folded before Flop
Seat 6: GRAF1111 (big blind) folded before Flop

CoinPoker Hand #295665561: Hold'em No Limit (0.01/0.02 ) 2025/09/12 12:35:13 GMT
Table 'NL ₮2 V' 7-max Seat #5 is the button
Seat 1: Dozen (2.00 in chips)
Seat 2: ahamvasuki (1.57 in chips)
Seat 3: VanaMoldovan (2.00 in chips)
Seat 4: ironheart (2.13 in chips)
Seat 5: kanococo (2.06 in chips)
Seat 6: GRAF1111 (1.98 in chips)
Seat 7: Nodori (4.65 in chips)
GRAF1111: posts small blind 0.01
Nodori: posts big blind 0.02
VanaMoldovan: posts big blind 0.02
*** HOLE CARDS ***
Dealt to kanococo [Qh 9h]
Dozen: raises 0.03 to 0.05
ahamvasuki: calls 0.05
VanaMoldovan: raises 0.19 to 0.24
ironheart: folds
kanococo: folds
GRAF1111: folds
Nodori: folds
Dozen: folds
ahamvasuki: calls 0.19
*** FLOP *** [9s Ts 8c]
ahamvasuki: checks
VanaMoldovan: bets 0.53
ahamvasuki: folds
Uncalled bet (0.53) returned to VanaMoldovan
VanaMoldovan collected 0.53 from pot
VanaMoldovan: doesn't show hand
*** SUMMARY ***
Total pot 0.56 | Rake 0.03
Board [ 9s Ts 8c ]
Game ended: 2025/09/12 12:36:04 GMT
Seat 1: Dozen folded before Flop
Seat 2: ahamvasuki folded on the Flop
Seat 3: VanaMoldovan collected (0.53)
Seat 4: ironheart folded before Flop (didn't bet)
Seat 5: kanococo (button) folded before Flop (didn't bet)
Seat 6: GRAF1111 (small blind) folded before Flop
Seat 7: Nodori (big blind) folded before Flop

CoinPoker Hand #295665801: Hold'em No Limit (0.01/0.02 ) 2025/09/12 12:36:08 GMT
Table 'NL ₮2 V' 7-max Seat #6 is the button
Seat 1: Dozen (1.95 in chips)
Seat 2: ahamvasuki (1.33 in chips)
Seat 3: VanaMoldovan (2.29 in chips)
Seat 4: ironheart (2.13 in chips)
Seat 5: kanococo (2.06 in chips)
Seat 6: GRAF1111 (1.97 in chips)
Seat 7: Nodori (4.63 in chips)
Nodori: posts small blind 0.01
Dozen: posts big blind 0.02
*** HOLE CARDS ***
Dealt to kanococo [4c 4h]
ahamvasuki: raises 0.02 to 0.04
VanaMoldovan: folds
ironheart: calls 0.04
kanococo: raises 0.06 to 0.10
GRAF1111: raises 0.24 to 0.34
Nodori: folds
Dozen: folds
ahamvasuki: calls 0.30
ironheart: raises 0.38 to 0.72
kanococo: folds
GRAF1111: raises 1.63 and is all-in
ahamvasuki: calls 0.99 and is all-in
ironheart: calls 1.25
*** FLOP *** [7h Jd 6d]
*** TURN *** [7h Jd 6d] [5c]
*** RIVER *** [7h Jd 6d 5c] [7d]
*** SHOW DOWN ***
GRAF1111: shows [As Qh] (a pair of Sevens)
ironheart: shows [Ac Ad] (two pairs, Aces and Sevens)
ironheart collected 1.28 from side-pot 1
ahamvasuki: shows [Ts Js] (two pairs, Jacks and Sevens)
ironheart collected 3.92 from pot
*** SUMMARY ***
Total pot 5.40 | Rake 0.20
Board [ 7h Jd 6d 5c 7d ]
Game ended: 2025/09/12 12:37:11 GMT
Seat 1: Dozen (big blind) folded before Flop
Seat 2: ahamvasuki showed [Ts Js]
Seat 3: VanaMoldovan folded before Flop (didn't bet)
Seat 4: ironheart showed [Ac Ad] and won (5.20) with two pairs, Aces and Sevens
Seat 5: kanococo folded before Flop
Seat 6: GRAF1111 (button) showed [As Qh]
Seat 7: Nodori (small blind) folded before Flop

CoinPoker Hand #295666173: Hold'em No Limit (0.01/0.02 ) 2025/09/12 12:37:16 GMT
Table 'NL ₮2 V' 7-max Seat #7 is the button
Seat 1: Dozen (1.98 in chips)
Seat 2: ahamvasuki (0.80 in chips)
Seat 3: VanaMoldovan (2.29 in chips)
Seat 4: ironheart (5.36 in chips)
Seat 5: kanococo (1.96 in chips)
Seat 6: GRAF1111 (2.00 in chips)
Seat 7: Nodori (4.62 in chips)
Dozen: posts small blind 0.01
ahamvasuki: posts big blind 0.02
*** HOLE CARDS ***
Dealt to kanococo [5c 2s]
VanaMoldovan: folds
ironheart: folds
kanococo: folds
GRAF1111: folds
Nodori: raises 0.03 to 0.05
Dozen: folds
ahamvasuki: raises 0.78 and is all-in
Nodori: folds
ahamvasuki collected 0.86 from pot
ahamvasuki: doesn't show hand
*** SUMMARY ***
Total pot 0.86 | Rake 0.00
Board [ ]
Game ended: 2025/09/12 12:37:47 GMT
Seat 1: Dozen (small blind) folded before Flop
Seat 2: ahamvasuki (big blind) collected (0.86)
Seat 3: VanaMoldovan folded before Flop (didn't bet)
Seat 4: ironheart folded before Flop (didn't bet)
Seat 5: kanococo folded before Flop (didn't bet)
Seat 6: GRAF1111 folded before Flop (didn't bet)
Seat 7: Nodori (button) folded before Flop

CoinPoker Hand #295666300: Hold'em No Limit (0.01/0.02 ) 2025/09/12 12:37:49 GMT
Table 'NL ₮2 V' 7-max Seat #1 is the button
Seat 1: Dozen (1.99 in chips)
Seat 2: ahamvasuki (0.86 in chips)
Seat 3: VanaMoldovan (2.29 in chips)
Seat 4: ironheart (5.36 in chips)
Seat 5: kanococo (1.96 in chips)
Seat 6: GRAF1111 (2.00 in chips)
Seat 7: Nodori (4.57 in chips)
ahamvasuki: posts small blind 0.01
VanaMoldovan: posts big blind 0.02
*** HOLE CARDS ***
Dealt to kanococo [9h 8d]
ironheart: raises 0.02 to 0.04
kanococo: folds
GRAF1111: folds
Nodori: folds
Dozen: folds
ahamvasuki: folds
VanaMoldovan: calls 0.02
*** FLOP *** [Js 9c Jc]
VanaMoldovan: checks
ironheart: checks
*** TURN *** [Js 9c Jc] [Jh]
VanaMoldovan: bets 0.04
ironheart: folds
Uncalled bet (0.04) returned to VanaMoldovan
VanaMoldovan collected 0.09 from pot
VanaMoldovan: doesn't show hand
*** SUMMARY ***
Total pot 0.09 | Rake 0.00
Board [ Js 9c Jc Jh ]
Game ended: 2025/09/12 12:38:24 GMT
Seat 1: Dozen (button) folded before Flop (didn't bet)
Seat 2: ahamvasuki (small blind) folded before Flop
Seat 3: VanaMoldovan (big blind) collected (0.09)
Seat 4: ironheart folded on the Turn
Seat 5: kanococo folded before Flop (didn't bet)
Seat 6: GRAF1111 folded before Flop (didn't bet)
Seat 7: Nodori folded before Flop (didn't bet)

CoinPoker Hand #295666496: Hold'em No Limit (0.01/0.02 ) 2025/09/12 12:38:26 GMT
Table 'NL ₮2 V' 7-max Seat #2 is the button
Seat 1: Dozen (2.00 in chips)
Seat 2: ahamvasuki (0.85 in chips)
Seat 3: VanaMoldovan (2.34 in chips)
Seat 4: ironheart (5.32 in chips)
Seat 5: kanococo (1.96 in chips)
Seat 6: GRAF1111 (2.00 in chips)
Seat 7: Nodori (4.57 in chips)
VanaMoldovan: posts small blind 0.01
ironheart: posts big blind 0.02
*** HOLE CARDS ***
Dealt to kanococo [Jd 9d]
kanococo: folds
GRAF1111: raises 0.03 to 0.05
Nodori: folds
Dozen: folds
ahamvasuki: calls 0.05
VanaMoldovan: raises 0.10 to 0.15
ironheart: folds
GRAF1111: folds
ahamvasuki: calls 0.10
*** FLOP *** [Tc 8s Js]
VanaMoldovan: bets 0.35
ahamvasuki: folds
Uncalled bet (0.35) returned to VanaMoldovan
VanaMoldovan collected 0.35 from pot
VanaMoldovan: doesn't show hand
*** SUMMARY ***
Total pot 0.37 | Rake 0.02
Board [ Tc 8s Js ]
Game ended: 2025/09/12 12:39:02 GMT
Seat 1: Dozen folded before Flop (didn't bet)
Seat 2: ahamvasuki (button) folded on the Flop
Seat 3: VanaMoldovan (small blind) collected (0.35)
Seat 4: ironheart (big blind) folded before Flop
Seat 5: kanococo folded before Flop (didn't bet)
Seat 6: GRAF1111 folded before Flop
Seat 7: Nodori folded before Flop (didn't bet)

CoinPoker Hand #295666627: Hold'em No Limit (0.01/0.02 ) 2025/09/12 12:39:06 GMT
Table 'NL ₮2 V' 7-max Seat #3 is the button
Seat 1: Dozen (2.00 in chips)
Seat 2: ahamvasuki (0.70 in chips)
Seat 3: VanaMoldovan (2.54 in chips)
Seat 4: ironheart (5.30 in chips)
Seat 5: kanococo (1.96 in chips)
Seat 6: GRAF1111 (1.95 in chips)
Seat 7: Nodori (4.57 in chips)
ironheart: posts small blind 0.01
kanococo: posts big blind 0.02
*** HOLE CARDS ***
Dealt to kanococo [2s 3c]
GRAF1111: folds
Nodori: folds
Dozen: raises 0.03 to 0.05
ahamvasuki: folds
VanaMoldovan: folds
ironheart: folds
kanococo: calls 0.03
*** FLOP *** [3s 4s 7c]
Dozen is disconnected
kanococo: bets 0.06
Dozen has reconnected
Dozen: folds
Uncalled bet (0.06) returned to kanococo
kanococo collected 0.10 from pot
kanococo: doesn't show hand
*** SUMMARY ***
Total pot 0.11 | Rake 0.01
Board [ 3s 4s 7c ]
Game ended: 2025/09/12 12:39:50 GMT
Seat 1: Dozen folded on the Flop
Seat 2: ahamvasuki folded before Flop (didn't bet)
Seat 3: VanaMoldovan (button) folded before Flop (didn't bet)
Seat 4: ironheart (small blind) folded before Flop
Seat 5: kanococo (big blind) collected (0.10)
Seat 6: GRAF1111 folded before Flop (didn't bet)
Seat 7: Nodori folded before Flop (didn't bet)

CoinPoker Hand #295666790: Hold'em No Limit (0.01/0.02 ) 2025/09/12 12:39:52 GMT
Table 'NL ₮2 V' 7-max Seat #4 is the button
Seat 1: Dozen (2.00 in chips)
Seat 2: ahamvasuki (0.70 in chips)
Seat 3: VanaMoldovan (2.54 in chips)
Seat 4: ironheart (5.29 in chips)
Seat 5: kanococo (2.01 in chips)
Seat 6: GRAF1111 (2.00 in chips)
Seat 7: Nodori (4.57 in chips)
kanococo: posts small blind 0.01
GRAF1111: posts big blind 0.02
*** HOLE CARDS ***
Dealt to kanococo [6s Kc]
Nodori: folds
Dozen: folds
ahamvasuki: raises 0.02 to 0.04
VanaMoldovan: raises 0.11 to 0.15
ironheart: folds
kanococo: folds
GRAF1111: folds
ahamvasuki: raises 0.66 and is all-in
VanaMoldovan: calls 0.55
*** FLOP *** [Ad 7d 9h]
*** TURN *** [Ad 7d 9h] [8h]
*** RIVER *** [Ad 7d 9h 8h] [Jh]
*** SHOW DOWN ***
ahamvasuki: shows [Kd Qh] (Ace high)
VanaMoldovan: shows [Ts Th] (a straight, Jack high)
VanaMoldovan collected 1.36 from pot
*** SUMMARY ***
Total pot 1.43 | Rake 0.07
Board [ Ad 7d 9h 8h Jh ]
Game ended: 2025/09/12 12:40:21 GMT
Seat 1: Dozen folded before Flop (didn't bet)
Seat 2: ahamvasuki showed [Kd Qh]
Seat 3: VanaMoldovan showed [Ts Th] and won (1.36) with a straight, Jack high
Seat 4: ironheart (button) folded before Flop (didn't bet)
Seat 5: kanococo (small blind) folded before Flop
Seat 6: GRAF1111 (big blind) folded before Flop
Seat 7: Nodori folded before Flop (didn't bet)

CoinPoker Hand #295666919: Hold'em No Limit (0.01/0.02 ) 2025/09/12 12:40:24 GMT
Table 'NL ₮2 V' 7-max Seat #5 is the button
Seat 1: Dozen (2.00 in chips)
Seat 3: VanaMoldovan (3.20 in chips)
Seat 4: ironheart (5.29 in chips)
Seat 5: kanococo (2.00 in chips)
Seat 6: GRAF1111 (1.98 in chips)
Seat 7: Nodori (4.57 in chips)
GRAF1111: posts small blind 0.01
Nodori: posts big blind 0.02
*** HOLE CARDS ***
Dealt to kanococo [6h 7d]
Dozen: folds
VanaMoldovan: folds
ironheart: folds
kanococo: folds
GRAF1111: folds
Nodori collected 0.03 from pot
Nodori: doesn't show hand
*** SUMMARY ***
Total pot 0.03 | Rake 0.00
Board [ ]
Game ended: 2025/09/12 12:40:44 GMT
Seat 1: Dozen folded before Flop (didn't bet)
Seat 3: VanaMoldovan folded before Flop (didn't bet)
Seat 4: ironheart folded before Flop (didn't bet)
Seat 5: kanococo (button) folded before Flop (didn't bet)
Seat 6: GRAF1111 (small blind) folded before Flop
Seat 7: Nodori (big blind) collected (0.03)

CoinPoker Hand #295667042: Hold'em No Limit (0.01/0.02 ) 2025/09/12 12:40:47 GMT
Table 'NL ₮2 V' 7-max Seat #6 is the button
Seat 1: Dozen (2.00 in chips)
Seat 3: VanaMoldovan (3.20 in chips)
Seat 4: ironheart (5.29 in chips)
Seat 5: kanococo (2.00 in chips)
Seat 6: GRAF1111 (2.00 in chips)
Seat 7: Nodori (4.58 in chips)
Nodori: posts small blind 0.01
Dozen: posts big blind 0.02
*** HOLE CARDS ***
Dealt to kanococo [Kh Td]
VanaMoldovan: folds
ironheart: folds
kanococo: raises 0.06 to 0.08
GRAF1111: folds
Nodori: folds
Dozen: folds
kanococo collected 0.11 from pot
kanococo: doesn't show hand
*** SUMMARY ***
Total pot 0.11 | Rake 0.00
Board [ ]
Game ended: 2025/09/12 12:41:13 GMT
Seat 1: Dozen (big blind) folded before Flop
Seat 3: VanaMoldovan folded before Flop (didn't bet)
Seat 4: ironheart folded before Flop (didn't bet)
Seat 5: kanococo collected (0.11)
Seat 6: GRAF1111 (button) folded before Flop (didn't bet)
Seat 7: Nodori (small blind) folded before Flop

CoinPoker Hand #295667208: Hold'em No Limit (0.01/0.02 ) 2025/09/12 12:41:17 GMT
Table 'NL ₮2 V' 7-max Seat #7 is the button
Seat 1: Dozen (2.00 in chips)
Seat 3: VanaMoldovan (3.20 in chips)
Seat 4: ironheart (5.29 in chips)
Seat 5: kanococo (2.03 in chips)
Seat 6: GRAF1111 (2.00 in chips)
Seat 7: Nodori (4.57 in chips)
Dozen: posts small blind 0.01
VanaMoldovan: posts big blind 0.02
*** HOLE CARDS ***
Dealt to kanococo [8c 9h]
ironheart: folds
kanococo: folds
GRAF1111: folds
Nodori: folds
Dozen: raises 0.04 to 0.06
VanaMoldovan: folds
Dozen collected 0.08 from pot
Dozen: doesn't show hand
*** SUMMARY ***
Total pot 0.08 | Rake 0.00
Board [ ]
Game ended: 2025/09/12 12:41:48 GMT
Seat 1: Dozen (small blind) collected (0.08)
Seat 3: VanaMoldovan (big blind) folded before Flop
Seat 4: ironheart folded before Flop (didn't bet)
Seat 5: kanococo folded before Flop (didn't bet)
Seat 6: GRAF1111 folded before Flop (didn't bet)
Seat 7: Nodori (button) folded before Flop (didn't bet)

CoinPoker Hand #295667390: Hold'em No Limit (0.01/0.02 ) 2025/09/12 12:41:52 GMT
Table 'NL ₮2 V' 7-max Seat #1 is the button
Seat 1: Dozen (2.02 in chips)
Seat 3: VanaMoldovan (3.18 in chips)
Seat 4: ironheart (5.29 in chips)
Seat 5: kanococo (2.03 in chips)
Seat 6: GRAF1111 (2.00 in chips)
Seat 7: Nodori (4.57 in chips)
VanaMoldovan: posts small blind 0.01
ironheart: posts big blind 0.02
*** HOLE CARDS ***
Dealt to kanococo [Th Ah]
kanococo: raises 0.10 to 0.12
GRAF1111: raises 0.22 to 0.34
Nodori: folds
Dozen: folds
VanaMoldovan: folds
ironheart: folds
kanococo: calls 0.22
*** FLOP *** [5d Js 4d]
kanococo: bets 0.34
GRAF1111: raises 1.66 and is all-in
kanococo: calls 1.32
*** TURN *** [5d Js 4d] [Qh]
*** RIVER *** [5d Js 4d Qh] [2d]
*** SHOW DOWN ***
GRAF1111: shows [As Ac] (a pair of Aces)
kanococo: shows [Th Ah] (Ace high)
GRAF1111 collected 3.83 from pot
*** SUMMARY ***
Total pot 4.03 | Rake 0.20
Board [ 5d Js 4d Qh 2d ]
Game ended: 2025/09/12 12:43:03 GMT
Seat 1: Dozen (button) folded before Flop (didn't bet)
Seat 3: VanaMoldovan (small blind) folded before Flop
Seat 4: ironheart (big blind) folded before Flop
Seat 5: kanococo showed [Th Ah]
Seat 6: GRAF1111 showed [As Ac] and won (3.83) with a pair of Aces
Seat 7: Nodori folded before Flop (didn't bet)

CoinPoker Hand #295667728: Hold'em No Limit (0.01/0.02 ) 2025/09/12 12:43:07 GMT
Table 'NL ₮2 V' 7-max Seat #3 is the button
Seat 1: Dozen (2.02 in chips)
Seat 2: Hustlerblood (2.00 in chips)
Seat 3: VanaMoldovan (3.17 in chips)
Seat 4: ironheart (5.27 in chips)
Seat 5: kanococo (0.03 in chips)
Seat 6: GRAF1111 (3.83 in chips)
Seat 7: Nodori (4.57 in chips)
ironheart: posts small blind 0.01
kanococo: posts big blind 0.02
Hustlerblood: posts big blind 0.02
*** HOLE CARDS ***
Dealt to kanococo [3c Kh]
GRAF1111: folds
Nodori: raises 0.05 to 0.07
Dozen: folds
Hustlerblood: calls 0.05
VanaMoldovan: folds
ironheart: folds
kanococo: calls 0.01 and is all-in
*** FLOP *** [9s 8s 7s]
Nodori: bets 0.03
Hustlerblood: calls 0.03
*** TURN *** [9s 8s 7s] [4c]
Nodori: bets 0.07
Hustlerblood: calls 0.07
*** RIVER *** [9s 8s 7s 4c] [Kd]
Nodori: checks
Hustlerblood: checks
*** SHOW DOWN ***
Nodori: shows [Js Ac] (Ace high)
Hustlerblood: shows [Td 9h] (a pair of Nines)
Hustlerblood collected 0.27 from side-pot 1
kanococo: shows [3c Kh] (a pair of Kings)
kanococo collected 0.09 from pot
*** SUMMARY ***
Total pot 0.38 | Rake 0.02
Board [ 9s 8s 7s 4c Kd ]
Game ended: 2025/09/12 12:44:01 GMT
Seat 1: Dozen folded before Flop (didn't bet)
Seat 2: Hustlerblood showed [Td 9h] and won (0.27) with a pair of Nines
Seat 3: VanaMoldovan (button) folded before Flop (didn't bet)
Seat 4: ironheart (small blind) folded before Flop
Seat 5: kanococo (big blind) showed [3c Kh] and won (0.09) with a pair of Kings
Seat 6: GRAF1111 folded before Flop (didn't bet)
Seat 7: Nodori showed [Js Ac]

CoinPoker Hand #295668031: Hold'em No Limit (0.01/0.02 ) 2025/09/12 12:44:07 GMT
Table 'NL ₮2 V' 7-max Seat #4 is the button
Seat 1: Dozen (2.02 in chips)
Seat 2: Hustlerblood (2.10 in chips)
Seat 3: VanaMoldovan (3.17 in chips)
Seat 4: ironheart (5.26 in chips)
Seat 5: kanococo (0.09 in chips)
Seat 6: GRAF1111 (3.83 in chips)
Seat 7: Nodori (4.40 in chips)
kanococo: posts small blind 0.01
GRAF1111: posts big blind 0.02
*** HOLE CARDS ***
Dealt to kanococo [4c 9h]
Nodori: folds
Dozen: folds
Hustlerblood: folds
VanaMoldovan: folds
ironheart: folds
kanococo: raises 0.08 and is all-in
GRAF1111 has timed out
GRAF1111 activated time-bank (60 seconds)
GRAF1111: calls 0.07
*** FLOP *** [2s Ad Ks]
*** TURN *** [2s Ad Ks] [Qh]
*** RIVER *** [2s Ad Ks Qh] [6c]
*** SHOW DOWN ***
kanococo: shows [4c 9h] (Ace high)
GRAF1111: shows [3c 5d] (Ace high)
kanococo collected 0.17 from pot
*** SUMMARY ***
Total pot 0.18 | Rake 0.01
Board [ 2s Ad Ks Qh 6c ]
Game ended: 2025/09/12 12:45:14 GMT
Seat 1: Dozen folded before Flop (didn't bet)
Seat 2: Hustlerblood folded before Flop (didn't bet)
Seat 3: VanaMoldovan folded before Flop (didn't bet)
Seat 4: ironheart (button) folded before Flop (didn't bet)
Seat 5: kanococo (small blind) showed [4c 9h] and won (0.17) with Ace high
Seat 6: GRAF1111 (big blind) showed [3c 5d]
Seat 7: Nodori folded before Flop (didn't bet)

CoinPoker Hand #295668387: Hold'em No Limit (0.01/0.02 ) 2025/09/12 12:45:17 GMT
Table 'NL ₮2 V' 7-max Seat #5 is the button
Seat 1: Dozen (2.02 in chips)
Seat 2: Hustlerblood (2.10 in chips)
Seat 3: VanaMoldovan (3.17 in chips)
Seat 4: ironheart (5.26 in chips)
Seat 5: kanococo (0.17 in chips)
Seat 6: GRAF1111 (3.74 in chips)
Seat 7: Nodori (4.40 in chips)
GRAF1111: posts small blind 0.01
Nodori: posts big blind 0.02
*** HOLE CARDS ***
Dealt to kanococo [3d 5d]
Dozen: folds
Hustlerblood: raises 0.04 to 0.06
VanaMoldovan: folds
ironheart: folds
kanococo: folds
GRAF1111: folds
Nodori: calls 0.04
*** FLOP *** [Ts Jh Tc]
Nodori: checks
Hustlerblood: checks
*** TURN *** [Ts Jh Tc] [4h]
Nodori: bets 0.04
Hustlerblood: calls 0.04
*** RIVER *** [Ts Jh Tc 4h] [Ks]
Nodori: bets 0.26
Hustlerblood: calls 0.26
*** SHOW DOWN ***
Nodori: shows [Kh Jd] (two pairs, Kings and Jacks)
Hustlerblood: shows [Td Ah] (three of kind, Tens)
Hustlerblood collected 0.69 from pot
*** SUMMARY ***
Total pot 0.73 | Rake 0.04
Board [ Ts Jh Tc 4h Ks ]
Game ended: 2025/09/12 12:46:24 GMT
Seat 1: Dozen folded before Flop (didn't bet)
Seat 2: Hustlerblood showed [Td Ah] and won (0.69) with three of kind, Tens
Seat 3: VanaMoldovan folded before Flop (didn't bet)
Seat 4: ironheart folded before Flop (didn't bet)
Seat 5: kanococo (button) folded before Flop (didn't bet)
Seat 6: GRAF1111 (small blind) folded before Flop
Seat 7: Nodori (big blind) showed [Kh Jd]

CoinPoker Hand #295668692: Hold'em No Limit (0.01/0.02 ) 2025/09/12 12:46:27 GMT
Table 'NL ₮2 V' 7-max Seat #6 is the button
Seat 1: Dozen (2.02 in chips)
Seat 2: Hustlerblood (2.43 in chips)
Seat 3: VanaMoldovan (3.17 in chips)
Seat 4: ironheart (5.26 in chips)
Seat 5: kanococo (0.17 in chips)
Seat 6: GRAF1111 (3.73 in chips)
Seat 7: Nodori (4.04 in chips)
Nodori: posts small blind 0.01
Dozen: posts big blind 0.02
*** HOLE CARDS ***
Dealt to kanococo [7c 7s]
Hustlerblood: raises 0.04 to 0.06
VanaMoldovan: folds
ironheart: folds
kanococo: raises 0.17 and is all-in
GRAF1111: folds
Nodori: folds
Dozen: folds
Hustlerblood: calls 0.11
*** FLOP *** [9d 6d Ks]
*** TURN *** [9d 6d Ks] [8s]
*** RIVER *** [9d 6d Ks 8s] [9s]
*** SHOW DOWN ***
kanococo: shows [7c 7s] (two pairs, Nines and Sevens)
Hustlerblood: shows [Td Jd] (a pair of Nines)
kanococo collected 0.35 from pot
*** SUMMARY ***
Total pot 0.37 | Rake 0.02
Board [ 9d 6d Ks 8s 9s ]
Game ended: 2025/09/12 12:47:13 GMT
Seat 1: Dozen (big blind) folded before Flop
Seat 2: Hustlerblood showed [Td Jd]
Seat 3: VanaMoldovan folded before Flop (didn't bet)
Seat 4: ironheart folded before Flop (didn't bet)
Seat 5: kanococo showed [7c 7s] and won (0.35) with two pairs, Nines and Sevens
Seat 6: GRAF1111 (button) folded before Flop (didn't bet)
Seat 7: Nodori (small blind) folded before Flop

CoinPoker Hand #295668873: Hold'em No Limit (0.01/0.02 ) 2025/09/12 12:47:16 GMT
Table 'NL ₮2 V' 7-max Seat #7 is the button
Seat 1: Dozen (2.00 in chips)
Seat 2: Hustlerblood (2.26 in chips)
Seat 3: VanaMoldovan (3.17 in chips)
Seat 4: ironheart (5.26 in chips)
Seat 5: kanococo (0.35 in chips)
Seat 6: GRAF1111 (3.73 in chips)
Seat 7: Nodori (4.03 in chips)
Dozen: posts small blind 0.01
Hustlerblood: posts big blind 0.02
*** HOLE CARDS ***
Dealt to kanococo [Kh 2h]
VanaMoldovan: raises 0.02 to 0.04
ironheart: calls 0.04
kanococo: folds
GRAF1111: folds
Nodori: folds
Dozen: folds
Hustlerblood: folds
*** FLOP *** [9s 7s 3d]
VanaMoldovan: bets 0.05
ironheart has timed out
ironheart activated time-bank (20 seconds)
ironheart: calls 0.05
*** TURN *** [9s 7s 3d] [Qc]
VanaMoldovan: bets 0.10
ironheart has timed out
ironheart activated time-bank (19 seconds)
ironheart: calls 0.10
*** RIVER *** [9s 7s 3d Qc] [Qh]
VanaMoldovan: bets 0.19
ironheart: folds
Uncalled bet (0.19) returned to VanaMoldovan
VanaMoldovan collected 0.39 from pot
VanaMoldovan: doesn't show hand
*** SUMMARY ***
Total pot 0.41 | Rake 0.02
Board [ 9s 7s 3d Qc Qh ]
Game ended: 2025/09/12 12:48:42 GMT
Seat 1: Dozen (small blind) folded before Flop
Seat 2: Hustlerblood (big blind) folded before Flop
Seat 3: VanaMoldovan collected (0.39)
Seat 4: ironheart folded on the River
Seat 5: kanococo folded before Flop (didn't bet)
Seat 6: GRAF1111 folded before Flop (didn't bet)
Seat 7: Nodori (button) folded before Flop (didn't bet)

CoinPoker Hand #295669280: Hold'em No Limit (0.01/0.02 ) 2025/09/12 12:48:45 GMT
Table 'NL ₮2 V' 7-max Seat #1 is the button
Seat 1: Dozen (2.00 in chips)
Seat 3: VanaMoldovan (3.37 in chips)
Seat 4: ironheart (5.07 in chips)
Seat 5: kanococo (0.35 in chips)
Seat 6: GRAF1111 (3.73 in chips)
Seat 7: Nodori (4.03 in chips)
VanaMoldovan: posts small blind 0.01
ironheart: posts big blind 0.02
*** HOLE CARDS ***
Dealt to kanococo [5s 7d]
kanococo: folds
GRAF1111: folds
Nodori: folds
Dozen: raises 0.04 to 0.06
VanaMoldovan: calls 0.05
ironheart: calls 0.04
*** FLOP *** [7h Ah 8s]
VanaMoldovan: checks
ironheart has timed out
ironheart activated time-bank (14 seconds)
ironheart: checks
Dozen: bets 0.08
VanaMoldovan: calls 0.08
LowLimitEnjoyer is disconnected
ironheart: calls 0.08
*** TURN *** [7h Ah 8s] [2d]
VanaMoldovan: checks
LowLimitEnjoyer has reconnected
ironheart has timed out
ironheart activated time-bank (4 seconds)
ironheart: checks
Dozen: bets 0.20
VanaMoldovan: folds
ironheart: folds
Uncalled bet (0.20) returned to Dozen
Dozen collected 0.40 from pot
Dozen: doesn't show hand
*** SUMMARY ***
Total pot 0.42 | Rake 0.02
Board [ 7h Ah 8s 2d ]
Game ended: 2025/09/12 12:51:05 GMT
Seat 1: Dozen (button) collected (0.40)
Seat 3: VanaMoldovan (small blind) folded on the Turn
Seat 4: ironheart (big blind) folded on the Turn
Seat 5: kanococo folded before Flop (didn't bet)
Seat 6: GRAF1111 folded before Flop (didn't bet)
Seat 7: Nodori folded before Flop (didn't bet)

CoinPoker Hand #295669919: Hold'em No Limit (0.01/0.02 ) 2025/09/12 12:51:07 GMT
Table 'NL ₮2 V' 7-max Seat #3 is the button
Seat 1: Dozen (2.26 in chips)
Seat 2: LowLimitEnjoyer (2.00 in chips) out of hand
Seat 3: VanaMoldovan (3.23 in chips)
Seat 4: ironheart (4.93 in chips)
Seat 5: kanococo (0.35 in chips)
Seat 6: GRAF1111 (3.73 in chips)
Seat 7: Nodori (4.03 in chips)
ironheart: posts small blind 0.01
kanococo: posts big blind 0.02
*** HOLE CARDS ***
Dealt to kanococo [Th 4h]
GRAF1111: folds
Nodori: folds
Dozen: raises 0.04 to 0.06
VanaMoldovan: calls 0.06
ironheart: folds
kanococo has timed out
kanococo activated time-bank (60 seconds)
kanococo: folds
*** FLOP *** [Ad 5s Kc]
Dozen: bets 0.07
VanaMoldovan: calls 0.07
*** TURN *** [Ad 5s Kc] [Kd]
Dozen: checks
VanaMoldovan: checks
*** RIVER *** [Ad 5s Kc Kd] [7s]
Dozen: checks
VanaMoldovan: bets 0.14
Dozen: folds
Uncalled bet (0.14) returned to VanaMoldovan
VanaMoldovan collected 0.28 from pot
VanaMoldovan: doesn't show hand
*** SUMMARY ***
Total pot 0.29 | Rake 0.01
Board [ Ad 5s Kc Kd 7s ]
Game ended: 2025/09/12 12:52:07 GMT
Seat 1: Dozen folded on the River
Seat 2: LowLimitEnjoyer folded before Flop (didn't bet)
Seat 3: VanaMoldovan (button) collected (0.28)
Seat 4: ironheart (small blind) folded before Flop
Seat 5: kanococo (big blind) folded before Flop
Seat 6: GRAF1111 folded before Flop (didn't bet)
Seat 7: Nodori folded before Flop (didn't bet)

CoinPoker Hand #295670248: Hold'em No Limit (0.01/0.02 ) 2025/09/12 12:52:10 GMT
Table 'NL ₮2 V' 7-max Seat #4 is the button
Seat 1: Dozen (2.13 in chips)
Seat 2: LowLimitEnjoyer (2.00 in chips) out of hand
Seat 3: VanaMoldovan (3.38 in chips)
Seat 4: ironheart (4.92 in chips)
Seat 5: kanococo (0.33 in chips)
Seat 6: GRAF1111 (3.73 in chips)
Seat 7: Nodori (4.03 in chips)
kanococo: posts small blind 0.01
GRAF1111: posts big blind 0.02
*** HOLE CARDS ***
Dealt to kanococo [Kd 8d]
Nodori: folds
Dozen: folds
VanaMoldovan: folds
ironheart: folds
kanococo: raises 0.08 to 0.10
GRAF1111: folds
kanococo collected 0.12 from pot
kanococo: doesn't show hand
*** SUMMARY ***
Total pot 0.12 | Rake 0.00
Board [ ]
Game ended: 2025/09/12 12:52:41 GMT
Seat 1: Dozen folded before Flop (didn't bet)
Seat 2: LowLimitEnjoyer folded before Flop (didn't bet)
Seat 3: VanaMoldovan folded before Flop (didn't bet)
Seat 4: ironheart (button) folded before Flop (didn't bet)
Seat 5: kanococo (small blind) collected (0.12)
Seat 6: GRAF1111 (big blind) folded before Flop
Seat 7: Nodori folded before Flop (didn't bet)

CoinPoker Hand #295670362: Hold'em No Limit (0.01/0.02 ) 2025/09/12 12:52:44 GMT
Table 'NL ₮2 V' 7-max Seat #5 is the button
Seat 1: Dozen (2.13 in chips)
Seat 2: LowLimitEnjoyer (2.00 in chips) out of hand
Seat 3: VanaMoldovan (3.38 in chips)
Seat 4: ironheart (4.92 in chips)
Seat 5: kanococo (0.35 in chips)
Seat 6: GRAF1111 (3.71 in chips)
Seat 7: Nodori (4.03 in chips)
GRAF1111: posts small blind 0.01
Nodori: posts big blind 0.02
*** HOLE CARDS ***
Dealt to kanococo [8c 7c]
Dozen: folds
VanaMoldovan: folds
ironheart: folds
kanococo: folds
GRAF1111: raises 0.04 to 0.06
Nodori: folds
GRAF1111 collected 0.08 from pot
GRAF1111: doesn't show hand
*** SUMMARY ***
Total pot 0.08 | Rake 0.00
Board [ ]
Game ended: 2025/09/12 12:53:18 GMT
Seat 1: Dozen folded before Flop (didn't bet)
Seat 2: LowLimitEnjoyer folded before Flop (didn't bet)
Seat 3: VanaMoldovan folded before Flop (didn't bet)
Seat 4: ironheart folded before Flop (didn't bet)
Seat 5: kanococo (button) folded before Flop (didn't bet)
Seat 6: GRAF1111 (small blind) collected (0.08)
Seat 7: Nodori (big blind) folded before Flop

CoinPoker Hand #295670560: Hold'em No Limit (0.01/0.02 ) 2025/09/12 12:53:22 GMT
Table 'NL ₮2 V' 7-max Seat #6 is the button
Seat 1: Dozen (2.13 in chips)
Seat 2: LowLimitEnjoyer (2.00 in chips) out of hand
Seat 3: VanaMoldovan (3.38 in chips)
Seat 4: ironheart (4.92 in chips)
Seat 5: kanococo (0.35 in chips)
Seat 6: GRAF1111 (3.73 in chips)
Seat 7: Nodori (4.01 in chips)
Nodori: posts small blind 0.01
Dozen: posts big blind 0.02
*** HOLE CARDS ***
Dealt to kanococo [2d As]
VanaMoldovan: folds
ironheart: folds
kanococo: raises 0.35 and is all-in
GRAF1111: folds
Nodori: folds
Dozen: calls 0.33
*** FLOP *** [Td 3h 6h]
*** TURN *** [Td 3h 6h] [7c]
*** RIVER *** [Td 3h 6h 7c] [Js]
*** SHOW DOWN ***
kanococo: shows [2d As] (Ace high)
Dozen: shows [Ac 5d] (Ace high)
kanococo collected 0.34 from pot
Dozen collected 0.33 from pot
*** SUMMARY ***
Total pot 0.71 | Rake 0.04
Board [ Td 3h 6h 7c Js ]
Game ended: 2025/09/12 12:54:02 GMT
Seat 1: Dozen (big blind) showed [Ac 5d] and won (0.33) with Ace high
Seat 2: LowLimitEnjoyer folded before Flop (didn't bet)
Seat 3: VanaMoldovan folded before Flop (didn't bet)
Seat 4: ironheart folded before Flop (didn't bet)
Seat 5: kanococo showed [2d As] and won (0.34) with Ace high
Seat 6: GRAF1111 (button) folded before Flop (didn't bet)
Seat 7: Nodori (small blind) folded before Flop

CoinPoker Hand #295670802: Hold'em No Limit (0.01/0.02 ) 2025/09/12 12:54:05 GMT
Table 'NL ₮2 V' 7-max Seat #7 is the button
Seat 1: Dozen (2.11 in chips)
Seat 2: LowLimitEnjoyer (2.00 in chips)
Seat 3: VanaMoldovan (3.38 in chips)
Seat 4: ironheart (4.92 in chips)
Seat 5: kanococo (0.34 in chips)
Seat 6: GRAF1111 (3.73 in chips)
Seat 7: Nodori (4.00 in chips)
Dozen: posts small blind 0.01
LowLimitEnjoyer: posts big blind 0.02
*** HOLE CARDS ***
Dealt to kanococo [Td 7c]
VanaMoldovan: folds
ironheart: folds
kanococo: folds
GRAF1111: folds
Nodori: folds
Dozen: calls 0.01
LowLimitEnjoyer: raises 0.04 to 0.06
Dozen: folds
LowLimitEnjoyer collected 0.08 from pot
LowLimitEnjoyer: doesn't show hand
*** SUMMARY ***
Total pot 0.08 | Rake 0.00
Board [ ]
Game ended: 2025/09/12 12:54:57 GMT
Seat 1: Dozen (small blind) folded before Flop
Seat 2: LowLimitEnjoyer (big blind) collected (0.08)
Seat 3: VanaMoldovan folded before Flop (didn't bet)
Seat 4: ironheart folded before Flop (didn't bet)
Seat 5: kanococo folded before Flop (didn't bet)
Seat 6: GRAF1111 folded before Flop (didn't bet)
Seat 7: Nodori (button) folded before Flop (didn't bet)

CoinPoker Hand #295670976: Hold'em No Limit (0.01/0.02 ) 2025/09/12 12:55:01 GMT
Table 'NL ₮2 V' 7-max Seat #1 is the button
Seat 1: Dozen (2.09 in chips)
Seat 2: LowLimitEnjoyer (2.02 in chips)
Seat 3: VanaMoldovan (3.38 in chips)
Seat 4: ironheart (4.92 in chips)
Seat 5: kanococo (0.34 in chips)
Seat 6: GRAF1111 (3.73 in chips)
Seat 7: Nodori (4.00 in chips)
LowLimitEnjoyer: posts small blind 0.01
VanaMoldovan: posts big blind 0.02
*** HOLE CARDS ***
Dealt to kanococo [9d Th]
ironheart: folds
kanococo: folds
GRAF1111: folds
Nodori: folds
Dozen: raises 0.04 to 0.06
LowLimitEnjoyer: raises 0.14 to 0.20
VanaMoldovan: folds
Dozen: folds
LowLimitEnjoyer collected 0.28 from pot
LowLimitEnjoyer: doesn't show hand
*** SUMMARY ***
Total pot 0.28 | Rake 0.00
Board [ ]
Game ended: 2025/09/12 12:55:37 GMT
Seat 1: Dozen (button) folded before Flop
Seat 2: LowLimitEnjoyer (small blind) collected (0.28)
Seat 3: VanaMoldovan (big blind) folded before Flop
Seat 4: ironheart folded before Flop (didn't bet)
Seat 5: kanococo folded before Flop (didn't bet)
Seat 6: GRAF1111 folded before Flop (didn't bet)
Seat 7: Nodori folded before Flop (didn't bet)

CoinPoker Hand #295671158: Hold'em No Limit (0.01/0.02 ) 2025/09/12 12:55:39 GMT
Table 'NL ₮2 V' 7-max Seat #2 is the button
Seat 1: Dozen (2.03 in chips)
Seat 2: LowLimitEnjoyer (2.10 in chips)
Seat 3: VanaMoldovan (3.36 in chips)
Seat 4: ironheart (4.92 in chips)
Seat 5: kanococo (0.34 in chips)
Seat 6: GRAF1111 (3.73 in chips)
Seat 7: Nodori (4.00 in chips)
VanaMoldovan: posts small blind 0.01
ironheart: posts big blind 0.02
*** HOLE CARDS ***
Dealt to kanococo [2h 6c]
kanococo: folds
GRAF1111: folds
Nodori: folds
Dozen: raises 0.04 to 0.06
LowLimitEnjoyer: folds
VanaMoldovan: folds
ironheart: folds
Dozen collected 0.09 from pot
Dozen: doesn't show hand
*** SUMMARY ***
Total pot 0.09 | Rake 0.00
Board [ ]
Game ended: 2025/09/12 12:55:57 GMT
Seat 1: Dozen collected (0.09)
Seat 2: LowLimitEnjoyer (button) folded before Flop (didn't bet)
Seat 3: VanaMoldovan (small blind) folded before Flop
Seat 4: ironheart (big blind) folded before Flop
Seat 5: kanococo folded before Flop (didn't bet)
Seat 6: GRAF1111 folded before Flop (didn't bet)
Seat 7: Nodori folded before Flop (didn't bet)

CoinPoker Hand #295671310: Hold'em No Limit (0.01/0.02 ) 2025/09/12 12:56:00 GMT
Table 'NL ₮2 V' 7-max Seat #3 is the button
Seat 1: Dozen (2.06 in chips)
Seat 2: LowLimitEnjoyer (2.10 in chips)
Seat 3: VanaMoldovan (3.35 in chips)
Seat 4: ironheart (4.90 in chips)
Seat 5: kanococo (0.34 in chips)
Seat 6: GRAF1111 (3.73 in chips)
Seat 7: Nodori (4.00 in chips)
ironheart: posts small blind 0.01
kanococo: posts big blind 0.02
*** HOLE CARDS ***
Dealt to kanococo [Tc 4d]
GRAF1111: folds
Nodori: folds
Dozen: folds
LowLimitEnjoyer: folds
VanaMoldovan: folds
ironheart: folds
kanococo collected 0.03 from pot
kanococo: doesn't show hand
*** SUMMARY ***
Total pot 0.03 | Rake 0.00
Board [ ]
Game ended: 2025/09/12 12:56:18 GMT
Seat 1: Dozen folded before Flop (didn't bet)
Seat 2: LowLimitEnjoyer folded before Flop (didn't bet)
Seat 3: VanaMoldovan (button) folded before Flop (didn't bet)
Seat 4: ironheart (small blind) folded before Flop
Seat 5: kanococo (big blind) collected (0.03)
Seat 6: GRAF1111 folded before Flop (didn't bet)
Seat 7: Nodori folded before Flop (didn't bet)

CoinPoker Hand #295671412: Hold'em No Limit (0.01/0.02 ) 2025/09/12 12:56:20 GMT
Table 'NL ₮2 V' 7-max Seat #4 is the button
Seat 1: Dozen (2.06 in chips)
Seat 2: LowLimitEnjoyer (2.10 in chips)
Seat 3: VanaMoldovan (3.35 in chips)
Seat 4: ironheart (4.89 in chips)
Seat 5: kanococo (0.35 in chips)
Seat 6: GRAF1111 (3.73 in chips)
Seat 7: Nodori (4.00 in chips)
kanococo: posts small blind 0.01
GRAF1111: posts big blind 0.02
*** HOLE CARDS ***
Dealt to kanococo [4h Kh]
Nodori: folds
Dozen: folds
LowLimitEnjoyer: folds
VanaMoldovan: raises 0.02 to 0.04
ironheart: folds
kanococo: raises 0.06 to 0.10
GRAF1111: folds
VanaMoldovan: calls 0.06
*** FLOP *** [Jc 7c Qd]
kanococo: checks
VanaMoldovan: checks
*** TURN *** [Jc 7c Qd] [3h]
kanococo: bets 0.12
VanaMoldovan: folds
Uncalled bet (0.12) returned to kanococo
kanococo collected 0.21 from pot
kanococo: doesn't show hand
*** SUMMARY ***
Total pot 0.22 | Rake 0.01
Board [ Jc 7c Qd 3h ]
Game ended: 2025/09/12 12:57:01 GMT
Seat 1: Dozen folded before Flop (didn't bet)
Seat 2: LowLimitEnjoyer folded before Flop (didn't bet)
Seat 3: VanaMoldovan folded on the Turn
Seat 4: ironheart (button) folded before Flop (didn't bet)
Seat 5: kanococo (small blind) collected (0.21)
Seat 6: GRAF1111 (big blind) folded before Flop
Seat 7: Nodori folded before Flop (didn't bet)

CoinPoker Hand #295671532: Hold'em No Limit (0.01/0.02 ) 2025/09/12 12:57:04 GMT
Table 'NL ₮2 V' 7-max Seat #5 is the button
Seat 1: Dozen (2.06 in chips)
Seat 2: LowLimitEnjoyer (2.10 in chips)
Seat 3: VanaMoldovan (3.25 in chips)
Seat 4: ironheart (4.89 in chips)
Seat 5: kanococo (0.46 in chips)
Seat 6: GRAF1111 (3.71 in chips)
Seat 7: Nodori (4.00 in chips)
GRAF1111: posts small blind 0.01
Nodori: posts big blind 0.02
*** HOLE CARDS ***
Dealt to kanococo [2c Jc]
Dozen: folds
LowLimitEnjoyer: folds
VanaMoldovan: raises 0.02 to 0.04
ironheart: folds
kanococo: folds
GRAF1111: raises 0.16 to 0.20
Nodori: folds
VanaMoldovan: calls 0.16
*** FLOP *** [Js 2h 7d]
GRAF1111: checks
VanaMoldovan: checks
*** TURN *** [Js 2h 7d] [7h]
GRAF1111: bets 0.18
VanaMoldovan: folds
Uncalled bet (0.18) returned to GRAF1111
GRAF1111 collected 0.40 from pot
GRAF1111: doesn't show hand
*** SUMMARY ***
Total pot 0.42 | Rake 0.02
Board [ Js 2h 7d 7h ]
Game ended: 2025/09/12 12:57:40 GMT
Seat 1: Dozen folded before Flop (didn't bet)
Seat 2: LowLimitEnjoyer folded before Flop (didn't bet)
Seat 3: VanaMoldovan folded on the Turn
Seat 4: ironheart folded before Flop (didn't bet)
Seat 5: kanococo (button) folded before Flop (didn't bet)
Seat 6: GRAF1111 (small blind) collected (0.40)
Seat 7: Nodori (big blind) folded before Flop

CoinPoker Hand #295671632: Hold'em No Limit (0.01/0.02 ) 2025/09/12 12:57:43 GMT
Table 'NL ₮2 V' 7-max Seat #6 is the button
Seat 1: Dozen (2.06 in chips)
Seat 2: LowLimitEnjoyer (2.10 in chips)
Seat 3: VanaMoldovan (3.05 in chips)
Seat 4: ironheart (4.89 in chips)
Seat 5: kanococo (0.46 in chips)
Seat 6: GRAF1111 (3.91 in chips)
Seat 7: Nodori (3.98 in chips)
Nodori: posts small blind 0.01
Dozen: posts big blind 0.02
*** HOLE CARDS ***
Dealt to kanococo [9s 9c]
LowLimitEnjoyer: folds
VanaMoldovan: raises 0.02 to 0.04
ironheart: folds
kanococo: raises 0.08 to 0.12
GRAF1111: raises 0.22 to 0.34
Nodori: folds
Dozen: folds
VanaMoldovan: folds
kanococo: raises 0.34 and is all-in
GRAF1111: calls 0.12
*** FLOP *** [7c 5d Ad]
*** TURN *** [7c 5d Ad] [7s]
*** RIVER *** [7c 5d Ad 7s] [4d]
*** SHOW DOWN ***
kanococo: shows [9s 9c] (two pairs, Nines and Sevens)
GRAF1111: shows [Ts Td] (two pairs, Tens and Sevens)
GRAF1111 collected 0.94 from pot
*** SUMMARY ***
Total pot 0.99 | Rake 0.05
Board [ 7c 5d Ad 7s 4d ]
Game ended: 2025/09/12 12:58:25 GMT
Seat 1: Dozen (big blind) folded before Flop
Seat 2: LowLimitEnjoyer folded before Flop (didn't bet)
Seat 3: VanaMoldovan folded before Flop
Seat 4: ironheart folded before Flop (didn't bet)
Seat 5: kanococo showed [9s 9c]
Seat 6: GRAF1111 (button) showed [Ts Td] and won (0.94) with two pairs, Tens and Sevens
Seat 7: Nodori (small blind) folded before Flop

CoinPoker Hand #295892187: Hold'em No Limit (0.01/0.02 ) 2025/09/12 21:24:02 GMT
Table 'NL ₮2 IV' 7-max Seat #7 is the button
Seat 1: Protonek (1.75 in chips)
Seat 2: Brandon121215 (1.71 in chips)
Seat 3: kanococo (2.00 in chips)
Seat 4: GG18vivek (3.92 in chips)
Seat 5: sh4rkw1s3 (2.12 in chips)
Seat 6: HoldBabyHold (2.09 in chips)
Seat 7: LaRochelle (2.81 in chips)
Protonek: posts small blind 0.01
Brandon121215: posts big blind 0.02
kanococo: posts big blind 0.02
*** HOLE CARDS ***
Dealt to kanococo [2h Qd]
kanococo: raises 0.02 to 0.04
GG18vivek: folds
sh4rkw1s3: folds
HoldBabyHold: folds
LaRochelle: raises 0.04 to 0.08
Protonek: folds
Brandon121215: calls 0.06
kanococo: calls 0.04
*** FLOP *** [8s 6h 3s]
Brandon121215: checks
kanococo: checks
LaRochelle: bets 0.12
Brandon121215: calls 0.12
kanococo: folds
*** TURN *** [8s 6h 3s] [Td]
Brandon121215: checks
LaRochelle: bets 0.23
Brandon121215: calls 0.23
*** RIVER *** [8s 6h 3s Td] [4c]
Brandon121215: checks
LaRochelle: checks
*** SHOW DOWN ***
Brandon121215: shows [5s Qs] (Queen high)
LaRochelle: shows [Ks Kh] (a pair of Kings)
LaRochelle collected 0.90 from pot
*** SUMMARY ***
Total pot 0.95 | Rake 0.05
Board [ 8s 6h 3s Td 4c ]
Game ended: 2025/09/12 21:24:57 GMT
Seat 1: Protonek (small blind) folded before Flop
Seat 2: Brandon121215 (big blind) showed [5s Qs]
Seat 3: kanococo folded on the Flop
Seat 4: GG18vivek folded before Flop (didn't bet)
Seat 5: sh4rkw1s3 folded before Flop (didn't bet)
Seat 6: HoldBabyHold folded before Flop (didn't bet)
Seat 7: LaRochelle (button) showed [Ks Kh] and won (0.90) with a pair of Kings

CoinPoker Hand #295892543: Hold'em No Limit (0.01/0.02 ) 2025/09/12 21:25:00 GMT
Table 'NL ₮2 IV' 7-max Seat #1 is the button
Seat 1: Protonek (1.74 in chips)
Seat 2: Brandon121215 (1.28 in chips)
Seat 3: kanococo (1.92 in chips)
Seat 4: GG18vivek (3.92 in chips)
Seat 5: sh4rkw1s3 (2.12 in chips)
Seat 6: HoldBabyHold (2.09 in chips)
Seat 7: LaRochelle (3.28 in chips)
Brandon121215: posts small blind 0.01
kanococo: posts big blind 0.02
*** HOLE CARDS ***
Dealt to kanococo [5d 9h]
GG18vivek: folds
sh4rkw1s3: raises 0.04 to 0.06
HoldBabyHold: folds
LaRochelle: folds
Protonek: calls 0.06
Brandon121215: folds
kanococo: folds
*** FLOP *** [Ad 5c Ac]
sh4rkw1s3: bets 0.04
Protonek: raises 0.04 to 0.08
sh4rkw1s3: folds
Uncalled bet (0.04) returned to Protonek
Protonek collected 0.22 from pot
Protonek: doesn't show hand
*** SUMMARY ***
Total pot 0.23 | Rake 0.01
Board [ Ad 5c Ac ]
Game ended: 2025/09/12 21:25:34 GMT
Seat 1: Protonek (button) collected (0.22)
Seat 2: Brandon121215 (small blind) folded before Flop
Seat 3: kanococo (big blind) folded before Flop
Seat 4: GG18vivek folded before Flop (didn't bet)
Seat 5: sh4rkw1s3 folded on the Flop
Seat 6: HoldBabyHold folded before Flop (didn't bet)
Seat 7: LaRochelle folded before Flop (didn't bet)

CoinPoker Hand #295892824: Hold'em No Limit (0.01/0.02 ) 2025/09/12 21:25:36 GMT
Table 'NL ₮2 IV' 7-max Seat #2 is the button
Seat 1: Protonek (1.86 in chips)
Seat 2: Brandon121215 (1.27 in chips)
Seat 3: kanococo (1.90 in chips)
Seat 4: GG18vivek (3.92 in chips)
Seat 5: sh4rkw1s3 (2.02 in chips)
Seat 6: HoldBabyHold (2.09 in chips)
Seat 7: LaRochelle (3.28 in chips)
kanococo: posts small blind 0.01
GG18vivek: posts big blind 0.02
*** HOLE CARDS ***
Dealt to kanococo [8h Kc]
sh4rkw1s3: folds
HoldBabyHold: folds
LaRochelle: folds
Protonek: calls 0.02
Brandon121215: raises 0.04 to 0.06
kanococo: calls 0.05
GG18vivek: folds
Protonek: calls 0.04
*** FLOP *** [Ad Ts Jh]
kanococo: checks
Protonek: checks
Brandon121215: checks
*** TURN *** [Ad Ts Jh] [Qc]
kanococo: bets 0.09
Protonek: raises 0.09 to 0.18
Brandon121215: folds
kanococo: raises 0.18 to 0.36
Protonek: raises 0.36 to 0.72
kanococo: raises 0.72 to 1.44
Protonek: raises 1.08 and is all-in
kanococo: calls 0.36
*** RIVER *** [Ad Ts Jh Qc] [2h]
*** SHOW DOWN ***
Protonek: shows [2s Qs] (two pairs, Queens and Twos)
kanococo: shows [8h Kc] (a straight, Ace high)
kanococo collected 3.61 from pot
*** SUMMARY ***
Total pot 3.80 | Rake 0.19
Board [ Ad Ts Jh Qc 2h ]
Game ended: 2025/09/12 21:26:27 GMT
Seat 1: Protonek showed [2s Qs]
Seat 2: Brandon121215 (button) folded on the Turn
Seat 3: kanococo (small blind) showed [8h Kc] and won (3.61) with a straight, Ace high
Seat 4: GG18vivek (big blind) folded before Flop
Seat 5: sh4rkw1s3 folded before Flop (didn't bet)
Seat 6: HoldBabyHold folded before Flop (didn't bet)
Seat 7: LaRochelle folded before Flop (didn't bet)

CoinPoker Hand #295893133: Hold'em No Limit (0.01/0.02 ) 2025/09/12 21:26:40 GMT
Table 'NL ₮2 IV' 7-max Seat #3 is the button
Seat 2: Brandon121215 (1.21 in chips)
Seat 3: kanococo (3.65 in chips)
Seat 4: GG18vivek (3.90 in chips)
Seat 5: sh4rkw1s3 (2.02 in chips)
Seat 6: HoldBabyHold (2.09 in chips)
Seat 7: LaRochelle (3.28 in chips)
GG18vivek: posts small blind 0.01
sh4rkw1s3: posts big blind 0.02
*** HOLE CARDS ***
Dealt to kanococo [Qh 2c]
HoldBabyHold: folds
LaRochelle: raises 0.05 to 0.07
Brandon121215: folds
kanococo: folds
GG18vivek: folds
sh4rkw1s3: folds
LaRochelle collected 0.10 from pot
LaRochelle: doesn't show hand
*** SUMMARY ***
Total pot 0.10 | Rake 0.00
Board [ ]
Game ended: 2025/09/12 21:27:10 GMT
Seat 2: Brandon121215 folded before Flop (didn't bet)
Seat 3: kanococo (button) folded before Flop (didn't bet)
Seat 4: GG18vivek (small blind) folded before Flop
Seat 5: sh4rkw1s3 (big blind) folded before Flop
Seat 6: HoldBabyHold folded before Flop (didn't bet)
Seat 7: LaRochelle collected (0.10)

CoinPoker Hand #295893356: Hold'em No Limit (0.01/0.02 ) 2025/09/12 21:27:12 GMT
Table 'NL ₮2 IV' 7-max Seat #4 is the button
Seat 2: Brandon121215 (1.21 in chips)
Seat 3: kanococo (3.65 in chips)
Seat 4: GG18vivek (3.89 in chips)
Seat 5: sh4rkw1s3 (2.00 in chips)
Seat 6: HoldBabyHold (2.09 in chips)
Seat 7: LaRochelle (3.31 in chips)
sh4rkw1s3: posts small blind 0.01
HoldBabyHold: posts big blind 0.02
*** HOLE CARDS ***
Dealt to kanococo [8d 9s]
LaRochelle: folds
Brandon121215: folds
kanococo: raises 0.04 to 0.06
GG18vivek: folds
sh4rkw1s3: folds
HoldBabyHold: folds
kanococo collected 0.09 from pot
kanococo: doesn't show hand
*** SUMMARY ***
Total pot 0.09 | Rake 0.00
Board [ ]
Game ended: 2025/09/12 21:27:37 GMT
Seat 2: Brandon121215 folded before Flop (didn't bet)
Seat 3: kanococo collected (0.09)
Seat 4: GG18vivek (button) folded before Flop (didn't bet)
Seat 5: sh4rkw1s3 (small blind) folded before Flop
Seat 6: HoldBabyHold (big blind) folded before Flop
Seat 7: LaRochelle folded before Flop (didn't bet)

CoinPoker Hand #295893469: Hold'em No Limit (0.01/0.02 ) 2025/09/12 21:27:39 GMT
Table 'NL ₮2 IV' 7-max Seat #5 is the button
Seat 1: ElonMucksss (0.82 in chips)
Seat 2: Brandon121215 (1.21 in chips)
Seat 3: kanococo (3.68 in chips)
Seat 4: GG18vivek (3.89 in chips)
Seat 5: sh4rkw1s3 (1.99 in chips)
Seat 6: HoldBabyHold (2.07 in chips)
Seat 7: LaRochelle (3.31 in chips)
HoldBabyHold: posts small blind 0.01
LaRochelle: posts big blind 0.02
ElonMucksss: posts big blind 0.02
*** HOLE CARDS ***
Dealt to kanococo [Ah 5h]
ElonMucksss: checks
Brandon121215: folds
kanococo: raises 0.06 to 0.08
GG18vivek: folds
sh4rkw1s3: folds
HoldBabyHold: raises 0.16 to 0.24
LaRochelle: calls 0.22
ElonMucksss: folds
kanococo: calls 0.16
*** FLOP *** [6c 3s As]
HoldBabyHold: bets 0.52
LaRochelle: calls 0.52
kanococo: calls 0.52
*** TURN *** [6c 3s As] [7d]
HoldBabyHold: bets 1.31 and is all-in
LaRochelle: raises 2.55 and is all-in
kanococo: folds
Uncalled bet (1.24) returned to LaRochelle
*** RIVER *** [6c 3s As 7d] [9c]
*** SHOW DOWN ***
LaRochelle: shows [Kd Ad] (a pair of Aces)
HoldBabyHold: shows [Ac Kc] (a pair of Aces)
LaRochelle collected 2.36 from pot
HoldBabyHold collected 2.36 from pot
*** SUMMARY ***
Total pot 4.92 | Rake 0.20
Board [ 6c 3s As 7d 9c ]
Game ended: 2025/09/12 21:28:48 GMT
Seat 1: ElonMucksss folded before Flop
Seat 2: Brandon121215 folded before Flop (didn't bet)
Seat 3: kanococo folded on the Turn
Seat 4: GG18vivek folded before Flop (didn't bet)
Seat 5: sh4rkw1s3 (button) folded before Flop (didn't bet)
Seat 6: HoldBabyHold (small blind) showed [Ac Kc] and won (2.36) with a pair of Aces
Seat 7: LaRochelle (big blind) showed [Kd Ad] and won (2.36) with a pair of Aces

CoinPoker Hand #295893936: Hold'em No Limit (0.01/0.02 ) 2025/09/12 21:28:50 GMT
Table 'NL ₮2 IV' 7-max Seat #6 is the button
Seat 1: ElonMucksss (0.80 in chips)
Seat 2: Brandon121215 (1.21 in chips)
Seat 3: kanococo (2.92 in chips)
Seat 4: GG18vivek (3.89 in chips)
Seat 5: sh4rkw1s3 (2.00 in chips)
Seat 6: HoldBabyHold (2.36 in chips)
Seat 7: LaRochelle (3.60 in chips)
LaRochelle: posts small blind 0.01
ElonMucksss: posts big blind 0.02
*** HOLE CARDS ***
Dealt to kanococo [4h 6c]
Brandon121215: folds
kanococo: folds
GG18vivek: folds
sh4rkw1s3: folds
HoldBabyHold: folds
LaRochelle: raises 0.02 to 0.04
ElonMucksss: raises 0.04 to 0.08
LaRochelle: raises 0.16 to 0.24
ElonMucksss: calls 0.16
*** FLOP *** [9c Ah Ks]
LaRochelle: checks
ElonMucksss: bets 0.56 and is all-in
LaRochelle: folds
Uncalled bet (0.56) returned to ElonMucksss
ElonMucksss collected 0.46 from pot
ElonMucksss: doesn't show hand
*** SUMMARY ***
Total pot 0.48 | Rake 0.02
Board [ 9c Ah Ks ]
Game ended: 2025/09/12 21:29:19 GMT
Seat 1: ElonMucksss (big blind) collected (0.46)
Seat 2: Brandon121215 folded before Flop (didn't bet)
Seat 3: kanococo folded before Flop (didn't bet)
Seat 4: GG18vivek folded before Flop (didn't bet)
Seat 5: sh4rkw1s3 folded before Flop (didn't bet)
Seat 6: HoldBabyHold (button) folded before Flop (didn't bet)
Seat 7: LaRochelle (small blind) folded on the Flop

CoinPoker Hand #295894033: Hold'em No Limit (0.01/0.02 ) 2025/09/12 21:29:21 GMT
Table 'NL ₮2 IV' 7-max Seat #7 is the button
Seat 1: ElonMucksss (1.02 in chips)
Seat 2: Brandon121215 (1.21 in chips)
Seat 3: kanococo (2.92 in chips)
Seat 4: GG18vivek (3.89 in chips)
Seat 5: sh4rkw1s3 (2.00 in chips)
Seat 6: HoldBabyHold (2.36 in chips)
Seat 7: LaRochelle (3.36 in chips)
ElonMucksss: posts small blind 0.01
Brandon121215: posts big blind 0.02
*** HOLE CARDS ***
Dealt to kanococo [As 5s]
kanococo: folds
GG18vivek: folds
sh4rkw1s3: folds
HoldBabyHold: folds
LaRochelle: calls 0.02
ElonMucksss: calls 0.01
Brandon121215: checks
*** FLOP *** [4h Js Kd]
ElonMucksss: bets 0.02
Brandon121215: calls 0.02
LaRochelle: folds
*** TURN *** [4h Js Kd] [6c]
ElonMucksss: bets 0.02
Brandon121215: calls 0.02
*** RIVER *** [4h Js Kd 6c] [5d]
ElonMucksss: checks
Brandon121215: checks
*** SHOW DOWN ***
ElonMucksss: shows [7h Jc] (a pair of Jacks)
Brandon121215: mucks hand
ElonMucksss collected 0.13 from pot
*** SUMMARY ***
Total pot 0.14 | Rake 0.01
Board [ 4h Js Kd 6c 5d ]
Game ended: 2025/09/12 21:30:19 GMT
Seat 1: ElonMucksss (small blind) showed [7h Jc] and won (0.13) with a pair of Jacks
Seat 2: Brandon121215 (big blind) mucked
Seat 3: kanococo folded before Flop (didn't bet)
Seat 4: GG18vivek folded before Flop (didn't bet)
Seat 5: sh4rkw1s3 folded before Flop (didn't bet)
Seat 6: HoldBabyHold folded before Flop (didn't bet)
Seat 7: LaRochelle (button) folded on the Flop

CoinPoker Hand #295894275: Hold'em No Limit (0.01/0.02 ) 2025/09/12 21:30:21 GMT
Table 'NL ₮2 IV' 7-max Seat #1 is the button
Seat 1: ElonMucksss (1.09 in chips)
Seat 2: Brandon121215 (1.15 in chips)
Seat 3: kanococo (2.92 in chips)
Seat 4: GG18vivek (3.89 in chips)
Seat 5: sh4rkw1s3 (2.00 in chips)
Seat 6: HoldBabyHold (2.36 in chips)
Seat 7: LaRochelle (3.34 in chips)
Brandon121215: posts small blind 0.01
kanococo: posts big blind 0.02
*** HOLE CARDS ***
Dealt to kanococo [2c 9s]
GG18vivek: folds
sh4rkw1s3: folds
HoldBabyHold: folds
LaRochelle: raises 0.04 to 0.06
ElonMucksss: folds
Brandon121215: calls 0.05
kanococo: calls 0.04
*** FLOP *** [Td 3s Ac]
Brandon121215: bets 0.05
kanococo: raises 0.07 to 0.12
LaRochelle: folds
Brandon121215: calls 0.07
*** TURN *** [Td 3s Ac] [7s]
Brandon121215: checks
kanococo: checks
*** RIVER *** [Td 3s Ac 7s] [Kc]
Brandon121215: checks
kanococo: checks
*** SHOW DOWN ***
Brandon121215: shows [Qs Th] (a pair of Tens)
kanococo: mucks hand
Brandon121215 collected 0.40 from pot
*** SUMMARY ***
Total pot 0.42 | Rake 0.02
Board [ Td 3s Ac 7s Kc ]
Game ended: 2025/09/12 21:31:27 GMT
Seat 1: ElonMucksss (button) folded before Flop (didn't bet)
Seat 2: Brandon121215 (small blind) showed [Qs Th] and won (0.40) with a pair of Tens
Seat 3: kanococo (big blind) mucked
Seat 4: GG18vivek folded before Flop (didn't bet)
Seat 5: sh4rkw1s3 folded before Flop (didn't bet)
Seat 6: HoldBabyHold folded before Flop (didn't bet)
Seat 7: LaRochelle folded on the Flop

CoinPoker Hand #295894800: Hold'em No Limit (0.01/0.02 ) 2025/09/12 21:31:30 GMT
Table 'NL ₮2 IV' 7-max Seat #2 is the button
Seat 1: ElonMucksss (1.09 in chips)
Seat 2: Brandon121215 (1.37 in chips)
Seat 3: kanococo (2.74 in chips)
Seat 4: GG18vivek (3.89 in chips)
Seat 5: sh4rkw1s3 (2.00 in chips)
Seat 6: HoldBabyHold (2.36 in chips)
Seat 7: LaRochelle (3.28 in chips)
kanococo: posts small blind 0.01
GG18vivek: posts big blind 0.02
*** HOLE CARDS ***
Dealt to kanococo [7c Js]
sh4rkw1s3: folds
HoldBabyHold: folds
LaRochelle: folds
ElonMucksss: raises 0.02 to 0.04
Brandon121215: calls 0.04
kanococo: calls 0.03
GG18vivek: calls 0.02
*** FLOP *** [4s Qh 7s]
kanococo: bets 0.07
GG18vivek: folds
ElonMucksss: calls 0.07
Brandon121215: raises 0.18 to 0.25
kanococo has timed out
kanococo activated time-bank (60 seconds)
kanococo: folds
ElonMucksss: calls 0.18
*** TURN *** [4s Qh 7s] [4d]
ElonMucksss: checks
Brandon121215: bets 0.22
ElonMucksss: raises 0.80 and is all-in
Brandon121215: calls 0.58
*** RIVER *** [4s Qh 7s 4d] [6h]
*** SHOW DOWN ***
ElonMucksss: shows [4c Ad] (three of kind, Fours)
Brandon121215: shows [6c Qc] (two pairs, Queens and Sixes)
ElonMucksss collected 2.21 from pot
*** SUMMARY ***
Total pot 2.33 | Rake 0.12
Board [ 4s Qh 7s 4d 6h ]
Game ended: 2025/09/12 21:33:06 GMT
Seat 1: ElonMucksss showed [4c Ad] and won (2.21) with three of kind, Fours
Seat 2: Brandon121215 (button) showed [6c Qc]
Seat 3: kanococo (small blind) folded on the Flop
Seat 4: GG18vivek (big blind) folded on the Flop
Seat 5: sh4rkw1s3 folded before Flop (didn't bet)
Seat 6: HoldBabyHold folded before Flop (didn't bet)
Seat 7: LaRochelle folded before Flop (didn't bet)

CoinPoker Hand #295895465: Hold'em No Limit (0.01/0.02 ) 2025/09/12 21:33:09 GMT
Table 'NL ₮2 IV' 7-max Seat #3 is the button
Seat 1: ElonMucksss (2.21 in chips)
Seat 3: kanococo (2.63 in chips)
Seat 4: GG18vivek (3.85 in chips)
Seat 5: sh4rkw1s3 (2.00 in chips)
Seat 6: HoldBabyHold (2.36 in chips)
Seat 7: LaRochelle (3.28 in chips)
GG18vivek: posts small blind 0.01
sh4rkw1s3: posts big blind 0.02
*** HOLE CARDS ***
Dealt to kanococo [9s Tc]
HoldBabyHold: folds
LaRochelle: raises 0.02 to 0.04
ElonMucksss: calls 0.04
kanococo: calls 0.04
GG18vivek: folds
sh4rkw1s3: folds
*** FLOP *** [3d 3s 9d]
LaRochelle: checks
ElonMucksss: checks
kanococo: bets 0.10
LaRochelle: folds
ElonMucksss: raises 0.10 to 0.20
kanococo: calls 0.10
*** TURN *** [3d 3s 9d] [Ad]
ElonMucksss: checks
kanococo: checks
*** RIVER *** [3d 3s 9d Ad] [6c]
ElonMucksss: bets 0.52
kanococo: calls 0.52
*** SHOW DOWN ***
ElonMucksss: shows [5c 3c] (three of kind, Threes)
kanococo: mucks hand
ElonMucksss collected 1.51 from pot
*** SUMMARY ***
Total pot 1.59 | Rake 0.08
Board [ 3d 3s 9d Ad 6c ]
Game ended: 2025/09/12 21:34:22 GMT
Seat 1: ElonMucksss showed [5c 3c] and won (1.51) with three of kind, Threes
Seat 3: kanococo (button) mucked
Seat 4: GG18vivek (small blind) folded before Flop
Seat 5: sh4rkw1s3 (big blind) folded before Flop
Seat 6: HoldBabyHold folded before Flop (didn't bet)
Seat 7: LaRochelle folded on the Flop

CoinPoker Hand #295896060: Hold'em No Limit (0.01/0.02 ) 2025/09/12 21:34:24 GMT
Table 'NL ₮2 IV' 7-max Seat #4 is the button
Seat 1: ElonMucksss (2.96 in chips)
Seat 3: kanococo (1.87 in chips)
Seat 4: GG18vivek (3.84 in chips)
Seat 5: sh4rkw1s3 (2.00 in chips)
Seat 6: HoldBabyHold (2.36 in chips)
Seat 7: LaRochelle (3.24 in chips)
sh4rkw1s3: posts small blind 0.01
HoldBabyHold: posts big blind 0.02
*** HOLE CARDS ***
Dealt to kanococo [Qh 3c]
LaRochelle: folds
ElonMucksss: calls 0.02
kanococo: raises 0.06 to 0.08
GG18vivek: folds
sh4rkw1s3: calls 0.07
HoldBabyHold: folds
ElonMucksss: calls 0.06
*** FLOP *** [5h 6c As]
sh4rkw1s3: checks
ElonMucksss: checks
kanococo: checks
*** TURN *** [5h 6c As] [Tc]
sh4rkw1s3: checks
ElonMucksss: bets 0.04
kanococo: raises 0.18 to 0.22
sh4rkw1s3: folds
ElonMucksss: folds
Uncalled bet (0.18) returned to kanococo
kanococo collected 0.33 from pot
kanococo: doesn't show hand
*** SUMMARY ***
Total pot 0.34 | Rake 0.01
Board [ 5h 6c As Tc ]
Game ended: 2025/09/12 21:35:16 GMT
Seat 1: ElonMucksss folded on the Turn
Seat 3: kanococo collected (0.33)
Seat 4: GG18vivek (button) folded before Flop (didn't bet)
Seat 5: sh4rkw1s3 (small blind) folded on the Turn
Seat 6: HoldBabyHold (big blind) folded before Flop
Seat 7: LaRochelle folded before Flop (didn't bet)

CoinPoker Hand #295896766: Hold'em No Limit (0.01/0.02 ) 2025/09/12 21:35:19 GMT
Table 'NL ₮2 IV' 7-max Seat #5 is the button
Seat 1: ElonMucksss (2.84 in chips)
Seat 3: kanococo (2.08 in chips)
Seat 4: GG18vivek (3.84 in chips)
Seat 5: sh4rkw1s3 (2.00 in chips)
Seat 6: HoldBabyHold (2.34 in chips)
Seat 7: LaRochelle (3.24 in chips)
HoldBabyHold: posts small blind 0.01
LaRochelle: posts big blind 0.02
*** HOLE CARDS ***
Dealt to kanococo [5s 4c]
ElonMucksss: raises 0.05 to 0.07
kanococo: folds
GG18vivek: folds
sh4rkw1s3: folds
HoldBabyHold: folds
LaRochelle: folds
ElonMucksss collected 0.10 from pot
ElonMucksss: doesn't show hand
*** SUMMARY ***
Total pot 0.10 | Rake 0.00
Board [ ]
Game ended: 2025/09/12 21:35:41 GMT
Seat 1: ElonMucksss collected (0.10)
Seat 3: kanococo folded before Flop (didn't bet)
Seat 4: GG18vivek folded before Flop (didn't bet)
Seat 5: sh4rkw1s3 (button) folded before Flop (didn't bet)
Seat 6: HoldBabyHold (small blind) folded before Flop
Seat 7: LaRochelle (big blind) folded before Flop

CoinPoker Hand #295896968: Hold'em No Limit (0.01/0.02 ) 2025/09/12 21:35:43 GMT
Table 'NL ₮2 IV' 7-max Seat #6 is the button
Seat 1: ElonMucksss (2.87 in chips)
Seat 3: kanococo (2.08 in chips)
Seat 4: GG18vivek (3.84 in chips)
Seat 5: sh4rkw1s3 (2.00 in chips)
Seat 6: HoldBabyHold (2.33 in chips)
Seat 7: LaRochelle (3.22 in chips)
LaRochelle: posts small blind 0.01
ElonMucksss: posts big blind 0.02
*** HOLE CARDS ***
Dealt to kanococo [Kd Th]
kanococo: raises 0.06 to 0.08
GG18vivek: folds
sh4rkw1s3: folds
HoldBabyHold: folds
LaRochelle: folds
ElonMucksss: folds
kanococo collected 0.11 from pot
kanococo: doesn't show hand
*** SUMMARY ***
Total pot 0.11 | Rake 0.00
Board [ ]
Game ended: 2025/09/12 21:35:59 GMT
Seat 1: ElonMucksss (big blind) folded before Flop
Seat 3: kanococo collected (0.11)
Seat 4: GG18vivek folded before Flop (didn't bet)
Seat 5: sh4rkw1s3 folded before Flop (didn't bet)
Seat 6: HoldBabyHold (button) folded before Flop (didn't bet)
Seat 7: LaRochelle (small blind) folded before Flop

CoinPoker Hand #295897033: Hold'em No Limit (0.01/0.02 ) 2025/09/12 21:36:01 GMT
Table 'NL ₮2 IV' 7-max Seat #7 is the button
Seat 1: ElonMucksss (2.85 in chips)
Seat 3: kanococo (2.11 in chips)
Seat 4: GG18vivek (3.84 in chips)
Seat 5: sh4rkw1s3 (2.00 in chips)
Seat 6: HoldBabyHold (2.33 in chips)
Seat 7: LaRochelle (3.21 in chips)
ElonMucksss: posts small blind 0.01
kanococo: posts big blind 0.02
*** HOLE CARDS ***
Dealt to kanococo [Tc 2h]
GG18vivek: folds
sh4rkw1s3: raises 0.04 to 0.06
HoldBabyHold: calls 0.06
LaRochelle: calls 0.06
ElonMucksss: folds
kanococo: calls 0.04
*** FLOP *** [8c 6s 8s]
kanococo: checks
sh4rkw1s3: checks
HoldBabyHold: checks
LaRochelle: checks
*** TURN *** [8c 6s 8s] [5s]
kanococo: checks
sh4rkw1s3: checks
HoldBabyHold: bets 0.12
LaRochelle: calls 0.12
kanococo: folds
sh4rkw1s3: folds
*** RIVER *** [8c 6s 8s 5s] [3d]
HoldBabyHold: checks
LaRochelle: checks
*** SHOW DOWN ***
HoldBabyHold: shows [7s 7h] (two pairs, Eights and Sevens)
LaRochelle: mucks hand
HoldBabyHold collected 0.47 from pot
*** SUMMARY ***
Total pot 0.49 | Rake 0.02
Board [ 8c 6s 8s 5s 3d ]
Game ended: 2025/09/12 21:36:55 GMT
Seat 1: ElonMucksss (small blind) folded before Flop
Seat 3: kanococo (big blind) folded on the Turn
Seat 4: GG18vivek folded before Flop (didn't bet)
Seat 5: sh4rkw1s3 folded on the Turn
Seat 6: HoldBabyHold showed [7s 7h] and won (0.47) with two pairs, Eights and Sevens
Seat 7: LaRochelle (button) mucked

CoinPoker Hand #295897610: Hold'em No Limit (0.01/0.02 ) 2025/09/12 21:36:57 GMT
Table 'NL ₮2 IV' 7-max Seat #1 is the button
Seat 1: ElonMucksss (2.84 in chips)
Seat 2: DrFortune (2.00 in chips)
Seat 3: kanococo (2.05 in chips)
Seat 4: GG18vivek (3.84 in chips)
Seat 5: sh4rkw1s3 (2.00 in chips)
Seat 6: HoldBabyHold (2.62 in chips)
Seat 7: LaRochelle (3.03 in chips)
kanococo: posts small blind 0.01
GG18vivek: posts big blind 0.02
DrFortune: posts big blind 0.02
*** HOLE CARDS ***
Dealt to kanococo [Ts 3h]
sh4rkw1s3: folds
HoldBabyHold: raises 0.04 to 0.06
LaRochelle: raises 0.12 to 0.18
ElonMucksss: folds
DrFortune: calls 0.16
kanococo: folds
GG18vivek: folds
HoldBabyHold: calls 0.12
*** FLOP *** [4h Ac 3s]
DrFortune: checks
HoldBabyHold: checks
LaRochelle: bets 0.27
DrFortune: calls 0.27
HoldBabyHold: raises 1.69 to 1.96
LaRochelle: folds
DrFortune: calls 1.55 and is all-in
Uncalled bet (0.14) returned to HoldBabyHold
*** TURN *** [4h Ac 3s] [Th]
*** RIVER *** [4h Ac 3s Th] [4c]
*** SHOW DOWN ***
HoldBabyHold: shows [Kc Ah] (two pairs, Aces and Fours)
DrFortune: shows [2d 6s] (a pair of Fours)
HoldBabyHold collected 4.28 from pot
*** SUMMARY ***
Total pot 4.48 | Rake 0.20
Board [ 4h Ac 3s Th 4c ]
Game ended: 2025/09/12 21:37:47 GMT
Seat 1: ElonMucksss (button) folded before Flop (didn't bet)
Seat 2: DrFortune showed [2d 6s]
Seat 3: kanococo (small blind) folded before Flop
Seat 4: GG18vivek (big blind) folded before Flop
Seat 5: sh4rkw1s3 folded before Flop (didn't bet)
Seat 6: HoldBabyHold showed [Kc Ah] and won (4.28) with two pairs, Aces and Fours
Seat 7: LaRochelle folded on the Flop

CoinPoker Hand #295897944: Hold'em No Limit (0.01/0.02 ) 2025/09/12 21:37:52 GMT
Table 'NL ₮2 IV' 7-max Seat #3 is the button
Seat 1: Ocram575 (2.00 in chips)
Seat 2: DrFortune (0.38 in chips)
Seat 3: kanococo (2.04 in chips)
Seat 4: GG18vivek (3.82 in chips)
Seat 5: sh4rkw1s3 (2.00 in chips)
Seat 6: HoldBabyHold (4.90 in chips)
Seat 7: LaRochelle (2.58 in chips)
GG18vivek: posts small blind 0.01
sh4rkw1s3: posts big blind 0.02
Ocram575: posts big blind 0.02
*** HOLE CARDS ***
Dealt to kanococo [2h Ks]
HoldBabyHold: folds
LaRochelle: raises 0.02 to 0.04
Ocram575: folds
DrFortune: raises 0.38 and is all-in
kanococo: calls 0.38
GG18vivek: folds
sh4rkw1s3: folds
LaRochelle: folds
*** FLOP *** [Kc 5s Qs]
*** TURN *** [Kc 5s Qs] [2c]
*** RIVER *** [Kc 5s Qs 2c] [Qh]
*** SHOW DOWN ***
DrFortune: shows [7d As] (a pair of Queens)
kanococo: shows [2h Ks] (two pairs, Kings and Queens)
kanococo collected 0.81 from pot
*** SUMMARY ***
Total pot 0.85 | Rake 0.04
Board [ Kc 5s Qs 2c Qh ]
Game ended: 2025/09/12 21:38:20 GMT
Seat 1: Ocram575 folded before Flop
Seat 2: DrFortune showed [7d As]
Seat 3: kanococo (button) showed [2h Ks] and won (0.81) with two pairs, Kings and Queens
Seat 4: GG18vivek (small blind) folded before Flop
Seat 5: sh4rkw1s3 (big blind) folded before Flop
Seat 6: HoldBabyHold folded before Flop (didn't bet)
Seat 7: LaRochelle folded before Flop

CoinPoker Hand #295898263: Hold'em No Limit (0.01/0.02 ) 2025/09/12 21:38:22 GMT
Table 'NL ₮2 IV' 7-max Seat #4 is the button
Seat 1: Ocram575 (1.98 in chips)
Seat 3: kanococo (2.47 in chips)
Seat 4: GG18vivek (3.81 in chips)
Seat 5: sh4rkw1s3 (2.00 in chips)
Seat 6: HoldBabyHold (4.90 in chips)
Seat 7: LaRochelle (2.54 in chips)
sh4rkw1s3: posts small blind 0.01
HoldBabyHold: posts big blind 0.02
*** HOLE CARDS ***
Dealt to kanococo [8c 7c]
LaRochelle: folds
Ocram575: folds
kanococo: folds
GG18vivek: folds
sh4rkw1s3: raises 0.04 to 0.06
HoldBabyHold: folds
sh4rkw1s3 collected 0.08 from pot
sh4rkw1s3: doesn't show hand
*** SUMMARY ***
Total pot 0.08 | Rake 0.00
Board [ ]
Game ended: 2025/09/12 21:38:51 GMT
Seat 1: Ocram575 folded before Flop (didn't bet)
Seat 3: kanococo folded before Flop (didn't bet)
Seat 4: GG18vivek (button) folded before Flop (didn't bet)
Seat 5: sh4rkw1s3 (small blind) collected (0.08)
Seat 6: HoldBabyHold (big blind) folded before Flop
Seat 7: LaRochelle folded before Flop (didn't bet)

CoinPoker Hand #295898434: Hold'em No Limit (0.01/0.02 ) 2025/09/12 21:38:54 GMT
Table 'NL ₮2 IV' 7-max Seat #5 is the button
Seat 1: Ocram575 (1.98 in chips)
Seat 3: kanococo (2.47 in chips)
Seat 4: GG18vivek (3.81 in chips)
Seat 5: sh4rkw1s3 (2.02 in chips)
Seat 6: HoldBabyHold (4.88 in chips)
Seat 7: LaRochelle (2.54 in chips)
HoldBabyHold: posts small blind 0.01
LaRochelle: posts big blind 0.02
*** HOLE CARDS ***
Dealt to kanococo [5c Kd]
Ocram575: folds
kanococo: folds
GG18vivek: folds
sh4rkw1s3: raises 0.02 to 0.04
HoldBabyHold: folds
LaRochelle: folds
sh4rkw1s3 collected 0.07 from pot
sh4rkw1s3: doesn't show hand
*** SUMMARY ***
Total pot 0.07 | Rake 0.00
Board [ ]
Game ended: 2025/09/12 21:39:12 GMT
Seat 1: Ocram575 folded before Flop (didn't bet)
Seat 3: kanococo folded before Flop (didn't bet)
Seat 4: GG18vivek folded before Flop (didn't bet)
Seat 5: sh4rkw1s3 (button) collected (0.07)
Seat 6: HoldBabyHold (small blind) folded before Flop
Seat 7: LaRochelle (big blind) folded before Flop

CoinPoker Hand #295898560: Hold'em No Limit (0.01/0.02 ) 2025/09/12 21:39:14 GMT
Table 'NL ₮2 IV' 7-max Seat #6 is the button
Seat 1: Ocram575 (1.98 in chips)
Seat 3: kanococo (2.47 in chips)
Seat 4: GG18vivek (3.81 in chips)
Seat 5: sh4rkw1s3 (2.05 in chips)
Seat 6: HoldBabyHold (4.87 in chips)
Seat 7: LaRochelle (2.52 in chips)
LaRochelle: posts small blind 0.01
Ocram575: posts big blind 0.02
*** HOLE CARDS ***
Dealt to kanococo [Kh 4s]
kanococo: folds
GG18vivek: raises 0.03 to 0.05
sh4rkw1s3: folds
HoldBabyHold: folds
LaRochelle: calls 0.04
Ocram575: folds
*** FLOP *** [Ac Td 2c]
LaRochelle: bets 0.05
GG18vivek: raises 0.13 to 0.18
LaRochelle: folds
Uncalled bet (0.13) returned to GG18vivek
GG18vivek collected 0.21 from pot
GG18vivek: doesn't show hand
*** SUMMARY ***
Total pot 0.22 | Rake 0.01
Board [ Ac Td 2c ]
Game ended: 2025/09/12 21:39:48 GMT
Seat 1: Ocram575 (big blind) folded before Flop
Seat 3: kanococo folded before Flop (didn't bet)
Seat 4: GG18vivek collected (0.21)
Seat 5: sh4rkw1s3 folded before Flop (didn't bet)
Seat 6: HoldBabyHold (button) folded before Flop (didn't bet)
Seat 7: LaRochelle (small blind) folded on the Flop

CoinPoker Hand #295898961: Hold'em No Limit (0.01/0.02 ) 2025/09/12 21:39:50 GMT
Table 'NL ₮2 IV' 7-max Seat #7 is the button
Seat 1: Ocram575 (1.96 in chips)
Seat 3: kanococo (2.47 in chips)
Seat 4: GG18vivek (3.92 in chips)
Seat 5: sh4rkw1s3 (2.05 in chips)
Seat 6: HoldBabyHold (4.87 in chips)
Seat 7: LaRochelle (2.42 in chips)
Ocram575: posts small blind 0.01
kanococo: posts big blind 0.02
*** HOLE CARDS ***
Dealt to kanococo [Jd 9c]
GG18vivek: raises 0.03 to 0.05
sh4rkw1s3: folds
HoldBabyHold: folds
LaRochelle: raises 0.10 to 0.15
Ocram575: folds
kanococo: folds
GG18vivek: raises 0.33 to 0.48
LaRochelle: calls 0.33
*** FLOP *** [5s Jc 5h]
GG18vivek: bets 0.23
LaRochelle: calls 0.23
*** TURN *** [5s Jc 5h] [8c]
GG18vivek: bets 0.69
LaRochelle: folds
Uncalled bet (0.69) returned to GG18vivek
GG18vivek collected 1.38 from pot
GG18vivek: doesn't show hand
*** SUMMARY ***
Total pot 1.45 | Rake 0.07
Board [ 5s Jc 5h 8c ]
Game ended: 2025/09/12 21:40:37 GMT
Seat 1: Ocram575 (small blind) folded before Flop
Seat 3: kanococo (big blind) folded before Flop
Seat 4: GG18vivek collected (1.38)
Seat 5: sh4rkw1s3 folded before Flop (didn't bet)
Seat 6: HoldBabyHold folded before Flop (didn't bet)
Seat 7: LaRochelle (button) folded on the Turn

CoinPoker Hand #295899368: Hold'em No Limit (0.01/0.02 ) 2025/09/12 21:40:39 GMT
Table 'NL ₮2 IV' 7-max Seat #1 is the button
Seat 1: Ocram575 (1.95 in chips)
Seat 3: kanococo (2.45 in chips)
Seat 4: GG18vivek (4.59 in chips)
Seat 5: sh4rkw1s3 (2.05 in chips)
Seat 6: HoldBabyHold (4.87 in chips)
Seat 7: LaRochelle (1.71 in chips)
kanococo: posts small blind 0.01
GG18vivek: posts big blind 0.02
*** HOLE CARDS ***
Dealt to kanococo [2h 7d]
sh4rkw1s3: folds
HoldBabyHold has timed out
HoldBabyHold activated time-bank (60 seconds)
HoldBabyHold: raises 0.04 to 0.06
LaRochelle: folds
Ocram575: folds
kanococo: folds
GG18vivek: folds
HoldBabyHold collected 0.09 from pot
HoldBabyHold: doesn't show hand
*** SUMMARY ***
Total pot 0.09 | Rake 0.00
Board [ ]
Game ended: 2025/09/12 21:41:45 GMT
Seat 1: Ocram575 (button) folded before Flop (didn't bet)
Seat 3: kanococo (small blind) folded before Flop
Seat 4: GG18vivek (big blind) folded before Flop
Seat 5: sh4rkw1s3 folded before Flop (didn't bet)
Seat 6: HoldBabyHold collected (0.09)
Seat 7: LaRochelle folded before Flop (didn't bet)

CoinPoker Hand #295899736: Hold'em No Limit (0.01/0.02 ) 2025/09/12 21:41:47 GMT
Table 'NL ₮2 IV' 7-max Seat #3 is the button
Seat 1: Ocram575 (1.95 in chips)
Seat 3: kanococo (2.44 in chips)
Seat 4: GG18vivek (4.57 in chips)
Seat 5: sh4rkw1s3 (2.05 in chips)
Seat 6: HoldBabyHold (4.90 in chips)
Seat 7: LaRochelle (1.71 in chips)
GG18vivek: posts small blind 0.01
sh4rkw1s3: posts big blind 0.02
*** HOLE CARDS ***
Dealt to kanococo [Qs 2c]
HoldBabyHold: folds
LaRochelle: raises 0.05 to 0.07
Ocram575: folds
kanococo: calls 0.07
GG18vivek: folds
sh4rkw1s3: calls 0.05
*** FLOP *** [2d Tc Kd]
sh4rkw1s3: checks
LaRochelle: checks
kanococo: bets 0.06
sh4rkw1s3: folds
LaRochelle: calls 0.06
*** TURN *** [2d Tc Kd] [3c]
LaRochelle: checks
kanococo: checks
*** RIVER *** [2d Tc Kd 3c] [5c]
LaRochelle: checks
kanococo: checks
*** SHOW DOWN ***
LaRochelle: shows [Js As] (Ace high)
kanococo: shows [Qs 2c] (a pair of Twos)
kanococo collected 0.32 from pot
*** SUMMARY ***
Total pot 0.34 | Rake 0.02
Board [ 2d Tc Kd 3c 5c ]
Game ended: 2025/09/12 21:42:35 GMT
Seat 1: Ocram575 folded before Flop (didn't bet)
Seat 3: kanococo (button) showed [Qs 2c] and won (0.32) with a pair of Twos
Seat 4: GG18vivek (small blind) folded before Flop
Seat 5: sh4rkw1s3 (big blind) folded on the Flop
Seat 6: HoldBabyHold folded before Flop (didn't bet)
Seat 7: LaRochelle showed [Js As]

CoinPoker Hand #295900094: Hold'em No Limit (0.01/0.02 ) 2025/09/12 21:42:37 GMT
Table 'NL ₮2 IV' 7-max Seat #4 is the button
Seat 1: Ocram575 (1.95 in chips)
Seat 3: kanococo (2.63 in chips)
Seat 4: GG18vivek (4.56 in chips)
Seat 5: sh4rkw1s3 (2.00 in chips)
Seat 6: HoldBabyHold (4.90 in chips)
Seat 7: LaRochelle (1.58 in chips)
sh4rkw1s3: posts small blind 0.01
HoldBabyHold: posts big blind 0.02
*** HOLE CARDS ***
Dealt to kanococo [Ac Tc]
LaRochelle: calls 0.02
Ocram575 has timed out
Ocram575 activated time-bank (60 seconds)
Ocram575: raises 0.06 to 0.08
kanococo: calls 0.08
GG18vivek: folds
sh4rkw1s3: folds
HoldBabyHold: folds
LaRochelle: calls 0.06
*** FLOP *** [7s Qh 3c]
LaRochelle: checks
Ocram575: checks
kanococo: checks
*** TURN *** [7s Qh 3c] [Qc]
LaRochelle: checks
Ocram575: bets 0.14
kanococo has timed out
kanococo activated time-bank (53 seconds)
kanococo: calls 0.14
LaRochelle: folds
*** RIVER *** [7s Qh 3c Qc] [Kc]
Ocram575: checks
kanococo: bets 2.41 and is all-in
Ocram575: folds
Uncalled bet (2.41) returned to kanococo
kanococo collected 0.52 from pot
kanococo: doesn't show hand
*** SUMMARY ***
Total pot 0.55 | Rake 0.03
Board [ 7s Qh 3c Qc Kc ]
Game ended: 2025/09/12 21:44:18 GMT
Seat 1: Ocram575 folded on the River
Seat 3: kanococo collected (0.52)
Seat 4: GG18vivek (button) folded before Flop (didn't bet)
Seat 5: sh4rkw1s3 (small blind) folded before Flop
Seat 6: HoldBabyHold (big blind) folded before Flop
Seat 7: LaRochelle folded on the Turn

CoinPoker Hand #295900850: Hold'em No Limit (0.01/0.02 ) 2025/09/12 21:44:20 GMT
Table 'NL ₮2 IV' 7-max Seat #5 is the button
Seat 1: Ocram575 (1.73 in chips)
Seat 3: kanococo (2.93 in chips)
Seat 4: GG18vivek (4.56 in chips)
Seat 5: sh4rkw1s3 (1.99 in chips)
Seat 6: HoldBabyHold (4.88 in chips)
Seat 7: LaRochelle (1.50 in chips)
HoldBabyHold: posts small blind 0.01
LaRochelle: posts big blind 0.02
*** HOLE CARDS ***
Dealt to kanococo [9h 6s]
Ocram575: folds
kanococo: folds
GG18vivek: raises 0.03 to 0.05
sh4rkw1s3: folds
HoldBabyHold: folds
LaRochelle: folds
GG18vivek collected 0.08 from pot
GG18vivek: doesn't show hand
*** SUMMARY ***
Total pot 0.08 | Rake 0.00
Board [ ]
Game ended: 2025/09/12 21:44:44 GMT
Seat 1: Ocram575 folded before Flop (didn't bet)
Seat 3: kanococo folded before Flop (didn't bet)
Seat 4: GG18vivek collected (0.08)
Seat 5: sh4rkw1s3 (button) folded before Flop (didn't bet)
Seat 6: HoldBabyHold (small blind) folded before Flop
Seat 7: LaRochelle (big blind) folded before Flop

CoinPoker Hand #295901022: Hold'em No Limit (0.01/0.02 ) 2025/09/12 21:44:47 GMT
Table 'NL ₮2 IV' 7-max Seat #6 is the button
Seat 1: Ocram575 (1.73 in chips)
Seat 3: kanococo (2.93 in chips)
Seat 4: GG18vivek (4.59 in chips)
Seat 5: sh4rkw1s3 (2.00 in chips)
Seat 6: HoldBabyHold (4.87 in chips)
Seat 7: LaRochelle (1.48 in chips)
LaRochelle: posts small blind 0.01
Ocram575: posts big blind 0.02
*** HOLE CARDS ***
Dealt to kanococo [Ac Js]
kanococo has timed out
kanococo activated time-bank (52 seconds)
kanococo: raises 0.06 to 0.08
GG18vivek: folds
sh4rkw1s3: folds
HoldBabyHold: folds
LaRochelle: folds
Ocram575: folds
kanococo collected 0.11 from pot
kanococo: doesn't show hand
*** SUMMARY ***
Total pot 0.11 | Rake 0.00
Board [ ]
Game ended: 2025/09/12 21:45:42 GMT
Seat 1: Ocram575 (big blind) folded before Flop
Seat 3: kanococo collected (0.11)
Seat 4: GG18vivek folded before Flop (didn't bet)
Seat 5: sh4rkw1s3 folded before Flop (didn't bet)
Seat 6: HoldBabyHold (button) folded before Flop (didn't bet)
Seat 7: LaRochelle (small blind) folded before Flop

CoinPoker Hand #295901489: Hold'em No Limit (0.01/0.02 ) 2025/09/12 21:45:44 GMT
Table 'NL ₮2 IV' 7-max Seat #7 is the button
Seat 1: Ocram575 (1.71 in chips)
Seat 3: kanococo (2.96 in chips)
Seat 4: GG18vivek (4.59 in chips)
Seat 5: sh4rkw1s3 (2.00 in chips)
Seat 6: HoldBabyHold (4.87 in chips)
Seat 7: LaRochelle (1.47 in chips)
Ocram575: posts small blind 0.01
kanococo: posts big blind 0.02
*** HOLE CARDS ***
Dealt to kanococo [8c 2h]
GG18vivek: raises 0.03 to 0.05
sh4rkw1s3: folds
HoldBabyHold: folds
LaRochelle: calls 0.05
Ocram575: folds
kanococo: folds
*** FLOP *** [2s Jd Kd]
GG18vivek: bets 0.06
LaRochelle: folds
Uncalled bet (0.06) returned to GG18vivek
GG18vivek collected 0.12 from pot
GG18vivek: doesn't show hand
*** SUMMARY ***
Total pot 0.13 | Rake 0.01
Board [ 2s Jd Kd ]
Game ended: 2025/09/12 21:46:22 GMT
Seat 1: Ocram575 (small blind) folded before Flop
Seat 3: kanococo (big blind) folded before Flop
Seat 4: GG18vivek collected (0.12)
Seat 5: sh4rkw1s3 folded before Flop (didn't bet)
Seat 6: HoldBabyHold folded before Flop (didn't bet)
Seat 7: LaRochelle (button) folded on the Flop

CoinPoker Hand #295901935: Hold'em No Limit (0.01/0.02 ) 2025/09/12 21:46:24 GMT
Table 'NL ₮2 IV' 7-max Seat #1 is the button
Seat 2: Alover (0.80 in chips)
Seat 3: kanococo (2.94 in chips)
Seat 4: GG18vivek (4.66 in chips)
Seat 5: sh4rkw1s3 (2.00 in chips)
Seat 6: HoldBabyHold (4.87 in chips)
Seat 7: LaRochelle (1.42 in chips)
kanococo: posts small blind 0.01
GG18vivek: posts big blind 0.02
Alover: posts big blind 0.02
*** HOLE CARDS ***
Dealt to kanococo [4h 6h]
sh4rkw1s3: folds
HoldBabyHold: folds
LaRochelle: folds
Alover: checks
kanococo: raises 0.06 to 0.08
GG18vivek: calls 0.06
Alover: calls 0.06
*** FLOP *** [8s 3d 3c]
Alover: checks
kanococo: checks
GG18vivek: checks
*** TURN *** [8s 3d 3c] [Kc]
Alover: bets 0.11
kanococo: folds
GG18vivek: folds
Uncalled bet (0.11) returned to Alover
Alover collected 0.23 from pot
Alover: doesn't show hand
*** SUMMARY ***
Total pot 0.24 | Rake 0.01
Board [ 8s 3d 3c Kc ]
Game ended: 2025/09/12 21:47:21 GMT
Seat 2: Alover collected (0.23)
Seat 3: kanococo (small blind) folded on the Turn
Seat 4: GG18vivek (big blind) folded on the Turn
Seat 5: sh4rkw1s3 folded before Flop (didn't bet)
Seat 6: HoldBabyHold folded before Flop (didn't bet)
Seat 7: LaRochelle folded before Flop (didn't bet)

CoinPoker Hand #295902272: Hold'em No Limit (0.01/0.02 ) 2025/09/12 21:47:23 GMT
Table 'NL ₮2 IV' 7-max Seat #3 is the button
Seat 2: Alover (0.95 in chips)
Seat 3: kanococo (2.86 in chips)
Seat 4: GG18vivek (4.58 in chips)
Seat 5: sh4rkw1s3 (2.00 in chips)
Seat 6: HoldBabyHold (4.87 in chips)
Seat 7: LaRochelle (1.42 in chips)
GG18vivek: posts small blind 0.01
sh4rkw1s3: posts big blind 0.02
*** HOLE CARDS ***
Dealt to kanococo [9d 4s]
HoldBabyHold: folds
LaRochelle: folds
Alover: calls 0.02
kanococo: raises 0.04 to 0.06
GG18vivek: folds
sh4rkw1s3: calls 0.04
Alover: calls 0.04
*** FLOP *** [2d 8d 7s]
sh4rkw1s3: checks
Alover: checks
kanococo: checks
*** TURN *** [2d 8d 7s] [Jd]
sh4rkw1s3: checks
Alover: bets 0.04
kanococo has timed out
kanococo activated time-bank (29 seconds)
kanococo: calls 0.04
sh4rkw1s3: folds
*** RIVER *** [2d 8d 7s Jd] [As]
Alover: bets 0.30
kanococo: folds
Uncalled bet (0.30) returned to Alover
Alover collected 0.26 from pot
Alover: doesn't show hand
*** SUMMARY ***
Total pot 0.27 | Rake 0.01
Board [ 2d 8d 7s Jd As ]
Game ended: 2025/09/12 21:48:55 GMT
Seat 2: Alover collected (0.26)
Seat 3: kanococo (button) folded on the River
Seat 4: GG18vivek (small blind) folded before Flop
Seat 5: sh4rkw1s3 (big blind) folded on the Turn
Seat 6: HoldBabyHold folded before Flop (didn't bet)
Seat 7: LaRochelle folded before Flop (didn't bet)

CoinPoker Hand #295902718: Hold'em No Limit (0.01/0.02 ) 2025/09/12 21:48:57 GMT
Table 'NL ₮2 IV' 7-max Seat #4 is the button
Seat 2: Alover (1.11 in chips)
Seat 3: kanococo (2.76 in chips)
Seat 4: GG18vivek (4.57 in chips)
Seat 5: sh4rkw1s3 (2.00 in chips)
Seat 6: HoldBabyHold (4.87 in chips)
Seat 7: LaRochelle (1.42 in chips)
sh4rkw1s3: posts small blind 0.01
HoldBabyHold: posts big blind 0.02
*** HOLE CARDS ***
Dealt to kanococo [7s 4s]
LaRochelle: folds
Alover: calls 0.02
kanococo has timed out
kanococo activated time-bank (15 seconds)
kanococo: folds
GG18vivek: folds
sh4rkw1s3: folds
HoldBabyHold: checks
*** FLOP *** [5s Jh 5d]
sh4rkw1s3 is disconnected
sh4rkw1s3 has reconnected
HoldBabyHold: checks
Alover: bets 0.02
HoldBabyHold: calls 0.02
*** TURN *** [5s Jh 5d] [5c]
HoldBabyHold: checks
Alover: checks
*** RIVER *** [5s Jh 5d 5c] [Ah]
HoldBabyHold: bets 0.11
Alover: folds
Uncalled bet (0.11) returned to HoldBabyHold
HoldBabyHold collected 0.09 from pot
HoldBabyHold: doesn't show hand
*** SUMMARY ***
Total pot 0.09 | Rake 0.00
Board [ 5s Jh 5d 5c Ah ]
Game ended: 2025/09/12 21:50:15 GMT
Seat 2: Alover folded on the River
Seat 3: kanococo folded before Flop (didn't bet)
Seat 4: GG18vivek (button) folded before Flop (didn't bet)
Seat 5: sh4rkw1s3 (small blind) folded before Flop
Seat 6: HoldBabyHold (big blind) collected (0.09)
Seat 7: LaRochelle folded before Flop (didn't bet)

CoinPoker Hand #295903257: Hold'em No Limit (0.01/0.02 ) 2025/09/12 21:50:17 GMT
Table 'NL ₮2 IV' 7-max Seat #5 is the button
Seat 1: Mibrisk (2.00 in chips)
Seat 2: Alover (1.07 in chips)
Seat 3: kanococo (2.76 in chips)
Seat 4: GG18vivek (4.57 in chips)
Seat 5: sh4rkw1s3 (1.99 in chips)
Seat 6: HoldBabyHold (4.92 in chips)
Seat 7: LaRochelle (1.42 in chips)
HoldBabyHold: posts small blind 0.01
LaRochelle: posts big blind 0.02
Mibrisk: posts big blind 0.02
*** HOLE CARDS ***
Dealt to kanococo [3d 2d]
Mibrisk: checks
Alover: calls 0.02
kanococo: folds
GG18vivek: raises 0.03 to 0.05
sh4rkw1s3: folds
HoldBabyHold: folds
LaRochelle: calls 0.03
Mibrisk: folds
Alover: calls 0.03
*** FLOP *** [5s 4s 7d]
LaRochelle: checks
Alover: checks
GG18vivek: checks
*** TURN *** [5s 4s 7d] [Qs]
LaRochelle: bets 0.02
Alover: calls 0.02
GG18vivek: calls 0.02
*** RIVER *** [5s 4s 7d Qs] [Qc]
LaRochelle: bets 0.11
Alover: folds
GG18vivek: folds
Uncalled bet (0.11) returned to LaRochelle
LaRochelle collected 0.23 from pot
LaRochelle: doesn't show hand
*** SUMMARY ***
Total pot 0.24 | Rake 0.01
Board [ 5s 4s 7d Qs Qc ]
Game ended: 2025/09/12 21:51:30 GMT
Seat 1: Mibrisk folded before Flop
Seat 2: Alover folded on the River
Seat 3: kanococo folded before Flop (didn't bet)
Seat 4: GG18vivek folded on the River
Seat 5: sh4rkw1s3 (button) folded before Flop (didn't bet)
Seat 6: HoldBabyHold (small blind) folded before Flop
Seat 7: LaRochelle (big blind) collected (0.23)

CoinPoker Hand #295903756: Hold'em No Limit (0.01/0.02 ) 2025/09/12 21:51:32 GMT
Table 'NL ₮2 IV' 7-max Seat #6 is the button
Seat 1: Mibrisk (1.98 in chips)
Seat 2: Alover (1.00 in chips)
Seat 3: kanococo (2.76 in chips)
Seat 4: GG18vivek (4.50 in chips)
Seat 5: sh4rkw1s3 (2.00 in chips)
Seat 6: HoldBabyHold (4.91 in chips)
Seat 7: LaRochelle (1.58 in chips)
LaRochelle: posts small blind 0.01
Mibrisk: posts big blind 0.02
*** HOLE CARDS ***
Dealt to kanococo [Qc 2s]
Alover: folds
kanococo: folds
GG18vivek: folds
sh4rkw1s3: folds
HoldBabyHold: raises 0.03 to 0.05
LaRochelle: folds
Mibrisk: folds
HoldBabyHold collected 0.08 from pot
HoldBabyHold: doesn't show hand
*** SUMMARY ***
Total pot 0.08 | Rake 0.00
Board [ ]
Game ended: 2025/09/12 21:52:00 GMT
Seat 1: Mibrisk (big blind) folded before Flop
Seat 2: Alover folded before Flop (didn't bet)
Seat 3: kanococo folded before Flop (didn't bet)
Seat 4: GG18vivek folded before Flop (didn't bet)
Seat 5: sh4rkw1s3 folded before Flop (didn't bet)
Seat 6: HoldBabyHold (button) collected (0.08)
Seat 7: LaRochelle (small blind) folded before Flop

CoinPoker Hand #295903925: Hold'em No Limit (0.01/0.02 ) 2025/09/12 21:52:02 GMT
Table 'NL ₮2 IV' 7-max Seat #7 is the button
Seat 1: Mibrisk (1.96 in chips)
Seat 2: GorillAA (2.00 in chips)
Seat 3: kanococo (2.76 in chips)
Seat 4: GG18vivek (4.50 in chips)
Seat 5: sh4rkw1s3 (2.00 in chips)
Seat 6: HoldBabyHold (4.94 in chips)
Seat 7: LaRochelle (1.57 in chips)
Mibrisk: posts small blind 0.01
GorillAA: posts big blind 0.02
*** HOLE CARDS ***
Dealt to kanococo [2h 3c]
kanococo: folds
GG18vivek: folds
sh4rkw1s3: folds
HoldBabyHold: folds
LaRochelle: raises 0.05 to 0.07
Mibrisk: calls 0.06
GorillAA: folds
*** FLOP *** [5d Qh 5s]
Mibrisk: checks
LaRochelle: bets 0.07
Mibrisk: raises 0.23 to 0.30
LaRochelle: folds
Uncalled bet (0.23) returned to Mibrisk
Mibrisk collected 0.29 from pot
Mibrisk: doesn't show hand
*** SUMMARY ***
Total pot 0.30 | Rake 0.01
Board [ 5d Qh 5s ]
Game ended: 2025/09/12 21:52:51 GMT
Seat 1: Mibrisk (small blind) collected (0.29)
Seat 2: GorillAA (big blind) folded before Flop
Seat 3: kanococo folded before Flop (didn't bet)
Seat 4: GG18vivek folded before Flop (didn't bet)
Seat 5: sh4rkw1s3 folded before Flop (didn't bet)
Seat 6: HoldBabyHold folded before Flop (didn't bet)
Seat 7: LaRochelle (button) folded on the Flop

CoinPoker Hand #295904277: Hold'em No Limit (0.01/0.02 ) 2025/09/12 21:52:53 GMT
Table 'NL ₮2 IV' 7-max Seat #1 is the button
Seat 1: Mibrisk (2.11 in chips)
Seat 2: GorillAA (2.00 in chips)
Seat 3: kanococo (2.76 in chips)
Seat 4: GG18vivek (4.50 in chips)
Seat 5: sh4rkw1s3 (2.00 in chips)
Seat 6: HoldBabyHold (4.94 in chips)
Seat 7: LaRochelle (1.43 in chips)
GorillAA: posts small blind 0.01
kanococo: posts big blind 0.02
*** HOLE CARDS ***
Dealt to kanococo [Td 6d]
GG18vivek: folds
sh4rkw1s3: raises 0.04 to 0.06
HoldBabyHold: folds
LaRochelle: folds
Mibrisk: folds
GorillAA: raises 0.12 to 0.18
kanococo: folds
sh4rkw1s3: calls 0.12
*** FLOP *** [8c 9c Ah]
GorillAA: checks
sh4rkw1s3: checks
*** TURN *** [8c 9c Ah] [As]
GorillAA: checks
sh4rkw1s3: checks
*** RIVER *** [8c 9c Ah As] [7c]
GorillAA: bets 0.14
sh4rkw1s3: calls 0.14
*** SHOW DOWN ***
GorillAA: shows [Ts Tc] (two pairs, Aces and Tens)
sh4rkw1s3: shows [Jh Jc] (two pairs, Aces and Jacks)
sh4rkw1s3 collected 0.63 from pot
*** SUMMARY ***
Total pot 0.66 | Rake 0.03
Board [ 8c 9c Ah As 7c ]
Game ended: 2025/09/12 21:54:05 GMT
Seat 1: Mibrisk (button) folded before Flop (didn't bet)
Seat 2: GorillAA (small blind) showed [Ts Tc]
Seat 3: kanococo (big blind) folded before Flop
Seat 4: GG18vivek folded before Flop (didn't bet)
Seat 5: sh4rkw1s3 showed [Jh Jc] and won (0.63) with two pairs, Aces and Jacks
Seat 6: HoldBabyHold folded before Flop (didn't bet)
Seat 7: LaRochelle folded before Flop (didn't bet)

CoinPoker Hand #295904632: Hold'em No Limit (0.01/0.02 ) 2025/09/12 21:54:07 GMT
Table 'NL ₮2 IV' 7-max Seat #2 is the button
Seat 1: Mibrisk (2.11 in chips)
Seat 2: GorillAA (2.00 in chips)
Seat 3: kanococo (2.74 in chips)
Seat 4: GG18vivek (4.50 in chips)
Seat 5: sh4rkw1s3 (2.31 in chips)
Seat 6: HoldBabyHold (4.94 in chips)
Seat 7: LaRochelle (1.43 in chips)
kanococo: posts small blind 0.01
GG18vivek: posts big blind 0.02
*** HOLE CARDS ***
Dealt to kanococo [Jd Ad]
sh4rkw1s3: folds
HoldBabyHold: folds
LaRochelle: folds
Mibrisk has timed out
Mibrisk activated time-bank (60 seconds)
Mibrisk: folds
GorillAA: raises 0.04 to 0.06
kanococo: raises 0.12 to 0.18
GG18vivek: folds
GorillAA: calls 0.12
*** FLOP *** [2h 5d As]
kanococo: checks
GorillAA: bets 0.18
kanococo: calls 0.18
*** TURN *** [2h 5d As] [6s]
kanococo: bets 0.40
GorillAA: folds
Uncalled bet (0.40) returned to kanococo
kanococo collected 0.70 from pot
kanococo: doesn't show hand
*** SUMMARY ***
Total pot 0.74 | Rake 0.04
Board [ 2h 5d As 6s ]
Game ended: 2025/09/12 21:55:30 GMT
Seat 1: Mibrisk folded before Flop (didn't bet)
Seat 2: GorillAA (button) folded on the Turn
Seat 3: kanococo (small blind) collected (0.70)
Seat 4: GG18vivek (big blind) folded before Flop
Seat 5: sh4rkw1s3 folded before Flop (didn't bet)
Seat 6: HoldBabyHold folded before Flop (didn't bet)
Seat 7: LaRochelle folded before Flop (didn't bet)

CoinPoker Hand #295905169: Hold'em No Limit (0.01/0.02 ) 2025/09/12 21:55:32 GMT
Table 'NL ₮2 IV' 7-max Seat #3 is the button
Seat 1: Mibrisk (2.11 in chips)
Seat 2: GorillAA (2.00 in chips)
Seat 3: kanococo (3.08 in chips)
Seat 4: GG18vivek (4.48 in chips)
Seat 5: sh4rkw1s3 (2.31 in chips)
Seat 6: HoldBabyHold (4.94 in chips)
Seat 7: LaRochelle (1.43 in chips)
GG18vivek: posts small blind 0.01
sh4rkw1s3: posts big blind 0.02
*** HOLE CARDS ***
Dealt to kanococo [9c 3c]
HoldBabyHold: raises 0.03 to 0.05
LaRochelle: raises 0.05 to 0.10
Mibrisk: folds
GorillAA: folds
kanococo: folds
GG18vivek: folds
sh4rkw1s3: calls 0.08
HoldBabyHold: calls 0.05
*** FLOP *** [Qd 5d 5c]
sh4rkw1s3: checks
HoldBabyHold: checks
LaRochelle: checks
*** TURN *** [Qd 5d 5c] [8s]
sh4rkw1s3: checks
HoldBabyHold: checks
LaRochelle: bets 0.14
sh4rkw1s3: calls 0.14
HoldBabyHold: folds
*** RIVER *** [Qd 5d 5c 8s] [Kd]
sh4rkw1s3: checks
LaRochelle: bets 0.28
sh4rkw1s3: raises 2.07 and is all-in
LaRochelle: folds
Uncalled bet (1.79) returned to sh4rkw1s3
sh4rkw1s3 collected 1.12 from pot
sh4rkw1s3: doesn't show hand
*** SUMMARY ***
Total pot 1.15 | Rake 0.03
Board [ Qd 5d 5c 8s Kd ]
Game ended: 2025/09/12 21:56:34 GMT
Seat 1: Mibrisk folded before Flop (didn't bet)
Seat 2: GorillAA folded before Flop (didn't bet)
Seat 3: kanococo (button) folded before Flop (didn't bet)
Seat 4: GG18vivek (small blind) folded before Flop
Seat 5: sh4rkw1s3 (big blind) collected (1.12)
Seat 6: HoldBabyHold folded on the Turn
Seat 7: LaRochelle folded on the River

CoinPoker Hand #295905602: Hold'em No Limit (0.01/0.02 ) 2025/09/12 21:56:37 GMT
Table 'NL ₮2 IV' 7-max Seat #4 is the button
Seat 1: Mibrisk (2.11 in chips)
Seat 2: GorillAA (2.00 in chips)
Seat 3: kanococo (3.08 in chips)
Seat 4: GG18vivek (4.47 in chips)
Seat 5: sh4rkw1s3 (2.91 in chips)
Seat 6: HoldBabyHold (4.84 in chips)
Seat 7: LaRochelle (0.91 in chips)
sh4rkw1s3: posts small blind 0.01
HoldBabyHold: posts big blind 0.02
*** HOLE CARDS ***
Dealt to kanococo [2c 7c]
LaRochelle: folds
Mibrisk: folds
GorillAA: folds
kanococo: folds
GG18vivek: folds
sh4rkw1s3: folds
HoldBabyHold collected 0.03 from pot
HoldBabyHold: doesn't show hand
*** SUMMARY ***
Total pot 0.03 | Rake 0.00
Board [ ]
Game ended: 2025/09/12 21:56:54 GMT
Seat 1: Mibrisk folded before Flop (didn't bet)
Seat 2: GorillAA folded before Flop (didn't bet)
Seat 3: kanococo folded before Flop (didn't bet)
Seat 4: GG18vivek (button) folded before Flop (didn't bet)
Seat 5: sh4rkw1s3 (small blind) folded before Flop
Seat 6: HoldBabyHold (big blind) collected (0.03)
Seat 7: LaRochelle folded before Flop (didn't bet)

CoinPoker Hand #295905739: Hold'em No Limit (0.01/0.02 ) 2025/09/12 21:56:57 GMT
Table 'NL ₮2 IV' 7-max Seat #5 is the button
Seat 1: Mibrisk (2.11 in chips)
Seat 2: GorillAA (2.00 in chips)
Seat 3: kanococo (3.08 in chips)
Seat 4: GG18vivek (4.47 in chips)
Seat 5: sh4rkw1s3 (2.90 in chips)
Seat 6: HoldBabyHold (4.85 in chips)
Seat 7: LaRochelle (0.91 in chips)
HoldBabyHold: posts small blind 0.01
LaRochelle: posts big blind 0.02
*** HOLE CARDS ***
Dealt to kanococo [Ts 7s]
Mibrisk: folds
GorillAA: folds
kanococo: folds
GG18vivek: folds
sh4rkw1s3: folds
HoldBabyHold: raises 0.05 to 0.07
LaRochelle: folds
HoldBabyHold collected 0.09 from pot
HoldBabyHold: doesn't show hand
*** SUMMARY ***
Total pot 0.09 | Rake 0.00
Board [ ]
Game ended: 2025/09/12 21:57:18 GMT
Seat 1: Mibrisk folded before Flop (didn't bet)
Seat 2: GorillAA folded before Flop (didn't bet)
Seat 3: kanococo folded before Flop (didn't bet)
Seat 4: GG18vivek folded before Flop (didn't bet)
Seat 5: sh4rkw1s3 (button) folded before Flop (didn't bet)
Seat 6: HoldBabyHold (small blind) collected (0.09)
Seat 7: LaRochelle (big blind) folded before Flop

CoinPoker Hand #295905818: Hold'em No Limit (0.01/0.02 ) 2025/09/12 21:57:20 GMT
Table 'NL ₮2 IV' 7-max Seat #6 is the button
Seat 1: Mibrisk (2.11 in chips)
Seat 2: GorillAA (2.00 in chips)
Seat 3: kanococo (3.08 in chips)
Seat 4: GG18vivek (4.47 in chips)
Seat 5: sh4rkw1s3 (2.90 in chips)
Seat 6: HoldBabyHold (4.87 in chips)
Seat 7: LaRochelle (0.89 in chips)
LaRochelle: posts small blind 0.01
Mibrisk: posts big blind 0.02
*** HOLE CARDS ***
Dealt to kanococo [Ks Qs]
GorillAA: folds
kanococo: raises 0.06 to 0.08
GG18vivek: folds
sh4rkw1s3: folds
HoldBabyHold: folds
LaRochelle: calls 0.07
Mibrisk: folds
*** FLOP *** [6c Th 6s]
LaRochelle: checks
kanococo: checks
*** TURN *** [6c Th 6s] [Js]
LaRochelle: checks
kanococo: checks
*** RIVER *** [6c Th 6s Js] [7h]
LaRochelle: checks
kanococo: checks
*** SHOW DOWN ***
LaRochelle: shows [Qh Ah] (a pair of Sixes)
kanococo: mucks hand
LaRochelle collected 0.17 from pot
*** SUMMARY ***
Total pot 0.18 | Rake 0.01
Board [ 6c Th 6s Js 7h ]
Game ended: 2025/09/12 21:58:02 GMT
Seat 1: Mibrisk (big blind) folded before Flop
Seat 2: GorillAA folded before Flop (didn't bet)
Seat 3: kanococo mucked
Seat 4: GG18vivek folded before Flop (didn't bet)
Seat 5: sh4rkw1s3 folded before Flop (didn't bet)
Seat 6: HoldBabyHold (button) folded before Flop (didn't bet)
Seat 7: LaRochelle (small blind) showed [Qh Ah] and won (0.17) with a pair of Sixes

CoinPoker Hand #295905928: Hold'em No Limit (0.01/0.02 ) 2025/09/12 21:58:04 GMT
Table 'NL ₮2 IV' 7-max Seat #7 is the button
Seat 1: Mibrisk (2.09 in chips)
Seat 2: GorillAA (2.00 in chips)
Seat 3: kanococo (3.00 in chips)
Seat 4: GG18vivek (4.47 in chips)
Seat 5: sh4rkw1s3 (2.90 in chips)
Seat 6: HoldBabyHold (4.87 in chips)
Seat 7: LaRochelle (0.98 in chips)
Mibrisk: posts small blind 0.01
GorillAA: posts big blind 0.02
*** HOLE CARDS ***
Dealt to kanococo [3d Jh]
kanococo: folds
GG18vivek: raises 0.03 to 0.05
sh4rkw1s3: folds
HoldBabyHold: folds
LaRochelle: folds
Mibrisk has timed out
Mibrisk activated time-bank (55 seconds)
Mibrisk: folds
GorillAA: folds
GG18vivek collected 0.08 from pot
GG18vivek: doesn't show hand
*** SUMMARY ***
Total pot 0.08 | Rake 0.00
Board [ ]
Game ended: 2025/09/12 21:58:40 GMT
Seat 1: Mibrisk (small blind) folded before Flop
Seat 2: GorillAA (big blind) folded before Flop
Seat 3: kanococo folded before Flop (didn't bet)
Seat 4: GG18vivek collected (0.08)
Seat 5: sh4rkw1s3 folded before Flop (didn't bet)
Seat 6: HoldBabyHold folded before Flop (didn't bet)
Seat 7: LaRochelle (button) folded before Flop (didn't bet)

CoinPoker Hand #296101653: Hold'em No Limit (0.01/0.02 ) 2025/09/13 12:27:24 GMT
Table 'NL ₮2 III' 7-max Seat #6 is the button
Seat 1: sabri (6.50 in chips)
Seat 2: shrimptesticles (1.97 in chips)
Seat 3: warmachine (1.70 in chips)
Seat 4: Crypppoker (2.64 in chips)
Seat 5: kanococo (2.00 in chips)
Seat 6: Misiao (2.00 in chips)
Seat 7: R1S3ND3V1L (1.96 in chips)
R1S3ND3V1L: posts small blind 0.01
sabri: posts big blind 0.02
kanococo: posts big blind 0.02
*** HOLE CARDS ***
Dealt to kanococo [8c 6d]
shrimptesticles: raises 0.06 to 0.08
warmachine: calls 0.08
Crypppoker: raises 2.64 and is all-in
kanococo: folds
Misiao: folds
R1S3ND3V1L: folds
sabri: folds
shrimptesticles: folds
warmachine: folds
Crypppoker collected 2.85 from pot
Crypppoker: doesn't show hand
*** SUMMARY ***
Total pot 2.85 | Rake 0.00
Board [ ]
Game ended: 2025/09/13 12:27:57 GMT
Seat 1: sabri (big blind) folded before Flop
Seat 2: shrimptesticles folded before Flop
Seat 3: warmachine folded before Flop
Seat 4: Crypppoker collected (2.85)
Seat 5: kanococo folded before Flop
Seat 6: Misiao (button) folded before Flop (didn't bet)
Seat 7: R1S3ND3V1L (small blind) folded before Flop

CoinPoker Hand #296101863: Hold'em No Limit (0.01/0.02 ) 2025/09/13 12:28:00 GMT
Table 'NL ₮2 III' 7-max Seat #7 is the button
Seat 1: sabri (6.48 in chips)
Seat 2: shrimptesticles (1.89 in chips)
Seat 3: warmachine (1.62 in chips)
Seat 4: Crypppoker (2.85 in chips)
Seat 5: kanococo (1.98 in chips)
Seat 6: Misiao (2.00 in chips)
Seat 7: R1S3ND3V1L (1.95 in chips)
sabri: posts small blind 0.01
shrimptesticles: posts big blind 0.02
warmachine: posts straddle 0.04
*** HOLE CARDS ***
Dealt to kanococo [6c Qh]
Crypppoker: calls 0.04
kanococo: folds
Misiao: folds
R1S3ND3V1L: folds
sabri: folds
shrimptesticles: folds
warmachine: checks
*** FLOP *** [2h 4d 5c]
warmachine: checks
Crypppoker: bets 0.10
warmachine: calls 0.10
*** TURN *** [2h 4d 5c] [Ac]
warmachine: bets 0.29
Crypppoker: calls 0.29
*** RIVER *** [2h 4d 5c Ac] [Th]
warmachine: bets 1.19 and is all-in
Crypppoker: folds
Uncalled bet (1.19) returned to warmachine
warmachine collected 0.85 from pot
warmachine: doesn't show hand
*** SUMMARY ***
Total pot 0.89 | Rake 0.04
Board [ 2h 4d 5c Ac Th ]
Game ended: 2025/09/13 12:29:10 GMT
Seat 1: sabri (small blind) folded before Flop
Seat 2: shrimptesticles (big blind) folded before Flop
Seat 3: warmachine (straddle) collected (0.85)
Seat 4: Crypppoker folded on the River
Seat 5: kanococo folded before Flop (didn't bet)
Seat 6: Misiao folded before Flop (didn't bet)
Seat 7: R1S3ND3V1L (button) folded before Flop (didn't bet)

CoinPoker Hand #296102168: Hold'em No Limit (0.01/0.02 ) 2025/09/13 12:29:12 GMT
Table 'NL ₮2 III' 7-max Seat #1 is the button
Seat 1: sabri (6.47 in chips)
Seat 2: shrimptesticles (1.87 in chips)
Seat 3: warmachine (2.04 in chips)
Seat 4: Crypppoker (2.42 in chips)
Seat 5: kanococo (1.98 in chips)
Seat 6: Misiao (2.00 in chips)
Seat 7: R1S3ND3V1L (1.95 in chips)
shrimptesticles: posts small blind 0.01
warmachine: posts big blind 0.02
*** HOLE CARDS ***
Dealt to kanococo [8s Js]
Crypppoker: raises 0.04 to 0.06
kanococo: folds
Misiao: folds
R1S3ND3V1L: folds
sabri: calls 0.06
shrimptesticles: folds
warmachine: folds
*** FLOP *** [Jc 6c Ks]
Crypppoker: checks
sabri: checks
*** TURN *** [Jc 6c Ks] [5d]
Crypppoker: bets 0.14
sabri: raises 0.42 to 0.56
Crypppoker: folds
Uncalled bet (0.42) returned to sabri
sabri collected 0.42 from pot
sabri: doesn't show hand
*** SUMMARY ***
Total pot 0.43 | Rake 0.01
Board [ Jc 6c Ks 5d ]
Game ended: 2025/09/13 12:30:13 GMT
Seat 1: sabri (button) collected (0.42)
Seat 2: shrimptesticles (small blind) folded before Flop
Seat 3: warmachine (big blind) folded before Flop
Seat 4: Crypppoker folded on the Turn
Seat 5: kanococo folded before Flop (didn't bet)
Seat 6: Misiao folded before Flop (didn't bet)
Seat 7: R1S3ND3V1L folded before Flop (didn't bet)

CoinPoker Hand #296102454: Hold'em No Limit (0.01/0.02 ) 2025/09/13 12:30:16 GMT
Table 'NL ₮2 III' 7-max Seat #2 is the button
Seat 1: sabri (6.69 in chips)
Seat 2: shrimptesticles (1.86 in chips)
Seat 4: Crypppoker (2.22 in chips)
Seat 5: kanococo (1.98 in chips)
Seat 6: Misiao (2.00 in chips)
Seat 7: R1S3ND3V1L (1.95 in chips)
Crypppoker: posts small blind 0.01
kanococo: posts big blind 0.02
*** HOLE CARDS ***
Dealt to kanococo [7d 6d]
Misiao: folds
R1S3ND3V1L: raises 0.04 to 0.06
sabri: calls 0.06
shrimptesticles: folds
Crypppoker: folds
kanococo: calls 0.04
*** FLOP *** [Th 2c 2h]
kanococo: checks
R1S3ND3V1L: bets 0.12
sabri: folds
kanococo: folds
Uncalled bet (0.12) returned to R1S3ND3V1L
R1S3ND3V1L collected 0.18 from pot
R1S3ND3V1L: doesn't show hand
*** SUMMARY ***
Total pot 0.19 | Rake 0.01
Board [ Th 2c 2h ]
Game ended: 2025/09/13 12:31:08 GMT
Seat 1: sabri folded on the Flop
Seat 2: shrimptesticles (button) folded before Flop (didn't bet)
Seat 4: Crypppoker (small blind) folded before Flop
Seat 5: kanococo (big blind) folded on the Flop
Seat 6: Misiao folded before Flop (didn't bet)
Seat 7: R1S3ND3V1L collected (0.18)

CoinPoker Hand #296102727: Hold'em No Limit (0.01/0.02 ) 2025/09/13 12:31:11 GMT
Table 'NL ₮2 III' 7-max Seat #4 is the button
Seat 1: sabri (6.63 in chips)
Seat 2: shrimptesticles (1.86 in chips)
Seat 4: Crypppoker (2.21 in chips)
Seat 5: kanococo (1.92 in chips)
Seat 6: Misiao (2.00 in chips)
Seat 7: R1S3ND3V1L (2.07 in chips)
kanococo: posts small blind 0.01
Misiao: posts big blind 0.02
*** HOLE CARDS ***
Dealt to kanococo [2h 2s]
R1S3ND3V1L: folds
sabri: raises 0.04 to 0.06
shrimptesticles: folds
Crypppoker: raises 0.14 to 0.20
kanococo: calls 0.19
Misiao: folds
sabri: calls 0.14
*** FLOP *** [Qd 7c Ks]
kanococo: checks
sabri: checks
Crypppoker: checks
*** TURN *** [Qd 7c Ks] [Kd]
kanococo: checks
sabri: checks
Crypppoker: bets 0.61
kanococo: folds
sabri: folds
Uncalled bet (0.61) returned to Crypppoker
Crypppoker collected 0.59 from pot
Crypppoker: doesn't show hand
*** SUMMARY ***
Total pot 0.62 | Rake 0.03
Board [ Qd 7c Ks Kd ]
Game ended: 2025/09/13 12:32:22 GMT
Seat 1: sabri folded on the Turn
Seat 2: shrimptesticles folded before Flop (didn't bet)
Seat 4: Crypppoker (button) collected (0.59)
Seat 5: kanococo (small blind) folded on the Turn
Seat 6: Misiao (big blind) folded before Flop
Seat 7: R1S3ND3V1L folded before Flop (didn't bet)

CoinPoker Hand #296103070: Hold'em No Limit (0.01/0.02 ) 2025/09/13 12:32:24 GMT
Table 'NL ₮2 III' 7-max Seat #5 is the button
Seat 1: sabri (6.43 in chips)
Seat 2: shrimptesticles (1.86 in chips)
Seat 4: Crypppoker (2.60 in chips)
Seat 5: kanococo (1.72 in chips)
Seat 6: Misiao (1.98 in chips)
Seat 7: R1S3ND3V1L (2.07 in chips)
Misiao: posts small blind 0.01
R1S3ND3V1L: posts big blind 0.02
*** HOLE CARDS ***
Dealt to kanococo [5h 9h]
sabri: raises 0.04 to 0.06
shrimptesticles has timed out
shrimptesticles activated time-bank (60 seconds)
shrimptesticles: folds
Crypppoker: calls 0.06
kanococo: folds
Misiao: folds
R1S3ND3V1L: folds
*** FLOP *** [Kh Ah Ac]
sabri: checks
Crypppoker: bets 0.14
sabri: folds
Uncalled bet (0.14) returned to Crypppoker
Crypppoker collected 0.14 from pot
Crypppoker: doesn't show hand
*** SUMMARY ***
Total pot 0.15 | Rake 0.01
Board [ Kh Ah Ac ]
Game ended: 2025/09/13 12:33:38 GMT
Seat 1: sabri folded on the Flop
Seat 2: shrimptesticles folded before Flop (didn't bet)
Seat 4: Crypppoker collected (0.14)
Seat 5: kanococo (button) folded before Flop (didn't bet)
Seat 6: Misiao (small blind) folded before Flop
Seat 7: R1S3ND3V1L (big blind) folded before Flop

CoinPoker Hand #296103449: Hold'em No Limit (0.01/0.02 ) 2025/09/13 12:33:40 GMT
Table 'NL ₮2 III' 7-max Seat #6 is the button
Seat 1: sabri (6.37 in chips)
Seat 2: shrimptesticles (1.86 in chips)
Seat 3: GannibalElectro (2.00 in chips)
Seat 4: Crypppoker (2.68 in chips)
Seat 5: kanococo (1.72 in chips)
Seat 6: Misiao (1.99 in chips)
Seat 7: R1S3ND3V1L (2.05 in chips)
R1S3ND3V1L: posts small blind 0.01
sabri: posts big blind 0.02
GannibalElectro: posts big blind 0.02
*** HOLE CARDS ***
Dealt to kanococo [4c 3s]
shrimptesticles: folds
GannibalElectro: checks
Crypppoker: raises 0.04 to 0.06
kanococo: folds
Misiao: calls 0.06
R1S3ND3V1L: calls 0.05
sabri: calls 0.04
GannibalElectro: folds
*** FLOP *** [2d Tc 8d]
R1S3ND3V1L: bets 0.12
sabri: folds
Crypppoker: folds
Misiao: folds
Uncalled bet (0.12) returned to R1S3ND3V1L
R1S3ND3V1L collected 0.25 from pot
R1S3ND3V1L: doesn't show hand
*** SUMMARY ***
Total pot 0.26 | Rake 0.01
Board [ 2d Tc 8d ]
Game ended: 2025/09/13 12:34:29 GMT
Seat 1: sabri (big blind) folded on the Flop
Seat 2: shrimptesticles folded before Flop (didn't bet)
Seat 3: GannibalElectro folded before Flop
Seat 4: Crypppoker folded on the Flop
Seat 5: kanococo folded before Flop (didn't bet)
Seat 6: Misiao (button) folded on the Flop
Seat 7: R1S3ND3V1L (small blind) collected (0.25)

CoinPoker Hand #296103681: Hold'em No Limit (0.01/0.02 ) 2025/09/13 12:34:31 GMT
Table 'NL ₮2 III' 7-max Seat #7 is the button
Seat 1: sabri (6.31 in chips)
Seat 2: shrimptesticles (1.86 in chips)
Seat 3: GannibalElectro (1.98 in chips)
Seat 4: Crypppoker (2.62 in chips)
Seat 5: kanococo (1.72 in chips)
Seat 6: Misiao (2.00 in chips)
Seat 7: R1S3ND3V1L (2.24 in chips)
sabri: posts small blind 0.01
shrimptesticles: posts big blind 0.02
*** HOLE CARDS ***
Dealt to kanococo [5c Ts]
GannibalElectro: folds
Crypppoker: raises 0.04 to 0.06
kanococo: folds
Misiao: folds
R1S3ND3V1L: folds
sabri: folds
shrimptesticles: calls 0.04
*** FLOP *** [Td 5h 5d]
shrimptesticles: checks
Crypppoker: bets 0.12
shrimptesticles: folds
Uncalled bet (0.12) returned to Crypppoker
Crypppoker collected 0.12 from pot
Crypppoker: doesn't show hand
sabri is disconnected
*** SUMMARY ***
Total pot 0.13 | Rake 0.01
Board [ Td 5h 5d ]
Game ended: 2025/09/13 12:35:20 GMT
Seat 1: sabri (small blind) folded before Flop
Seat 2: shrimptesticles (big blind) folded on the Flop
Seat 3: GannibalElectro folded before Flop (didn't bet)
Seat 4: Crypppoker collected (0.12)
Seat 5: kanococo folded before Flop (didn't bet)
Seat 6: Misiao folded before Flop (didn't bet)
Seat 7: R1S3ND3V1L (button) folded before Flop (didn't bet)

CoinPoker Hand #296104022: Hold'em No Limit (0.01/0.02 ) 2025/09/13 12:35:22 GMT
Table 'NL ₮2 III' 7-max Seat #1 is the button
Seat 1: sabri (6.30 in chips) is sitting out
Seat 2: shrimptesticles (1.80 in chips)
Seat 3: GannibalElectro (1.98 in chips)
Seat 4: Crypppoker (2.68 in chips)
Seat 5: kanococo (1.72 in chips)
Seat 6: Misiao (2.00 in chips)
Seat 7: R1S3ND3V1L (2.24 in chips)
shrimptesticles: posts small blind 0.01
GannibalElectro: posts big blind 0.02
*** HOLE CARDS ***
Dealt to kanococo [5c 9c]
sabri has reconnected
Crypppoker: raises 0.04 to 0.06
kanococo: folds
Misiao: folds
R1S3ND3V1L: raises 0.12 to 0.18
shrimptesticles: folds
GannibalElectro: folds
Crypppoker: folds
R1S3ND3V1L collected 0.27 from pot
R1S3ND3V1L: doesn't show hand
*** SUMMARY ***
Total pot 0.27 | Rake 0.00
Board [ ]
Game ended: 2025/09/13 12:35:54 GMT
Seat 1: sabri (button) folded before Flop (didn't bet)
Seat 2: shrimptesticles (small blind) folded before Flop
Seat 3: GannibalElectro (big blind) folded before Flop
Seat 4: Crypppoker folded before Flop
Seat 5: kanococo folded before Flop (didn't bet)
Seat 6: Misiao folded before Flop (didn't bet)
Seat 7: R1S3ND3V1L collected (0.27)

CoinPoker Hand #296104190: Hold'em No Limit (0.01/0.02 ) 2025/09/13 12:35:56 GMT
Table 'NL ₮2 III' 7-max Seat #2 is the button
Seat 1: sabri (6.30 in chips)
Seat 2: shrimptesticles (1.79 in chips)
Seat 3: GannibalElectro (1.98 in chips)
Seat 4: Crypppoker (2.62 in chips)
Seat 5: kanococo (1.72 in chips)
Seat 6: Misiao (2.00 in chips)
Seat 7: R1S3ND3V1L (2.33 in chips)
GannibalElectro: posts small blind 0.01
Crypppoker: posts big blind 0.02
*** HOLE CARDS ***
Dealt to kanococo [Ts As]
kanococo: raises 0.06 to 0.08
Misiao: folds
R1S3ND3V1L: calls 0.08
sabri: folds
shrimptesticles: folds
GannibalElectro: folds
Crypppoker: folds
*** FLOP *** [9h 3h 7h]
kanococo: bets 0.06
R1S3ND3V1L: calls 0.06
*** TURN *** [9h 3h 7h] [7d]
kanococo: checks
R1S3ND3V1L: bets 0.20
kanococo: folds
Uncalled bet (0.20) returned to R1S3ND3V1L
R1S3ND3V1L collected 0.29 from pot
R1S3ND3V1L: doesn't show hand
*** SUMMARY ***
Total pot 0.31 | Rake 0.02
Board [ 9h 3h 7h 7d ]
Game ended: 2025/09/13 12:36:49 GMT
Seat 1: sabri folded before Flop (didn't bet)
Seat 2: shrimptesticles (button) folded before Flop (didn't bet)
Seat 3: GannibalElectro (small blind) folded before Flop
Seat 4: Crypppoker (big blind) folded before Flop
Seat 5: kanococo folded on the Turn
Seat 6: Misiao folded before Flop (didn't bet)
Seat 7: R1S3ND3V1L collected (0.29)

CoinPoker Hand #296104471: Hold'em No Limit (0.01/0.02 ) 2025/09/13 12:36:51 GMT
Table 'NL ₮2 III' 7-max Seat #3 is the button
Seat 1: sabri (6.30 in chips)
Seat 2: shrimptesticles (1.79 in chips)
Seat 3: GannibalElectro (2.00 in chips)
Seat 4: Crypppoker (2.60 in chips)
Seat 5: kanococo (1.58 in chips)
Seat 6: Misiao (2.00 in chips)
Seat 7: R1S3ND3V1L (2.48 in chips)
Crypppoker: posts small blind 0.01
kanococo: posts big blind 0.02
*** HOLE CARDS ***
Dealt to kanococo [5c 4s]
Misiao: raises 0.02 to 0.04
R1S3ND3V1L: folds
sabri: folds
shrimptesticles: folds
GannibalElectro: raises 0.12 to 0.16
Crypppoker: raises 2.59 and is all-in
kanococo: folds
Misiao: folds
GannibalElectro: calls 1.84 and is all-in
Uncalled bet (0.60) returned to Crypppoker
*** FLOP *** [Kh Js 7d]
*** TURN *** [Kh Js 7d] [Qs]
*** RIVER *** [Kh Js 7d Qs] [6c]
*** SHOW DOWN ***
Crypppoker: shows [2s 3c] (King high)
GannibalElectro: shows [Kd Kc] (three of kind, Kings)
GannibalElectro collected 3.86 from pot
*** SUMMARY ***
Total pot 4.06 | Rake 0.20
Board [ Kh Js 7d Qs 6c ]
Game ended: 2025/09/13 12:37:38 GMT
Seat 1: sabri folded before Flop (didn't bet)
Seat 2: shrimptesticles folded before Flop (didn't bet)
Seat 3: GannibalElectro (button) showed [Kd Kc] and won (3.86) with three of kind, Kings
Seat 4: Crypppoker (small blind) showed [2s 3c]
Seat 5: kanococo (big blind) folded before Flop
Seat 6: Misiao folded before Flop
Seat 7: R1S3ND3V1L folded before Flop (didn't bet)

CoinPoker Hand #296104696: Hold'em No Limit (0.01/0.02 ) 2025/09/13 12:37:40 GMT
Table 'NL ₮2 III' 7-max Seat #4 is the button
Seat 1: sabri (6.30 in chips)
Seat 2: shrimptesticles (1.79 in chips)
Seat 3: GannibalElectro (3.86 in chips)
Seat 4: Crypppoker (2.00 in chips)
Seat 5: kanococo (1.56 in chips)
Seat 6: Misiao (1.96 in chips)
Seat 7: R1S3ND3V1L (2.48 in chips)
kanococo: posts small blind 0.01
Misiao: posts big blind 0.02
*** HOLE CARDS ***
Dealt to kanococo [8s Qh]
R1S3ND3V1L: folds
sabri: folds
shrimptesticles: folds
GannibalElectro: folds
Crypppoker: folds
kanococo: raises 0.06 to 0.08
Misiao: folds
kanococo collected 0.10 from pot
kanococo: doesn't show hand
*** SUMMARY ***
Total pot 0.10 | Rake 0.00
Board [ ]
Game ended: 2025/09/13 12:38:05 GMT
Seat 1: sabri folded before Flop (didn't bet)
Seat 2: shrimptesticles folded before Flop (didn't bet)
Seat 3: GannibalElectro folded before Flop (didn't bet)
Seat 4: Crypppoker (button) folded before Flop (didn't bet)
Seat 5: kanococo (small blind) collected (0.10)
Seat 6: Misiao (big blind) folded before Flop
Seat 7: R1S3ND3V1L folded before Flop (didn't bet)

CoinPoker Hand #296104823: Hold'em No Limit (0.01/0.02 ) 2025/09/13 12:38:07 GMT
Table 'NL ₮2 III' 7-max Seat #5 is the button
Seat 1: sabri (6.30 in chips)
Seat 2: shrimptesticles (1.79 in chips)
Seat 3: GannibalElectro (3.86 in chips)
Seat 4: Crypppoker (2.00 in chips)
Seat 5: kanococo (1.58 in chips)
Seat 6: Misiao (2.00 in chips)
Seat 7: R1S3ND3V1L (2.48 in chips)
Misiao: posts small blind 0.01
R1S3ND3V1L: posts big blind 0.02
*** HOLE CARDS ***
Dealt to kanococo [2c Kc]
sabri: folds
shrimptesticles: raises 0.04 to 0.06
GannibalElectro: folds
Crypppoker: folds
kanococo has timed out
kanococo activated time-bank (60 seconds)
kanococo: calls 0.06
Misiao: folds
R1S3ND3V1L: folds
*** FLOP *** [Jc Th 4c]
shrimptesticles: checks
kanococo: checks
*** TURN *** [Jc Th 4c] [3d]
shrimptesticles: bets 0.05
kanococo: calls 0.05
*** RIVER *** [Jc Th 4c 3d] [4d]
shrimptesticles: checks
kanococo: bets 0.82
shrimptesticles: folds
Uncalled bet (0.82) returned to kanococo
kanococo collected 0.24 from pot
kanococo: doesn't show hand
*** SUMMARY ***
Total pot 0.25 | Rake 0.01
Board [ Jc Th 4c 3d 4d ]
Game ended: 2025/09/13 12:39:24 GMT
Seat 1: sabri folded before Flop (didn't bet)
Seat 2: shrimptesticles folded on the River
Seat 3: GannibalElectro folded before Flop (didn't bet)
Seat 4: Crypppoker folded before Flop (didn't bet)
Seat 5: kanococo (button) collected (0.24)
Seat 6: Misiao (small blind) folded before Flop
Seat 7: R1S3ND3V1L (big blind) folded before Flop

CoinPoker Hand #296105173: Hold'em No Limit (0.01/0.02 ) 2025/09/13 12:39:26 GMT
Table 'NL ₮2 III' 7-max Seat #6 is the button
Seat 1: sabri (6.30 in chips)
Seat 2: shrimptesticles (1.68 in chips)
Seat 3: GannibalElectro (3.86 in chips)
Seat 4: Crypppoker (2.00 in chips)
Seat 5: kanococo (1.71 in chips)
Seat 6: Misiao (2.00 in chips)
Seat 7: R1S3ND3V1L (2.46 in chips)
R1S3ND3V1L: posts small blind 0.01
sabri: posts big blind 0.02
*** HOLE CARDS ***
Dealt to kanococo [8d 2d]
shrimptesticles: folds
GannibalElectro: folds
Crypppoker: raises 0.04 to 0.06
kanococo: folds
Misiao: folds
R1S3ND3V1L: folds
sabri: raises 0.10 to 0.16
Crypppoker: raises 0.16 to 0.32
sabri: calls 0.16
*** FLOP *** [2h Jd 5c]
sabri: checks
Crypppoker: bets 0.62
sabri has timed out
sabri activated time-bank (60 seconds)
sabri: folds
Uncalled bet (0.62) returned to Crypppoker
Crypppoker collected 0.62 from pot
Crypppoker: doesn't show hand
*** SUMMARY ***
Total pot 0.65 | Rake 0.03
Board [ 2h Jd 5c ]
Game ended: 2025/09/13 12:40:31 GMT
Seat 1: sabri (big blind) folded on the Flop
Seat 2: shrimptesticles folded before Flop (didn't bet)
Seat 3: GannibalElectro folded before Flop (didn't bet)
Seat 4: Crypppoker collected (0.62)
Seat 5: kanococo folded before Flop (didn't bet)
Seat 6: Misiao (button) folded before Flop (didn't bet)
Seat 7: R1S3ND3V1L (small blind) folded before Flop

CoinPoker Hand #296105517: Hold'em No Limit (0.01/0.02 ) 2025/09/13 12:40:33 GMT
Table 'NL ₮2 III' 7-max Seat #7 is the button
Seat 1: sabri (5.98 in chips)
Seat 2: shrimptesticles (1.68 in chips)
Seat 3: GannibalElectro (3.86 in chips)
Seat 4: Crypppoker (2.30 in chips)
Seat 5: kanococo (1.71 in chips)
Seat 6: Misiao (2.00 in chips)
Seat 7: R1S3ND3V1L (2.45 in chips)
sabri: posts small blind 0.01
shrimptesticles: posts big blind 0.02
*** HOLE CARDS ***
Dealt to kanococo [Td 3s]
GannibalElectro: folds
Crypppoker: folds
kanococo: folds
Misiao: folds
R1S3ND3V1L: folds
sabri: raises 0.02 to 0.04
shrimptesticles: calls 0.02
*** FLOP *** [5c Th Kd]
sabri: checks
shrimptesticles: checks
*** TURN *** [5c Th Kd] [Ks]
sabri: bets 0.06
shrimptesticles: folds
Uncalled bet (0.06) returned to sabri
sabri collected 0.08 from pot
sabri: doesn't show hand
*** SUMMARY ***
Total pot 0.08 | Rake 0.00
Board [ 5c Th Kd Ks ]
Game ended: 2025/09/13 12:41:05 GMT
Seat 1: sabri (small blind) collected (0.08)
Seat 2: shrimptesticles (big blind) folded on the Turn
Seat 3: GannibalElectro folded before Flop (didn't bet)
Seat 4: Crypppoker folded before Flop (didn't bet)
Seat 5: kanococo folded before Flop (didn't bet)
Seat 6: Misiao folded before Flop (didn't bet)
Seat 7: R1S3ND3V1L (button) folded before Flop (didn't bet)

CoinPoker Hand #296105657: Hold'em No Limit (0.01/0.02 ) 2025/09/13 12:41:07 GMT
Table 'NL ₮2 III' 7-max Seat #1 is the button
Seat 1: sabri (6.02 in chips)
Seat 2: shrimptesticles (1.64 in chips)
Seat 3: GannibalElectro (3.86 in chips)
Seat 4: Crypppoker (2.30 in chips)
Seat 5: kanococo (1.71 in chips)
Seat 6: Misiao (2.00 in chips)
Seat 7: R1S3ND3V1L (2.45 in chips)
shrimptesticles: posts small blind 0.01
GannibalElectro: posts big blind 0.02
*** HOLE CARDS ***
Dealt to kanococo [As Ad]
Crypppoker: folds
kanococo: calls 0.02
Misiao: folds
R1S3ND3V1L: folds
sabri: calls 0.02
shrimptesticles: folds
GannibalElectro: checks
*** FLOP *** [Ac 6s Th]
GannibalElectro: checks
kanococo: bets 0.03
sabri: calls 0.03
GannibalElectro: folds
*** TURN *** [Ac 6s Th] [2h]
kanococo: checks
sabri: bets 0.08
kanococo: calls 0.08
*** RIVER *** [Ac 6s Th 2h] [4d]
kanococo: bets 0.28
sabri: folds
Uncalled bet (0.28) returned to kanococo
kanococo collected 0.28 from pot
kanococo: doesn't show hand
*** SUMMARY ***
Total pot 0.29 | Rake 0.01
Board [ Ac 6s Th 2h 4d ]
Game ended: 2025/09/13 12:42:19 GMT
Seat 1: sabri (button) folded on the River
Seat 2: shrimptesticles (small blind) folded before Flop
Seat 3: GannibalElectro (big blind) folded on the Flop
Seat 4: Crypppoker folded before Flop (didn't bet)
Seat 5: kanococo collected (0.28)
Seat 6: Misiao folded before Flop (didn't bet)
Seat 7: R1S3ND3V1L folded before Flop (didn't bet)

CoinPoker Hand #296106119: Hold'em No Limit (0.01/0.02 ) 2025/09/13 12:42:21 GMT
Table 'NL ₮2 III' 7-max Seat #2 is the button
Seat 1: sabri (5.89 in chips)
Seat 2: lyrica300 (2.00 in chips) out of hand
Seat 3: GannibalElectro (3.84 in chips)
Seat 4: Crypppoker (2.30 in chips)
Seat 5: kanococo (1.86 in chips)
Seat 6: Misiao (2.00 in chips)
Seat 7: R1S3ND3V1L (2.45 in chips)
GannibalElectro: posts small blind 0.01
Crypppoker: posts big blind 0.02
*** HOLE CARDS ***
Dealt to kanococo [8c Kh]
kanococo: folds
Misiao: folds
R1S3ND3V1L: folds
sabri: folds
GannibalElectro: raises 0.03 to 0.05
Crypppoker: raises 2.28 and is all-in
GannibalElectro: folds
Crypppoker collected 2.35 from pot
Crypppoker: doesn't show hand
*** SUMMARY ***
Total pot 2.35 | Rake 0.00
Board [ ]
Game ended: 2025/09/13 12:42:52 GMT
Seat 1: sabri folded before Flop (didn't bet)
Seat 2: lyrica300 (button) folded before Flop (didn't bet)
Seat 3: GannibalElectro (small blind) folded before Flop
Seat 4: Crypppoker (big blind) collected (2.35)
Seat 5: kanococo folded before Flop (didn't bet)
Seat 6: Misiao folded before Flop (didn't bet)
Seat 7: R1S3ND3V1L folded before Flop (didn't bet)

CoinPoker Hand #296106300: Hold'em No Limit (0.01/0.02 ) 2025/09/13 12:42:55 GMT
Table 'NL ₮2 III' 7-max Seat #3 is the button
Seat 1: sabri (5.89 in chips)
Seat 2: lyrica300 (2.00 in chips) out of hand
Seat 3: GannibalElectro (3.79 in chips)
Seat 4: Crypppoker (2.35 in chips)
Seat 5: kanococo (1.86 in chips)
Seat 6: Misiao (2.00 in chips)
Seat 7: R1S3ND3V1L (2.45 in chips)
Crypppoker: posts small blind 0.01
kanococo: posts big blind 0.02
*** HOLE CARDS ***
Dealt to kanococo [3d 6s]
Misiao: folds
R1S3ND3V1L: folds
sabri: raises 0.02 to 0.04
GannibalElectro: folds
Crypppoker: raises 0.04 to 0.08
kanococo: folds
sabri: calls 0.04
*** FLOP *** [6h 9c 5c]
Crypppoker: bets 2.27 and is all-in
sabri: calls 2.27
*** TURN *** [6h 9c 5c] [Qs]
*** RIVER *** [6h 9c 5c Qs] [4c]
*** SHOW DOWN ***
Crypppoker: shows [4d 5h] (two pairs, Fives and Fours)
sabri: shows [6c 8h] (a pair of Sixes)
Crypppoker collected 4.52 from pot
*** SUMMARY ***
Total pot 4.72 | Rake 0.20
Board [ 6h 9c 5c Qs 4c ]
Game ended: 2025/09/13 12:43:44 GMT
Seat 1: sabri showed [6c 8h]
Seat 2: lyrica300 folded before Flop (didn't bet)
Seat 3: GannibalElectro (button) folded before Flop (didn't bet)
Seat 4: Crypppoker (small blind) showed [4d 5h] and won (4.52) with two pairs, Fives and Fours
Seat 5: kanococo (big blind) folded before Flop
Seat 6: Misiao folded before Flop (didn't bet)
Seat 7: R1S3ND3V1L folded before Flop (didn't bet)

CoinPoker Hand #296106553: Hold'em No Limit (0.01/0.02 ) 2025/09/13 12:43:47 GMT
Table 'NL ₮2 III' 7-max Seat #4 is the button
Seat 1: sabri (3.54 in chips)
Seat 2: lyrica300 (2.00 in chips) out of hand
Seat 3: GannibalElectro (3.79 in chips)
Seat 4: Crypppoker (4.52 in chips)
Seat 5: kanococo (1.84 in chips)
Seat 6: Misiao (2.00 in chips)
Seat 7: R1S3ND3V1L (2.45 in chips)
kanococo: posts small blind 0.01
Misiao: posts big blind 0.02
*** HOLE CARDS ***
Dealt to kanococo [9d 6d]
R1S3ND3V1L: folds
sabri: raises 0.04 to 0.06
GannibalElectro: folds
Crypppoker said, "good a**"
Crypppoker: calls 0.06
kanococo: folds
Misiao: folds
*** FLOP *** [Ah Ks 6s]
sabri: checks
Crypppoker: bets 0.14
sabri: folds
Uncalled bet (0.14) returned to Crypppoker
Crypppoker collected 0.14 from pot
Crypppoker: doesn't show hand
*** SUMMARY ***
Total pot 0.15 | Rake 0.01
Board [ Ah Ks 6s ]
Game ended: 2025/09/13 12:44:20 GMT
Seat 1: sabri folded on the Flop
Seat 2: lyrica300 folded before Flop (didn't bet)
Seat 3: GannibalElectro folded before Flop (didn't bet)
Seat 4: Crypppoker (button) collected (0.14)
Seat 5: kanococo (small blind) folded before Flop
Seat 6: Misiao (big blind) folded before Flop
Seat 7: R1S3ND3V1L folded before Flop (didn't bet)

CoinPoker Hand #296106841: Hold'em No Limit (0.01/0.02 ) 2025/09/13 12:44:22 GMT
Table 'NL ₮2 III' 7-max Seat #5 is the button
Seat 1: sabri (3.48 in chips)
Seat 2: lyrica300 (2.00 in chips) out of hand
Seat 3: GannibalElectro (3.79 in chips)
Seat 4: Crypppoker (4.60 in chips)
Seat 5: kanococo (1.83 in chips)
Seat 6: Misiao (2.00 in chips)
Seat 7: R1S3ND3V1L (2.45 in chips)
Misiao: posts small blind 0.01
R1S3ND3V1L: posts big blind 0.02
*** HOLE CARDS ***
Dealt to kanococo [8c 6d]
sabri: raises 0.04 to 0.06
GannibalElectro: folds
Crypppoker: folds
kanococo: folds
Misiao: raises 0.14 to 0.20
R1S3ND3V1L: folds
sabri: calls 0.14
*** FLOP *** [6h 5c Kh]
Misiao: bets 0.14
sabri: calls 0.14
*** TURN *** [6h 5c Kh] [3s]
Misiao: checks
sabri: bets 0.40
Misiao: folds
Uncalled bet (0.40) returned to sabri
sabri collected 0.66 from pot
sabri: doesn't show hand
*** SUMMARY ***
Total pot 0.70 | Rake 0.04
Board [ 6h 5c Kh 3s ]
Game ended: 2025/09/13 12:45:13 GMT
Seat 1: sabri collected (0.66)
Seat 2: lyrica300 folded before Flop (didn't bet)
Seat 3: GannibalElectro folded before Flop (didn't bet)
Seat 4: Crypppoker folded before Flop (didn't bet)
Seat 5: kanococo (button) folded before Flop (didn't bet)
Seat 6: Misiao (small blind) folded on the Turn
Seat 7: R1S3ND3V1L (big blind) folded before Flop

CoinPoker Hand #296107103: Hold'em No Limit (0.01/0.02 ) 2025/09/13 12:45:15 GMT
Table 'NL ₮2 III' 7-max Seat #6 is the button
Seat 1: sabri (3.80 in chips)
Seat 2: lyrica300 (2.00 in chips) out of hand
Seat 3: GannibalElectro (3.79 in chips)
Seat 4: Crypppoker (4.60 in chips)
Seat 5: kanococo (1.83 in chips)
Seat 6: Misiao (2.00 in chips)
Seat 7: R1S3ND3V1L (2.43 in chips)
R1S3ND3V1L: posts small blind 0.01
sabri: posts big blind 0.02
*** HOLE CARDS ***
Dealt to kanococo [Jh 7c]
GannibalElectro: folds
Crypppoker: calls 0.02
kanococo: raises 0.06 to 0.08
Misiao: folds
R1S3ND3V1L: folds
sabri: calls 0.06
Crypppoker: calls 0.06
*** FLOP *** [Tc Jd 4c]
sabri: checks
Crypppoker: checks
kanococo: bets 0.16
sabri: folds
Crypppoker: calls 0.16
*** TURN *** [Tc Jd 4c] [3s]
Crypppoker: checks
kanococo: bets 0.54
Crypppoker: folds
Uncalled bet (0.54) returned to kanococo
kanococo collected 0.54 from pot
kanococo: doesn't show hand
*** SUMMARY ***
Total pot 0.57 | Rake 0.03
Board [ Tc Jd 4c 3s ]
Game ended: 2025/09/13 12:46:20 GMT
Seat 1: sabri (big blind) folded on the Flop
Seat 2: lyrica300 folded before Flop (didn't bet)
Seat 3: GannibalElectro folded before Flop (didn't bet)
Seat 4: Crypppoker folded on the Turn
Seat 5: kanococo collected (0.54)
Seat 6: Misiao (button) folded before Flop (didn't bet)
Seat 7: R1S3ND3V1L (small blind) folded before Flop

CoinPoker Hand #296107444: Hold'em No Limit (0.01/0.02 ) 2025/09/13 12:46:22 GMT
Table 'NL ₮2 III' 7-max Seat #7 is the button
Seat 1: sabri (3.72 in chips)
Seat 2: lyrica300 (2.00 in chips)
Seat 3: GannibalElectro (3.79 in chips)
Seat 4: Crypppoker (4.36 in chips)
Seat 5: kanococo (2.13 in chips)
Seat 6: Misiao (2.00 in chips)
Seat 7: R1S3ND3V1L (2.42 in chips)
sabri: posts small blind 0.01
lyrica300: posts big blind 0.02
*** HOLE CARDS ***
Dealt to kanococo [Js Kh]
GannibalElectro: folds
Crypppoker: folds
kanococo: raises 0.06 to 0.08
Misiao: folds
R1S3ND3V1L: folds
sabri: raises 0.18 to 0.26
lyrica300: folds
kanococo: calls 0.18
*** FLOP *** [9h 2s 3c]
sabri: bets 0.25
kanococo: folds
Uncalled bet (0.25) returned to sabri
sabri collected 0.51 from pot
sabri: doesn't show hand
*** SUMMARY ***
Total pot 0.54 | Rake 0.03
Board [ 9h 2s 3c ]
Game ended: 2025/09/13 12:47:08 GMT
Seat 1: sabri (small blind) collected (0.51)
Seat 2: lyrica300 (big blind) folded before Flop
Seat 3: GannibalElectro folded before Flop (didn't bet)
Seat 4: Crypppoker folded before Flop (didn't bet)
Seat 5: kanococo folded on the Flop
Seat 6: Misiao folded before Flop (didn't bet)
Seat 7: R1S3ND3V1L (button) folded before Flop (didn't bet)

CoinPoker Hand #296107616: Hold'em No Limit (0.01/0.02 ) 2025/09/13 12:47:10 GMT
Table 'NL ₮2 III' 7-max Seat #1 is the button
Seat 1: sabri (3.97 in chips)
Seat 2: lyrica300 (1.98 in chips)
Seat 3: GannibalElectro (3.79 in chips)
Seat 4: Crypppoker (4.36 in chips)
Seat 5: kanococo (1.87 in chips)
Seat 6: Misiao (2.00 in chips)
Seat 7: R1S3ND3V1L (2.42 in chips)
lyrica300: posts small blind 0.01
GannibalElectro: posts big blind 0.02
*** HOLE CARDS ***
Dealt to kanococo [6s 4d]
Crypppoker: calls 0.02
kanococo: folds
Misiao: folds
R1S3ND3V1L: folds
sabri: raises 0.04 to 0.06
lyrica300: folds
GannibalElectro: folds
Crypppoker: calls 0.04
*** FLOP *** [Ah 9c Qc]
Crypppoker: checks
sabri: checks
*** TURN *** [Ah 9c Qc] [2h]
Crypppoker: bets 0.04
sabri: raises 0.10 to 0.14
Crypppoker: folds
Uncalled bet (0.10) returned to sabri
sabri collected 0.22 from pot
sabri: doesn't show hand
*** SUMMARY ***
Total pot 0.23 | Rake 0.01
Board [ Ah 9c Qc 2h ]
Game ended: 2025/09/13 12:48:00 GMT
Seat 1: sabri (button) collected (0.22)
Seat 2: lyrica300 (small blind) folded before Flop
Seat 3: GannibalElectro (big blind) folded before Flop
Seat 4: Crypppoker folded on the Turn
Seat 5: kanococo folded before Flop (didn't bet)
Seat 6: Misiao folded before Flop (didn't bet)
Seat 7: R1S3ND3V1L folded before Flop (didn't bet)

CoinPoker Hand #296107837: Hold'em No Limit (0.01/0.02 ) 2025/09/13 12:48:02 GMT
Table 'NL ₮2 III' 7-max Seat #2 is the button
Seat 1: sabri (4.09 in chips)
Seat 2: lyrica300 (1.99 in chips)
Seat 3: GannibalElectro (3.77 in chips)
Seat 4: Crypppoker (4.26 in chips)
Seat 5: kanococo (1.87 in chips)
Seat 6: Misiao (2.00 in chips)
Seat 7: R1S3ND3V1L (2.42 in chips)
GannibalElectro: posts small blind 0.01
Crypppoker: posts big blind 0.02
*** HOLE CARDS ***
Dealt to kanococo [Kc Qd]
kanococo: raises 0.05 to 0.07
Misiao: folds
R1S3ND3V1L: folds
sabri: folds
lyrica300: folds
GannibalElectro: folds
Crypppoker: calls 0.05
*** FLOP *** [Qh 3h 4c]
Crypppoker: checks
kanococo: bets 0.07
Crypppoker: folds
Uncalled bet (0.07) returned to kanococo
kanococo collected 0.14 from pot
kanococo: doesn't show hand
*** SUMMARY ***
Total pot 0.15 | Rake 0.01
Board [ Qh 3h 4c ]
Game ended: 2025/09/13 12:48:48 GMT
Seat 1: sabri folded before Flop (didn't bet)
Seat 2: lyrica300 (button) folded before Flop (didn't bet)
Seat 3: GannibalElectro (small blind) folded before Flop
Seat 4: Crypppoker (big blind) folded on the Flop
Seat 5: kanococo collected (0.14)
Seat 6: Misiao folded before Flop (didn't bet)
Seat 7: R1S3ND3V1L folded before Flop (didn't bet)

CoinPoker Hand #296108151: Hold'em No Limit (0.01/0.02 ) 2025/09/13 12:48:50 GMT
Table 'NL ₮2 III' 7-max Seat #3 is the button
Seat 1: sabri (4.09 in chips)
Seat 2: lyrica300 (2.00 in chips)
Seat 3: GannibalElectro (3.76 in chips)
Seat 4: Crypppoker (4.19 in chips)
Seat 5: kanococo (1.94 in chips)
Seat 6: Misiao (2.00 in chips)
Seat 7: R1S3ND3V1L (2.42 in chips)
Crypppoker: posts small blind 0.01
kanococo: posts big blind 0.02
*** HOLE CARDS ***
Dealt to kanococo [6d Qs]
Misiao: folds
R1S3ND3V1L: folds
sabri: folds
lyrica300: raises 0.04 to 0.06
GannibalElectro: folds
Crypppoker: raises 0.06 to 0.12
kanococo: folds
lyrica300: raises 0.23 to 0.35
Crypppoker: calls 0.23
*** FLOP *** [Qd 9s Kh]
Crypppoker: bets 3.84 and is all-in
lyrica300: calls 1.65 and is all-in
Uncalled bet (2.19) returned to Crypppoker
*** TURN *** [Qd 9s Kh] [3h]
*** RIVER *** [Qd 9s Kh 3h] [5d]
*** SHOW DOWN ***
Crypppoker: shows [Tc Kc] (a pair of Kings)
lyrica300: shows [Ac Ks] (a pair of Kings)
lyrica300 collected 3.82 from pot
*** SUMMARY ***
Total pot 4.02 | Rake 0.20
Board [ Qd 9s Kh 3h 5d ]
Game ended: 2025/09/13 12:50:12 GMT
Seat 1: sabri folded before Flop (didn't bet)
Seat 2: lyrica300 showed [Ac Ks] and won (3.82) with a pair of Kings
Seat 3: GannibalElectro (button) folded before Flop (didn't bet)
Seat 4: Crypppoker (small blind) showed [Tc Kc]
Seat 5: kanococo (big blind) folded before Flop
Seat 6: Misiao folded before Flop (didn't bet)
Seat 7: R1S3ND3V1L folded before Flop (didn't bet)

CoinPoker Hand #296108560: Hold'em No Limit (0.01/0.02 ) 2025/09/13 12:50:15 GMT
Table 'NL ₮2 III' 7-max Seat #4 is the button
Seat 1: sabri (4.09 in chips)
Seat 2: lyrica300 (3.82 in chips)
Seat 3: GannibalElectro (3.76 in chips)
Seat 4: Crypppoker (2.19 in chips)
Seat 5: kanococo (1.92 in chips)
Seat 6: Misiao (2.00 in chips)
Seat 7: R1S3ND3V1L (2.42 in chips)
kanococo: posts small blind 0.01
Misiao: posts big blind 0.02
*** HOLE CARDS ***
Dealt to kanococo [2d Jh]
R1S3ND3V1L: folds
sabri: folds
lyrica300: raises 0.04 to 0.06
GannibalElectro: folds
Crypppoker: calls 0.06
kanococo: folds
Misiao: calls 0.04
*** FLOP *** [5d 7c 4h]
Misiao: checks
lyrica300: bets 0.11
Crypppoker: calls 0.11
Misiao: calls 0.11
*** TURN *** [5d 7c 4h] [2s]
Misiao: checks
lyrica300: bets 0.36
Crypppoker: calls 0.36
Misiao: folds
*** RIVER *** [5d 7c 4h 2s] [Kh]
lyrica300: bets 0.38
Crypppoker: folds
Uncalled bet (0.38) returned to lyrica300
lyrica300 collected 1.18 from pot
lyrica300: doesn't show hand
*** SUMMARY ***
Total pot 1.24 | Rake 0.06
Board [ 5d 7c 4h 2s Kh ]
Game ended: 2025/09/13 12:51:38 GMT
Seat 1: sabri folded before Flop (didn't bet)
Seat 2: lyrica300 collected (1.18)
Seat 3: GannibalElectro folded before Flop (didn't bet)
Seat 4: Crypppoker (button) folded on the River
Seat 5: kanococo (small blind) folded before Flop
Seat 6: Misiao (big blind) folded on the Turn
Seat 7: R1S3ND3V1L folded before Flop (didn't bet)

CoinPoker Hand #296108971: Hold'em No Limit (0.01/0.02 ) 2025/09/13 12:51:40 GMT
Table 'NL ₮2 III' 7-max Seat #5 is the button
Seat 1: sabri (4.09 in chips)
Seat 2: lyrica300 (4.47 in chips)
Seat 3: GannibalElectro (3.76 in chips)
Seat 4: Crypppoker (2.00 in chips)
Seat 5: kanococo (1.91 in chips)
Seat 6: Misiao (2.00 in chips)
Seat 7: R1S3ND3V1L (2.42 in chips)
Misiao: posts small blind 0.01
R1S3ND3V1L: posts big blind 0.02
*** HOLE CARDS ***
Dealt to kanococo [2d Ad]
sabri: folds
lyrica300: folds
GannibalElectro: folds
Crypppoker: raises 0.04 to 0.06
kanococo: raises 0.06 to 0.12
Misiao: calls 0.11
R1S3ND3V1L: folds
Crypppoker: calls 0.06
*** FLOP *** [Jd Ah 4d]
Misiao: checks
Crypppoker: checks
kanococo: bets 0.22
Misiao: raises 0.34 to 0.56
Crypppoker: folds
kanococo: calls 0.34
*** TURN *** [Jd Ah 4d] [9h]
Misiao: bets 1.32 and is all-in
kanococo: calls 1.23 and is all-in
Uncalled bet (0.09) returned to Misiao
*** RIVER *** [Jd Ah 4d 9h] [Js]
*** SHOW DOWN ***
Misiao: shows [4c 4h] (a full house, Fours over Jacks)
kanococo: shows [2d Ad] (two pairs, Aces and Jacks)
Misiao collected 3.76 from pot
*** SUMMARY ***
Total pot 3.96 | Rake 0.20
Board [ Jd Ah 4d 9h Js ]
Game ended: 2025/09/13 12:52:52 GMT
Seat 1: sabri folded before Flop (didn't bet)
Seat 2: lyrica300 folded before Flop (didn't bet)
Seat 3: GannibalElectro folded before Flop (didn't bet)
Seat 4: Crypppoker folded on the Flop
Seat 5: kanococo (button) showed [2d Ad]
Seat 6: Misiao (small blind) showed [4c 4h] and won (3.76) with a full house, Fours over Jacks
Seat 7: R1S3ND3V1L (big blind) folded before Flop

CoinPoker Hand #296431333: Hold'em No Limit (0.01/0.02 ) 2025/09/14 01:09:34 GMT
Table 'NL ₮2 V' 7-max Seat #4 is the button
Seat 1: randixyz (0.65 in chips)
Seat 2: Kman2 (2.02 in chips) is sitting out
Seat 3: kanococo (2.00 in chips)
Seat 4: 0bsidiana777 (1.95 in chips)
Seat 5: Mark72751 (2.22 in chips)
Seat 6: SQuest (5.16 in chips)
Seat 7: tu2tu (1.62 in chips)
Mark72751: posts small blind 0.01
SQuest: posts big blind 0.02
kanococo: posts big blind 0.02
*** HOLE CARDS ***
Dealt to kanococo [Jh 6s]
tu2tu: folds
randixyz: calls 0.02
kanococo has timed out
kanococo activated time-bank (60 seconds)
kanococo: checks
0bsidiana777: folds
Mark72751: folds
SQuest: checks
*** FLOP *** [Ts 3s As]
SQuest: checks
randixyz: checks
kanococo: checks
*** TURN *** [Ts 3s As] [5c]
SQuest: checks
randixyz: checks
kanococo: bets 0.06
SQuest: folds
randixyz: folds
Uncalled bet (0.06) returned to kanococo
kanococo collected 0.07 from pot
kanococo: doesn't show hand
*** SUMMARY ***
Total pot 0.07 | Rake 0.00
Board [ Ts 3s As 5c ]
Game ended: 2025/09/14 01:10:35 GMT
Seat 1: randixyz folded on the Turn
Seat 2: Kman2 folded before Flop (didn't bet)
Seat 3: kanococo collected (0.07)
Seat 4: 0bsidiana777 (button) folded before Flop (didn't bet)
Seat 5: Mark72751 (small blind) folded before Flop
Seat 6: SQuest (big blind) folded on the Turn
Seat 7: tu2tu folded before Flop (didn't bet)

CoinPoker Hand #296431574: Hold'em No Limit (0.01/0.02 ) 2025/09/14 01:10:37 GMT
Table 'NL ₮2 V' 7-max Seat #5 is the button
Seat 1: randixyz (0.63 in chips)
Seat 2: Kman2 (2.02 in chips) is sitting out
Seat 3: kanococo (2.05 in chips)
Seat 4: 0bsidiana777 (1.95 in chips)
Seat 5: Mark72751 (2.21 in chips)
Seat 6: SQuest (5.14 in chips)
Seat 7: tu2tu (1.62 in chips)
SQuest: posts small blind 0.01
tu2tu: posts big blind 0.02
*** HOLE CARDS ***
Dealt to kanococo [3c 8d]
randixyz: calls 0.02
kanococo: folds
0bsidiana777: folds
Mark72751: folds
SQuest: folds
tu2tu: checks
*** FLOP *** [3h 7h Tc]
tu2tu: checks
randixyz: checks
*** TURN *** [3h 7h Tc] [5c]
tu2tu: bets 0.03
randixyz: folds
Uncalled bet (0.03) returned to tu2tu
tu2tu collected 0.05 from pot
tu2tu: doesn't show hand
*** SUMMARY ***
Total pot 0.05 | Rake 0.00
Board [ 3h 7h Tc 5c ]
Game ended: 2025/09/14 01:11:29 GMT
Seat 1: randixyz folded on the Turn
Seat 2: Kman2 folded before Flop (didn't bet)
Seat 3: kanococo folded before Flop (didn't bet)
Seat 4: 0bsidiana777 folded before Flop (didn't bet)
Seat 5: Mark72751 (button) folded before Flop (didn't bet)
Seat 6: SQuest (small blind) folded before Flop
Seat 7: tu2tu (big blind) collected (0.05)

CoinPoker Hand #296431726: Hold'em No Limit (0.01/0.02 ) 2025/09/14 01:11:31 GMT
Table 'NL ₮2 V' 7-max Seat #6 is the button
Seat 1: randixyz (0.61 in chips)
Seat 2: Kman2 (2.02 in chips) is sitting out
Seat 3: kanococo (2.05 in chips)
Seat 4: 0bsidiana777 (1.95 in chips)
Seat 5: Mark72751 (2.21 in chips)
Seat 6: SQuest (5.13 in chips)
Seat 7: tu2tu (1.65 in chips)
tu2tu: posts small blind 0.01
randixyz: posts big blind 0.02
*** HOLE CARDS ***
Dealt to kanococo [5c 3d]
kanococo: folds
0bsidiana777: folds
Mark72751: folds
SQuest: raises 0.03 to 0.05
tu2tu: folds
randixyz: raises 0.15 to 0.20
SQuest: calls 0.15
*** FLOP *** [Ac Kc As]
randixyz: bets 0.41 and is all-in
SQuest: calls 0.41
*** TURN *** [Ac Kc As] [Qd]
*** RIVER *** [Ac Kc As Qd] [Qh]
*** SHOW DOWN ***
randixyz: shows [Td Ts] (two pairs, Aces and Queens)
SQuest: shows [Jc Ah] (a full house, Aces over Queens)
SQuest collected 1.17 from pot
*** SUMMARY ***
Total pot 1.23 | Rake 0.06
Board [ Ac Kc As Qd Qh ]
Game ended: 2025/09/14 01:12:23 GMT
Seat 1: randixyz (big blind) showed [Td Ts]
Seat 2: Kman2 folded before Flop (didn't bet)
Seat 3: kanococo folded before Flop (didn't bet)
Seat 4: 0bsidiana777 folded before Flop (didn't bet)
Seat 5: Mark72751 folded before Flop (didn't bet)
Seat 6: SQuest (button) showed [Jc Ah] and won (1.17) with a full house, Aces over Queens
Seat 7: tu2tu (small blind) folded before Flop

CoinPoker Hand #296431908: Hold'em No Limit (0.01/0.02 ) 2025/09/14 01:12:26 GMT
Table 'NL ₮2 V' 7-max Seat #7 is the button
Seat 2: Kman2 (2.02 in chips) is sitting out
Seat 3: kanococo (2.05 in chips)
Seat 4: 0bsidiana777 (1.95 in chips)
Seat 5: Mark72751 (2.21 in chips)
Seat 6: SQuest (5.69 in chips)
Seat 7: tu2tu (1.64 in chips)
kanococo: posts small blind 0.01
0bsidiana777: posts big blind 0.02
*** HOLE CARDS ***
Dealt to kanococo [Ah 6c]
tu2tu said, "nasty"
Mark72751: raises 0.04 to 0.06
SQuest: folds
tu2tu: raises 1.08 to 1.14
kanococo: folds
0bsidiana777: folds
Mark72751: raises 2.15 and is all-in
tu2tu: calls 0.50 and is all-in
Uncalled bet (0.57) returned to Mark72751
*** FLOP *** [9s 6s 2h]
*** TURN *** [9s 6s 2h] [9c]
*** RIVER *** [9s 6s 2h 9c] [6h]
*** SHOW DOWN ***
Mark72751: shows [Qc Qd] (two pairs, Queens and Nines)
tu2tu: shows [As Td] (two pairs, Nines and Sixes)
Mark72751 collected 3.14 from pot
*** SUMMARY ***
Total pot 3.31 | Rake 0.17
Board [ 9s 6s 2h 9c 6h ]
Game ended: 2025/09/14 01:13:05 GMT
Seat 2: Kman2 folded before Flop (didn't bet)
Seat 3: kanococo (small blind) folded before Flop
Seat 4: 0bsidiana777 (big blind) folded before Flop
Seat 5: Mark72751 showed [Qc Qd] and won (3.14) with two pairs, Queens and Nines
Seat 6: SQuest folded before Flop (didn't bet)
Seat 7: tu2tu (button) showed [As Td]

CoinPoker Hand #296432079: Hold'em No Limit (0.01/0.02 ) 2025/09/14 01:13:09 GMT
Table 'NL ₮2 V' 7-max Seat #3 is the button
Seat 2: Kman2 (2.02 in chips) is sitting out
Seat 3: kanococo (2.04 in chips)
Seat 4: 0bsidiana777 (1.93 in chips)
Seat 5: Mark72751 (3.71 in chips)
Seat 6: SQuest (5.69 in chips)
Seat 7: tu2tu (2.00 in chips)
0bsidiana777: posts small blind 0.01
Mark72751: posts big blind 0.02
*** HOLE CARDS ***
Dealt to kanococo [7d Ah]
SQuest: folds
tu2tu said, "walked into ladies thats right"
tu2tu: raises 0.04 to 0.06
kanococo: calls 0.06
0bsidiana777: folds
Mark72751: folds
*** FLOP *** [Kd 2h 7c]
tu2tu: bets 0.10
kanococo: calls 0.10
*** TURN *** [Kd 2h 7c] [Tc]
tu2tu: checks
kanococo: bets 0.08
tu2tu: calls 0.08
*** RIVER *** [Kd 2h 7c Tc] [8h]
tu2tu: checks
kanococo: checks
*** SHOW DOWN ***
tu2tu: shows [8c As] (a pair of Eights)
kanococo: mucks hand
tu2tu collected 0.48 from pot
*** SUMMARY ***
Total pot 0.51 | Rake 0.03
Board [ Kd 2h 7c Tc 8h ]
Game ended: 2025/09/14 01:14:00 GMT
Seat 2: Kman2 folded before Flop (didn't bet)
Seat 3: kanococo (button) mucked
Seat 4: 0bsidiana777 (small blind) folded before Flop
Seat 5: Mark72751 (big blind) folded before Flop
Seat 6: SQuest folded before Flop (didn't bet)
Seat 7: tu2tu showed [8c As] and won (0.48) with a pair of Eights

CoinPoker Hand #296432208: Hold'em No Limit (0.01/0.02 ) 2025/09/14 01:14:02 GMT
Table 'NL ₮2 V' 7-max Seat #4 is the button
Seat 1: omittimo (2.00 in chips)
Seat 2: Kman2 (2.02 in chips) is sitting out
Seat 3: kanococo (1.80 in chips)
Seat 4: 0bsidiana777 (1.92 in chips)
Seat 5: Mark72751 (3.69 in chips)
Seat 6: SQuest (5.69 in chips)
Seat 7: tu2tu (2.24 in chips)
Mark72751: posts small blind 0.01
SQuest: posts big blind 0.02
omittimo: posts big blind 0.02
*** HOLE CARDS ***
Dealt to kanococo [Jh 3s]
tu2tu: raises 2.24 and is all-in
omittimo: folds
kanococo: folds
0bsidiana777: folds
Mark72751: folds
SQuest: folds
tu2tu collected 2.29 from pot
tu2tu: doesn't show hand
*** SUMMARY ***
Total pot 2.29 | Rake 0.00
Board [ ]
Game ended: 2025/09/14 01:14:21 GMT
Seat 1: omittimo folded before Flop
Seat 2: Kman2 folded before Flop (didn't bet)
Seat 3: kanococo folded before Flop (didn't bet)
Seat 4: 0bsidiana777 (button) folded before Flop (didn't bet)
Seat 5: Mark72751 (small blind) folded before Flop
Seat 6: SQuest (big blind) folded before Flop
Seat 7: tu2tu collected (2.29)

CoinPoker Hand #296432358: Hold'em No Limit (0.01/0.02 ) 2025/09/14 01:14:23 GMT
Table 'NL ₮2 V' 7-max Seat #5 is the button
Seat 1: omittimo (1.98 in chips)
Seat 2: Kman2 (2.02 in chips) is sitting out
Seat 3: kanococo (1.80 in chips)
Seat 4: 0bsidiana777 (1.92 in chips)
Seat 5: Mark72751 (3.68 in chips)
Seat 6: SQuest (5.67 in chips)
Seat 7: tu2tu (2.29 in chips)
SQuest: posts small blind 0.01
tu2tu: posts big blind 0.02
*** HOLE CARDS ***
Dealt to kanococo [Jd 5s]
omittimo: raises 0.04 to 0.06
kanococo: folds
0bsidiana777: folds
Mark72751: calls 0.06
SQuest: folds
tu2tu: raises 0.19 to 0.25
omittimo: folds
Mark72751: folds
tu2tu collected 0.38 from pot
tu2tu: doesn't show hand
*** SUMMARY ***
Total pot 0.38 | Rake 0.00
Board [ ]
Game ended: 2025/09/14 01:15:09 GMT
Seat 1: omittimo folded before Flop
Seat 2: Kman2 folded before Flop (didn't bet)
Seat 3: kanococo folded before Flop (didn't bet)
Seat 4: 0bsidiana777 folded before Flop (didn't bet)
Seat 5: Mark72751 (button) folded before Flop
Seat 6: SQuest (small blind) folded before Flop
Seat 7: tu2tu (big blind) collected (0.38)

CoinPoker Hand #296432465: Hold'em No Limit (0.01/0.02 ) 2025/09/14 01:15:11 GMT
Table 'NL ₮2 V' 7-max Seat #6 is the button
Seat 1: omittimo (1.92 in chips)
Seat 2: Kman2 (2.02 in chips) is sitting out
Seat 3: kanococo (1.80 in chips)
Seat 4: 0bsidiana777 (1.92 in chips)
Seat 5: Mark72751 (3.62 in chips)
Seat 6: SQuest (5.66 in chips)
Seat 7: tu2tu (2.42 in chips)
tu2tu: posts small blind 0.01
omittimo: posts big blind 0.02
*** HOLE CARDS ***
Dealt to kanococo [8c Td]
kanococo: folds
0bsidiana777: folds
Mark72751: folds
SQuest: folds
tu2tu: folds
omittimo collected 0.03 from pot
omittimo: doesn't show hand
*** SUMMARY ***
Total pot 0.03 | Rake 0.00
Board [ ]
Game ended: 2025/09/14 01:15:27 GMT
Seat 1: omittimo (big blind) collected (0.03)
Seat 2: Kman2 folded before Flop (didn't bet)
Seat 3: kanococo folded before Flop (didn't bet)
Seat 4: 0bsidiana777 folded before Flop (didn't bet)
Seat 5: Mark72751 folded before Flop (didn't bet)
Seat 6: SQuest (button) folded before Flop (didn't bet)
Seat 7: tu2tu (small blind) folded before Flop

CoinPoker Hand #296432515: Hold'em No Limit (0.01/0.02 ) 2025/09/14 01:15:29 GMT
Table 'NL ₮2 V' 7-max Seat #7 is the button
Seat 1: omittimo (1.93 in chips)
Seat 2: Kman2 (2.02 in chips) is sitting out
Seat 3: kanococo (1.80 in chips)
Seat 4: 0bsidiana777 (1.92 in chips)
Seat 5: Mark72751 (3.62 in chips)
Seat 6: SQuest (5.66 in chips)
Seat 7: tu2tu (2.41 in chips)
omittimo: posts small blind 0.01
kanococo: posts big blind 0.02
*** HOLE CARDS ***
Dealt to kanococo [9h 2c]
0bsidiana777: folds
Mark72751: folds
SQuest: folds
tu2tu: calls 0.02
omittimo: folds
kanococo: raises 0.06 to 0.08
tu2tu: calls 0.06
*** FLOP *** [Qd 7s Th]
kanococo: checks
tu2tu: bets 0.16
kanococo: folds
Uncalled bet (0.16) returned to tu2tu
tu2tu collected 0.16 from pot
tu2tu: doesn't show hand
*** SUMMARY ***
Total pot 0.17 | Rake 0.01
Board [ Qd 7s Th ]
Game ended: 2025/09/14 01:16:04 GMT
Seat 1: omittimo (small blind) folded before Flop
Seat 2: Kman2 folded before Flop (didn't bet)
Seat 3: kanococo (big blind) folded on the Flop
Seat 4: 0bsidiana777 folded before Flop (didn't bet)
Seat 5: Mark72751 folded before Flop (didn't bet)
Seat 6: SQuest folded before Flop (didn't bet)
Seat 7: tu2tu (button) collected (0.16)

CoinPoker Hand #296432615: Hold'em No Limit (0.01/0.02 ) 2025/09/14 01:16:06 GMT
Table 'NL ₮2 V' 7-max Seat #1 is the button
Seat 1: omittimo (1.92 in chips)
Seat 2: Kman2 (2.02 in chips) is sitting out
Seat 3: kanococo (1.72 in chips)
Seat 4: 0bsidiana777 (1.92 in chips)
Seat 5: Mark72751 (3.62 in chips)
Seat 6: SQuest (5.66 in chips)
Seat 7: tu2tu (2.49 in chips)
kanococo: posts small blind 0.01
0bsidiana777: posts big blind 0.02
*** HOLE CARDS ***
Dealt to kanococo [Th 5d]
Mark72751: raises 0.06 to 0.08
SQuest: folds
tu2tu: folds
omittimo: calls 0.08
kanococo: folds
0bsidiana777: folds
*** FLOP *** [2c 9c Jc]
Mark72751: checks
omittimo: bets 0.05
Mark72751: folds
Uncalled bet (0.05) returned to omittimo
omittimo collected 0.18 from pot
omittimo: doesn't show hand
*** SUMMARY ***
Total pot 0.19 | Rake 0.01
Board [ 2c 9c Jc ]
Game ended: 2025/09/14 01:16:43 GMT
Seat 1: omittimo (button) collected (0.18)
Seat 2: Kman2 folded before Flop (didn't bet)
Seat 3: kanococo (small blind) folded before Flop
Seat 4: 0bsidiana777 (big blind) folded before Flop
Seat 5: Mark72751 folded on the Flop
Seat 6: SQuest folded before Flop (didn't bet)
Seat 7: tu2tu folded before Flop (didn't bet)

CoinPoker Hand #296432732: Hold'em No Limit (0.01/0.02 ) 2025/09/14 01:16:45 GMT
Table 'NL ₮2 V' 7-max Seat #3 is the button
Seat 1: omittimo (2.02 in chips)
Seat 3: kanococo (1.71 in chips)
Seat 4: 0bsidiana777 (1.90 in chips)
Seat 5: Mark72751 (3.54 in chips)
Seat 6: SQuest (5.66 in chips)
Seat 7: tu2tu (2.49 in chips)
0bsidiana777: posts small blind 0.01
Mark72751: posts big blind 0.02
*** HOLE CARDS ***
Dealt to kanococo [Jd 9h]
SQuest: raises 0.04 to 0.06
tu2tu: folds
omittimo: folds
kanococo: folds
0bsidiana777: folds
Mark72751: folds
SQuest collected 0.09 from pot
SQuest: doesn't show hand
*** SUMMARY ***
Total pot 0.09 | Rake 0.00
Board [ ]
Game ended: 2025/09/14 01:17:06 GMT
Seat 1: omittimo folded before Flop (didn't bet)
Seat 3: kanococo (button) folded before Flop (didn't bet)
Seat 4: 0bsidiana777 (small blind) folded before Flop
Seat 5: Mark72751 (big blind) folded before Flop
Seat 6: SQuest collected (0.09)
Seat 7: tu2tu folded before Flop (didn't bet)

CoinPoker Hand #296432866: Hold'em No Limit (0.01/0.02 ) 2025/09/14 01:17:08 GMT
Table 'NL ₮2 V' 7-max Seat #4 is the button
Seat 1: omittimo (2.02 in chips)
Seat 2: JoeyCraps (2.00 in chips)
Seat 3: kanococo (1.71 in chips)
Seat 4: 0bsidiana777 (1.89 in chips)
Seat 5: Mark72751 (3.52 in chips)
Seat 6: SQuest (5.69 in chips)
Seat 7: tu2tu (2.49 in chips)
Mark72751: posts small blind 0.01
SQuest: posts big blind 0.02
JoeyCraps: posts big blind 0.02
*** HOLE CARDS ***
Dealt to kanococo [4h 8h]
tu2tu: folds
omittimo: folds
JoeyCraps: checks
kanococo: folds
0bsidiana777: folds
Mark72751: folds
SQuest: checks
*** FLOP *** [2h 7h Ah]
SQuest: checks
JoeyCraps: checks
*** TURN *** [2h 7h Ah] [Ks]
SQuest: checks
JoeyCraps: bets 0.04
SQuest: folds
Uncalled bet (0.04) returned to JoeyCraps
JoeyCraps collected 0.05 from pot
JoeyCraps: doesn't show hand
*** SUMMARY ***
Total pot 0.05 | Rake 0.00
Board [ 2h 7h Ah Ks ]
Game ended: 2025/09/14 01:18:15 GMT
Seat 1: omittimo folded before Flop (didn't bet)
Seat 2: JoeyCraps collected (0.05)
Seat 3: kanococo folded before Flop (didn't bet)
Seat 4: 0bsidiana777 (button) folded before Flop (didn't bet)
Seat 5: Mark72751 (small blind) folded before Flop
Seat 6: SQuest (big blind) folded on the Turn
Seat 7: tu2tu folded before Flop (didn't bet)

CoinPoker Hand #296433091: Hold'em No Limit (0.01/0.02 ) 2025/09/14 01:18:17 GMT
Table 'NL ₮2 V' 7-max Seat #5 is the button
Seat 1: omittimo (2.02 in chips)
Seat 2: JoeyCraps (2.03 in chips)
Seat 3: kanococo (1.71 in chips)
Seat 4: 0bsidiana777 (1.89 in chips)
Seat 5: Mark72751 (3.51 in chips)
Seat 6: SQuest (5.67 in chips)
Seat 7: tu2tu (2.49 in chips)
SQuest: posts small blind 0.01
tu2tu: posts big blind 0.02
*** HOLE CARDS ***
Dealt to kanococo [5c Td]
omittimo: raises 0.04 to 0.06
JoeyCraps: folds
kanococo: folds
0bsidiana777: folds
Mark72751: folds
SQuest: folds
tu2tu: calls 0.04
*** FLOP *** [Qs 7c 9h]
tu2tu: bets 0.09
omittimo has timed out
omittimo activated time-bank (60 seconds)
omittimo: calls 0.09
*** TURN *** [Qs 7c 9h] [Ad]
tu2tu: bets 0.29
omittimo: calls 0.29
*** RIVER *** [Qs 7c 9h Ad] [Jd]
tu2tu: checks
omittimo: bets 0.28
tu2tu: calls 0.28
*** SHOW DOWN ***
omittimo: shows [Kc Kh] (a pair of Kings)
tu2tu: shows [Ah 6d] (a pair of Aces)
tu2tu collected 1.38 from pot
*** SUMMARY ***
Total pot 1.45 | Rake 0.07
Board [ Qs 7c 9h Ad Jd ]
Game ended: 2025/09/14 01:19:47 GMT
Seat 1: omittimo showed [Kc Kh]
Seat 2: JoeyCraps folded before Flop (didn't bet)
Seat 3: kanococo folded before Flop (didn't bet)
Seat 4: 0bsidiana777 folded before Flop (didn't bet)
Seat 5: Mark72751 (button) folded before Flop (didn't bet)
Seat 6: SQuest (small blind) folded before Flop
Seat 7: tu2tu (big blind) showed [Ah 6d] and won (1.38) with a pair of Aces

CoinPoker Hand #296433439: Hold'em No Limit (0.01/0.02 ) 2025/09/14 01:19:49 GMT
Table 'NL ₮2 V' 7-max Seat #6 is the button
Seat 1: omittimo (1.30 in chips)
Seat 2: JoeyCraps (2.03 in chips)
Seat 3: kanococo (1.71 in chips)
Seat 4: 0bsidiana777 (1.89 in chips)
Seat 5: Mark72751 (3.51 in chips)
Seat 6: SQuest (5.66 in chips)
Seat 7: tu2tu (3.15 in chips)
tu2tu: posts small blind 0.01
omittimo: posts big blind 0.02
*** HOLE CARDS ***
Dealt to kanococo [3h 6d]
JoeyCraps: folds
kanococo: folds
0bsidiana777: folds
Mark72751: folds
SQuest: folds
tu2tu: calls 0.01
omittimo: checks
*** FLOP *** [Ad 4c Kc]
tu2tu: bets 0.03
omittimo: calls 0.03
*** TURN *** [Ad 4c Kc] [8c]
tu2tu: bets 0.09
omittimo: folds
Uncalled bet (0.09) returned to tu2tu
tu2tu collected 0.09 from pot
tu2tu: doesn't show hand
*** SUMMARY ***
Total pot 0.10 | Rake 0.01
Board [ Ad 4c Kc 8c ]
Game ended: 2025/09/14 01:20:53 GMT
Seat 1: omittimo (big blind) folded on the Turn
Seat 2: JoeyCraps folded before Flop (didn't bet)
Seat 3: kanococo folded before Flop (didn't bet)
Seat 4: 0bsidiana777 folded before Flop (didn't bet)
Seat 5: Mark72751 folded before Flop (didn't bet)
Seat 6: SQuest (button) folded before Flop (didn't bet)
Seat 7: tu2tu (small blind) collected (0.09)

CoinPoker Hand #296433491: Tournament #1369441, ₮0.20 Sat to ₮2 Mini Rumble PKO, 4 Seats GTD Hold'em No Limit (60/120 ante 15 play) 2025/09/14 01:20:10 GMT
Table '4' 7-max Seat #3 is the button
Seat 1: Rappture (10433 in chips)
Seat 2: BlueYoko (4509 in chips)
Seat 4: kanococo (5000 in chips)
Seat 5: Summoned (3702 in chips)
Seat 6: CagnusMarlsen (4394 in chips)
Seat 7: bweee81 (11497 in chips)
Rappture: posts the ante 15
BlueYoko: posts the ante 15
kanococo: posts the ante 15
Summoned: posts the ante 15
CagnusMarlsen: posts the ante 15
bweee81: posts the ante 15
Summoned: posts small blind 60
CagnusMarlsen: posts big blind 120
*** HOLE CARDS ***
Dealt to kanococo [Ad 6c]
bweee81: folds
Rappture: raises 240 to 360
BlueYoko: folds
kanococo has timed out
kanococo activated time-bank (30 seconds)
kanococo: calls 360
Summoned: folds
CagnusMarlsen: calls 240
*** FLOP *** [2d Ac 8s]
kanococo: bets 720
CagnusMarlsen: folds
Rappture: calls 720
*** TURN *** [2d Ac 8s] [Js]
kanococo: checks
Rappture: bets 960
kanococo has timed out
kanococo activated time-bank (25 seconds)
kanococo: calls 960
*** RIVER *** [2d Ac 8s Js] [3s]
kanococo: bets 480
Rappture: raises 5550 to 6030
kanococo: calls 2465 and is all-in
Uncalled bet (3085) returned to Rappture
*** SHOW DOWN ***
Rappture: shows [Jd Jh] (three of kind, Jacks)
kanococo: shows [Ad 6c] (a pair of Aces)
Rappture collected 10480 from pot
*** SUMMARY ***
Total pot 10480 | Rake 0
Board [ 2d Ac 8s Js 3s ]
Game ended: 2025/09/14 01:21:42 GMT
Seat 1: Rappture showed [Jd Jh] and won (10480) with three of kind, Jacks
Seat 2: BlueYoko folded before Flop
Seat 4: kanococo showed [Ad 6c]
Seat 5: Summoned (small blind) folded before Flop
Seat 6: CagnusMarlsen (big blind) folded on the Flop
Seat 7: bweee81 folded before Flop

CoinPoker Hand #296433654: Hold'em No Limit (0.01/0.02 ) 2025/09/14 01:20:55 GMT
Table 'NL ₮2 V' 7-max Seat #7 is the button
Seat 1: omittimo (1.25 in chips)
Seat 2: JoeyCraps (2.03 in chips)
Seat 3: kanococo (1.71 in chips)
Seat 4: 0bsidiana777 (1.89 in chips)
Seat 5: Mark72751 (3.51 in chips)
Seat 6: SQuest (5.66 in chips)
Seat 7: tu2tu (3.19 in chips)
omittimo: posts small blind 0.01
JoeyCraps: posts big blind 0.02
*** HOLE CARDS ***
Dealt to kanococo [8d Kh]
kanococo: raises 0.06 to 0.08
0bsidiana777: folds
Mark72751: folds
SQuest: folds
tu2tu: folds
omittimo: calls 0.07
JoeyCraps: folds
*** FLOP *** [5c Qh 7d]
omittimo: checks
kanococo: checks
*** TURN *** [5c Qh 7d] [7s]
omittimo: bets 0.08
kanococo: folds
Uncalled bet (0.08) returned to omittimo
omittimo collected 0.17 from pot
omittimo: doesn't show hand
*** SUMMARY ***
Total pot 0.18 | Rake 0.01
Board [ 5c Qh 7d 7s ]
Game ended: 2025/09/14 01:21:52 GMT
Seat 1: omittimo (small blind) collected (0.17)
Seat 2: JoeyCraps (big blind) folded before Flop
Seat 3: kanococo folded on the Turn
Seat 4: 0bsidiana777 folded before Flop (didn't bet)
Seat 5: Mark72751 folded before Flop (didn't bet)
Seat 6: SQuest folded before Flop (didn't bet)
Seat 7: tu2tu (button) folded before Flop (didn't bet)

CoinPoker Hand #296433802: Hold'em No Limit (0.01/0.02 ) 2025/09/14 01:21:54 GMT
Table 'NL ₮2 V' 7-max Seat #1 is the button
Seat 1: omittimo (1.34 in chips)
Seat 2: JoeyCraps (2.01 in chips)
Seat 3: kanococo (1.63 in chips)
Seat 4: 0bsidiana777 (1.89 in chips)
Seat 5: Mark72751 (3.51 in chips)
Seat 6: SQuest (5.66 in chips)
Seat 7: tu2tu (3.19 in chips)
JoeyCraps: posts small blind 0.01
kanococo: posts big blind 0.02
*** HOLE CARDS ***
Dealt to kanococo [9s 6d]
0bsidiana777: folds
Mark72751: folds
SQuest: folds
tu2tu: folds
omittimo: folds
JoeyCraps: calls 0.01
kanococo: checks
*** FLOP *** [2c 3d 3s]
JoeyCraps: checks
kanococo: checks
*** TURN *** [2c 3d 3s] [7h]
JoeyCraps: bets 0.02
kanococo: calls 0.02
*** RIVER *** [2c 3d 3s 7h] [3c]
JoeyCraps: checks
kanococo: checks
*** SHOW DOWN ***
JoeyCraps: shows [Tc 4c] (three of kind, Threes)
kanococo: mucks hand
JoeyCraps collected 0.08 from pot
*** SUMMARY ***
Total pot 0.08 | Rake 0.00
Board [ 2c 3d 3s 7h 3c ]
Game ended: 2025/09/14 01:22:58 GMT
Seat 1: omittimo (button) folded before Flop (didn't bet)
Seat 2: JoeyCraps (small blind) showed [Tc 4c] and won (0.08) with three of kind, Threes
Seat 3: kanococo (big blind) mucked
Seat 4: 0bsidiana777 folded before Flop (didn't bet)
Seat 5: Mark72751 folded before Flop (didn't bet)
Seat 6: SQuest folded before Flop (didn't bet)
Seat 7: tu2tu folded before Flop (didn't bet)

CoinPoker Hand #296434000: Tournament #1369441, ₮0.20 Sat to ₮2 Mini Rumble PKO, 4 Seats GTD Hold'em No Limit (60/120 ante 15 play) 2025/09/14 01:22:27 GMT
Table '4' 7-max Seat #6 is the button
Seat 1: Rappture (15898 in chips)
Seat 2: BlueYoko (4479 in chips)
Seat 3: kanococo (5000 in chips)
Seat 4: aWeTodd (5000 in chips)
Seat 6: CagnusMarlsen (3764 in chips)
Seat 7: bweee81 (11227 in chips)
Rappture: posts the ante 15
BlueYoko: posts the ante 15
kanococo: posts the ante 15
aWeTodd: posts the ante 15
CagnusMarlsen: posts the ante 15
bweee81: posts the ante 15
bweee81: posts small blind 60
Rappture: posts big blind 120
*** HOLE CARDS ***
Dealt to kanococo [3s 8s]
BlueYoko: calls 120
kanococo: folds
aWeTodd: calls 120
CagnusMarlsen: folds
bweee81: calls 60
Rappture: checks
*** FLOP *** [Ad Qd As]
bweee81: checks
Rappture: bets 240
BlueYoko: calls 240
aWeTodd: raises 1290 to 1530
bweee81: folds
Rappture: calls 1290
BlueYoko: folds
*** TURN *** [Ad Qd As] [Th]
Rappture: checks
aWeTodd: checks
*** RIVER *** [Ad Qd As Th] [Kc]
Rappture: bets 1470
aWeTodd: folds
Uncalled bet (1470) returned to Rappture
Rappture collected 3870 from pot
Rappture: doesn't show hand
*** SUMMARY ***
Total pot 3870 | Rake 0
Board [ Ad Qd As Th Kc ]
Game ended: 2025/09/14 01:23:57 GMT
Seat 1: Rappture (big blind) collected (3870)
Seat 2: BlueYoko folded on the Flop
Seat 3: kanococo folded before Flop
Seat 4: aWeTodd folded on the River
Seat 6: CagnusMarlsen (button) folded before Flop
Seat 7: bweee81 (small blind) folded on the Flop

CoinPoker Hand #296434011: Hold'em No Limit (0.01/0.02 ) 2025/09/14 01:22:59 GMT
Table 'NL ₮2 V' 7-max Seat #2 is the button
Seat 1: omittimo (1.34 in chips)
Seat 2: JoeyCraps (2.05 in chips)
Seat 3: kanococo (1.59 in chips)
Seat 4: 0bsidiana777 (1.89 in chips)
Seat 5: Mark72751 (3.51 in chips)
Seat 6: SQuest (5.66 in chips)
Seat 7: tu2tu (3.19 in chips)
kanococo: posts small blind 0.01
0bsidiana777: posts big blind 0.02
*** HOLE CARDS ***
Dealt to kanococo [6c 8h]
Mark72751: raises 0.06 to 0.08
SQuest: folds
tu2tu: folds
omittimo: folds
JoeyCraps: folds
kanococo: folds
0bsidiana777: folds
Mark72751 collected 0.11 from pot
Mark72751: doesn't show hand
*** SUMMARY ***
Total pot 0.11 | Rake 0.00
Board [ ]
Game ended: 2025/09/14 01:23:38 GMT
Seat 1: omittimo folded before Flop (didn't bet)
Seat 2: JoeyCraps (button) folded before Flop (didn't bet)
Seat 3: kanococo (small blind) folded before Flop
Seat 4: 0bsidiana777 (big blind) folded before Flop
Seat 5: Mark72751 collected (0.11)
Seat 6: SQuest folded before Flop (didn't bet)
Seat 7: tu2tu folded before Flop (didn't bet)

CoinPoker Hand #296434138: Hold'em No Limit (0.01/0.02 ) 2025/09/14 01:23:40 GMT
Table 'NL ₮2 V' 7-max Seat #3 is the button
Seat 1: omittimo (1.34 in chips)
Seat 2: Krelis (2.00 in chips)
Seat 3: kanococo (1.58 in chips)
Seat 4: 0bsidiana777 (1.87 in chips)
Seat 5: Mark72751 (3.54 in chips)
Seat 6: SQuest (5.66 in chips)
Seat 7: tu2tu (3.19 in chips)
0bsidiana777: posts small blind 0.01
Mark72751: posts big blind 0.02
Krelis: posts big blind 0.02
*** HOLE CARDS ***
Dealt to kanococo [Kh Ks]
SQuest: folds
tu2tu: folds
omittimo: raises 0.04 to 0.06
Krelis has timed out
Krelis activated time-bank (60 seconds)
Krelis: calls 0.04
kanococo: raises 0.06 to 0.12
0bsidiana777: folds
Mark72751: folds
omittimo: calls 0.06
Krelis: folds
*** FLOP *** [2c 3c Kd]
omittimo: checks
kanococo: bets 0.15
omittimo has timed out
omittimo activated time-bank (57 seconds)
omittimo: calls 0.15
*** TURN *** [2c 3c Kd] [Ac]
omittimo: bets 0.15
kanococo: raises 1.31 and is all-in
omittimo: folds
Uncalled bet (1.16) returned to kanococo
kanococo collected 0.90 from pot
kanococo: doesn't show hand
*** SUMMARY ***
Total pot 0.93 | Rake 0.03
Board [ 2c 3c Kd Ac ]
Game ended: 2025/09/14 01:25:32 GMT
Seat 1: omittimo folded on the Turn
Seat 2: Krelis folded before Flop
Seat 3: kanococo (button) collected (0.90)
Seat 4: 0bsidiana777 (small blind) folded before Flop
Seat 5: Mark72751 (big blind) folded before Flop
Seat 6: SQuest folded before Flop (didn't bet)
Seat 7: tu2tu folded before Flop (didn't bet)

CoinPoker Hand #296434231: Tournament #1369441, ₮0.20 Sat to ₮2 Mini Rumble PKO, 4 Seats GTD Hold'em No Limit (60/120 ante 15 play) 2025/09/14 01:23:58 GMT
Table '4' 7-max Seat #7 is the button
Seat 1: Rappture (18103 in chips)
Seat 2: BlueYoko (4104 in chips)
Seat 3: kanococo (4985 in chips)
Seat 4: aWeTodd (3335 in chips)
Seat 6: CagnusMarlsen (3749 in chips)
Seat 7: bweee81 (11092 in chips)
Rappture: posts the ante 15
BlueYoko: posts the ante 15
kanococo: posts the ante 15
aWeTodd: posts the ante 15
CagnusMarlsen: posts the ante 15
bweee81: posts the ante 15
Rappture: posts small blind 60
BlueYoko: posts big blind 120
*** HOLE CARDS ***
Dealt to kanococo [9s 7c]
kanococo: folds
aWeTodd: folds
CagnusMarlsen: folds
bweee81: folds
Rappture: folds
BlueYoko collected 270 from pot
BlueYoko: doesn't show hand
*** SUMMARY ***
Total pot 270 | Rake 0
Board [ ]
Game ended: 2025/09/14 01:24:16 GMT
Seat 1: Rappture (small blind) folded before Flop
Seat 2: BlueYoko (big blind) collected (270)
Seat 3: kanococo folded before Flop
Seat 4: aWeTodd folded before Flop
Seat 6: CagnusMarlsen folded before Flop
Seat 7: bweee81 (button) folded before Flop

CoinPoker Hand #296434336: Tournament #1369441, ₮0.20 Sat to ₮2 Mini Rumble PKO, 4 Seats GTD Hold'em No Limit (60/120 ante 15 play) 2025/09/14 01:24:17 GMT
Table '4' 7-max Seat #1 is the button
Seat 1: Rappture (18028 in chips)
Seat 2: BlueYoko (4239 in chips)
Seat 3: kanococo (4970 in chips)
Seat 4: aWeTodd (3320 in chips)
Seat 6: CagnusMarlsen (3734 in chips)
Seat 7: bweee81 (11077 in chips)
Rappture: posts the ante 15
BlueYoko: posts the ante 15
kanococo: posts the ante 15
aWeTodd: posts the ante 15
CagnusMarlsen: posts the ante 15
bweee81: posts the ante 15
BlueYoko: posts small blind 60
kanococo: posts big blind 120
*** HOLE CARDS ***
Dealt to kanococo [Qs 6c]
aWeTodd: calls 120
CagnusMarlsen: folds
bweee81: folds
Rappture: folds
BlueYoko: folds
kanococo: checks
*** FLOP *** [Ts Qc 7d]
kanococo: checks
aWeTodd: checks
*** TURN *** [Ts Qc 7d] [9d]
kanococo: bets 360
aWeTodd: calls 360
*** RIVER *** [Ts Qc 7d 9d] [8d]
kanococo: bets 4475 and is all-in
aWeTodd: folds
Uncalled bet (4475) returned to kanococo
kanococo collected 1110 from pot
kanococo: doesn't show hand
*** SUMMARY ***
Total pot 1110 | Rake 0
Board [ Ts Qc 7d 9d 8d ]
Game ended: 2025/09/14 01:25:02 GMT
Seat 1: Rappture (button) folded before Flop
Seat 2: BlueYoko (small blind) folded before Flop
Seat 3: kanococo (big blind) collected (1110)
Seat 4: aWeTodd folded on the River
Seat 6: CagnusMarlsen folded before Flop
Seat 7: bweee81 folded before Flop

CoinPoker Hand #296434503: Tournament #1369441, ₮0.20 Sat to ₮2 Mini Rumble PKO, 4 Seats GTD Hold'em No Limit (75/150 ante 19 play) 2025/09/14 01:25:07 GMT
Table '4' 7-max Seat #2 is the button
Seat 1: Rappture (18013 in chips)
Seat 2: BlueYoko (4164 in chips)
Seat 3: kanococo (5585 in chips)
Seat 4: aWeTodd (2825 in chips)
Seat 6: CagnusMarlsen (3719 in chips)
Seat 7: bweee81 (11062 in chips)
Rappture: posts the ante 19
BlueYoko: posts the ante 19
kanococo: posts the ante 19
aWeTodd: posts the ante 19
CagnusMarlsen: posts the ante 19
bweee81: posts the ante 19
kanococo: posts small blind 75
aWeTodd: posts big blind 150
*** HOLE CARDS ***
Dealt to kanococo [2s Ks]
CagnusMarlsen: folds
bweee81: folds
Rappture: folds
BlueYoko: raises 489 to 639
kanococo: calls 564
aWeTodd: folds
*** FLOP *** [9d 6s Td]
kanococo: checks
BlueYoko: checks
*** TURN *** [9d 6s Td] [5d]
kanococo: checks
BlueYoko: checks
*** RIVER *** [9d 6s Td 5d] [Jh]
kanococo: checks
BlueYoko: checks
*** SHOW DOWN ***
kanococo: shows [2s Ks] (King high)
BlueYoko: shows [Qh Ac] (Ace high)
BlueYoko collected 1542 from pot
*** SUMMARY ***
Total pot 1542 | Rake 0
Board [ 9d 6s Td 5d Jh ]
Game ended: 2025/09/14 01:25:49 GMT
Seat 1: Rappture folded before Flop
Seat 2: BlueYoko (button) showed [Qh Ac] and won (1542) with Ace high
Seat 3: kanococo (small blind) showed [2s Ks]
Seat 4: aWeTodd (big blind) folded before Flop
Seat 6: CagnusMarlsen folded before Flop
Seat 7: bweee81 folded before Flop

CoinPoker Hand #296434587: Hold'em No Limit (0.01/0.02 ) 2025/09/14 01:25:34 GMT
Table 'NL ₮2 V' 7-max Seat #4 is the button
Seat 1: omittimo (0.92 in chips)
Seat 2: Krelis (1.94 in chips)
Seat 3: kanococo (2.06 in chips)
Seat 4: 0bsidiana777 (1.86 in chips)
Seat 5: Mark72751 (3.52 in chips)
Seat 6: SQuest (5.66 in chips)
Seat 7: tu2tu (3.19 in chips)
Mark72751: posts small blind 0.01
SQuest: didn't post big blind
tu2tu: posts big blind 0.02
*** HOLE CARDS ***
Dealt to kanococo [Qh 5d]
omittimo: folds
Krelis: raises 0.02 to 0.04
kanococo: folds
0bsidiana777: raises 0.04 to 0.08
Mark72751: calls 0.07
tu2tu: folds
Krelis: calls 0.04
*** FLOP *** [8h 9s 6s]
Mark72751: checks
Krelis: checks
0bsidiana777: bets 0.18
Mark72751: raises 3.44 and is all-in
Krelis: folds
0bsidiana777: calls 1.60 and is all-in
Uncalled bet (1.66) returned to Mark72751
*** TURN *** [8h 9s 6s] [Kc]
*** RIVER *** [8h 9s 6s Kc] [Ad]
*** SHOW DOWN ***
Mark72751: shows [Jd Jh] (a pair of Jacks)
0bsidiana777: shows [Ah As] (three of kind, Aces)
0bsidiana777 collected 3.63 from pot
*** SUMMARY ***
Total pot 3.82 | Rake 0.19
Board [ 8h 9s 6s Kc Ad ]
Game ended: 2025/09/14 01:27:10 GMT
Seat 1: omittimo folded before Flop (didn't bet)
Seat 2: Krelis folded on the Flop
Seat 3: kanococo folded before Flop (didn't bet)
Seat 4: 0bsidiana777 (button) showed [Ah As] and won (3.63) with three of kind, Aces
Seat 5: Mark72751 (small blind) showed [Jd Jh]
Seat 6: SQuest folded before Flop (didn't bet)
Seat 7: tu2tu (big blind) folded before Flop

CoinPoker Hand #296434680: Tournament #1369441, ₮0.20 Sat to ₮2 Mini Rumble PKO, 4 Seats GTD Hold'em No Limit (75/150 ante 19 play) 2025/09/14 01:25:50 GMT
Table '4' 7-max Seat #3 is the button
Seat 1: Rappture (17994 in chips)
Seat 2: BlueYoko (5048 in chips)
Seat 3: kanococo (4927 in chips)
Seat 4: aWeTodd (2656 in chips)
Seat 6: CagnusMarlsen (3700 in chips)
Seat 7: bweee81 (11043 in chips)
Rappture: posts the ante 19
BlueYoko: posts the ante 19
kanococo: posts the ante 19
aWeTodd: posts the ante 19
CagnusMarlsen: posts the ante 19
bweee81: posts the ante 19
aWeTodd: posts small blind 75
CagnusMarlsen: posts big blind 150
*** HOLE CARDS ***
Dealt to kanococo [Ks Qs]
bweee81: folds
Rappture: folds
BlueYoko: calls 150
kanococo: raises 600 to 750
aWeTodd: folds
JavierSarduy01 has reconnected
CagnusMarlsen: folds
BlueYoko: calls 600
*** FLOP *** [5d Ad 6h]
BlueYoko: checks
kanococo: checks
*** TURN *** [5d Ad 6h] [Jd]
BlueYoko: bets 919
kanococo: calls 919
*** RIVER *** [5d Ad 6h Jd] [3h]
BlueYoko: bets 1838
kanococo has timed out
kanococo activated time-bank (30 seconds)
kanococo: folds
Uncalled bet (1838) returned to BlueYoko
BlueYoko collected 3677 from pot
BlueYoko: doesn't show hand
*** SUMMARY ***
Total pot 3677 | Rake 0
Board [ 5d Ad 6h Jd 3h ]
Game ended: 2025/09/14 01:26:57 GMT
Seat 1: Rappture folded before Flop
Seat 2: BlueYoko collected (3677)
Seat 3: kanococo (button) folded on the River
Seat 4: aWeTodd (small blind) folded before Flop
Seat 6: CagnusMarlsen (big blind) folded before Flop
Seat 7: bweee81 folded before Flop

CoinPoker Hand #296434830: Tournament #1369441, ₮0.20 Sat to ₮2 Mini Rumble PKO, 4 Seats GTD Hold'em No Limit (75/150 ante 19 play) 2025/09/14 01:26:58 GMT
Table '4' 7-max Seat #4 is the button
Seat 1: Rappture (17975 in chips)
Seat 2: BlueYoko (7037 in chips)
Seat 3: kanococo (3239 in chips)
Seat 4: aWeTodd (2562 in chips)
Seat 5: JavierSarduy01 (5000 in chips) out of hand
Seat 6: CagnusMarlsen (3531 in chips)
Seat 7: bweee81 (11024 in chips)
Rappture: posts the ante 19
BlueYoko: posts the ante 19
kanococo: posts the ante 19
aWeTodd: posts the ante 19
CagnusMarlsen: posts the ante 19
bweee81: posts the ante 19
CagnusMarlsen: posts small blind 75
bweee81: posts big blind 150
*** HOLE CARDS ***
Dealt to kanococo [6h 6d]
Rappture: folds
BlueYoko: folds
kanococo: raises 600 to 750
aWeTodd: folds
CagnusMarlsen: folds
bweee81: calls 600
*** FLOP *** [7c 3d 5d]
bweee81: checks
kanococo: bets 1050
bweee81: folds
Uncalled bet (1050) returned to kanococo
kanococo collected 1689 from pot
kanococo: doesn't show hand
*** SUMMARY ***
Total pot 1689 | Rake 0
Board [ 7c 3d 5d ]
Game ended: 2025/09/14 01:27:38 GMT
Seat 1: Rappture folded before Flop
Seat 2: BlueYoko folded before Flop
Seat 3: kanococo collected (1689)
Seat 4: aWeTodd (button) folded before Flop
Seat 5: JavierSarduy01 folded before Flop (didn't bet)
Seat 6: CagnusMarlsen (small blind) folded before Flop
Seat 7: bweee81 (big blind) folded on the Flop

CoinPoker Hand #296434848: Hold'em No Limit (0.01/0.02 ) 2025/09/14 01:27:13 GMT
Table 'NL ₮2 V' 7-max Seat #5 is the button
Seat 1: D3ATHANG3L (0.80 in chips)
Seat 2: Krelis (1.86 in chips)
Seat 3: kanococo (2.06 in chips)
Seat 4: 0bsidiana777 (3.63 in chips)
Seat 5: Mark72751 (2.00 in chips)
Seat 6: Ballbag (0.80 in chips)
Seat 7: tu2tu (3.17 in chips)
tu2tu: posts small blind 0.01
D3ATHANG3L: posts big blind 0.02
Ballbag: posts big blind 0.02
*** HOLE CARDS ***
Dealt to kanococo [9s As]
Krelis has timed out
Krelis activated time-bank (56 seconds)
Krelis: folds
kanococo: raises 0.04 to 0.06
0bsidiana777: folds
Mark72751: raises 0.14 to 0.20
Ballbag: folds
tu2tu: folds
D3ATHANG3L: folds
kanococo: calls 0.14
*** FLOP *** [Jc Qs Jd]
kanococo: bets 0.21
Mark72751: folds
Uncalled bet (0.21) returned to kanococo
kanococo collected 0.43 from pot
kanococo: doesn't show hand
*** SUMMARY ***
Total pot 0.45 | Rake 0.02
Board [ Jc Qs Jd ]
Game ended: 2025/09/14 01:29:02 GMT
Seat 1: D3ATHANG3L (big blind) folded before Flop
Seat 2: Krelis folded before Flop (didn't bet)
Seat 3: kanococo collected (0.43)
Seat 4: 0bsidiana777 folded before Flop (didn't bet)
Seat 5: Mark72751 (button) folded on the Flop
Seat 6: Ballbag folded before Flop
Seat 7: tu2tu (small blind) folded before Flop

CoinPoker Hand #296435046: Tournament #1369441, ₮0.20 Sat to ₮2 Mini Rumble PKO, 4 Seats GTD Hold'em No Limit (75/150 ante 19 play) 2025/09/14 01:27:40 GMT
Table '4' 7-max Seat #6 is the button
Seat 1: Rappture (17956 in chips)
Seat 2: BlueYoko (7018 in chips)
Seat 3: kanococo (4159 in chips)
Seat 4: aWeTodd (2543 in chips)
Seat 5: JavierSarduy01 (5000 in chips)
Seat 6: CagnusMarlsen (3437 in chips)
Seat 7: bweee81 (10255 in chips)
Rappture: posts the ante 19
BlueYoko: posts the ante 19
kanococo: posts the ante 19
aWeTodd: posts the ante 19
JavierSarduy01: posts the ante 19
CagnusMarlsen: posts the ante 19
bweee81: posts the ante 19
bweee81: posts small blind 75
Rappture: posts big blind 150
*** HOLE CARDS ***
Dealt to kanococo [7s 2c]
BlueYoko: folds
kanococo: folds
aWeTodd: calls 150
JavierSarduy01: folds
CagnusMarlsen: folds
bweee81 has timed out
bweee81 activated time-bank (28 seconds)
bweee81: calls 75
Rappture: checks
*** FLOP *** [2s 6h 3d]
bweee81: bets 300
Rappture: calls 300
aWeTodd: calls 300
*** TURN *** [2s 6h 3d] [Kh]
bweee81: checks
Rappture: checks
aWeTodd: checks
*** RIVER *** [2s 6h 3d Kh] [3c]
bweee81: checks
Rappture: bets 600
aWeTodd: folds
bweee81: folds
Uncalled bet (600) returned to Rappture
Rappture collected 1483 from pot
Rappture: doesn't show hand
*** SUMMARY ***
Total pot 1483 | Rake 0
Board [ 2s 6h 3d Kh 3c ]
Game ended: 2025/09/14 01:29:07 GMT
Seat 1: Rappture (big blind) collected (1483)
Seat 2: BlueYoko folded before Flop
Seat 3: kanococo folded before Flop
Seat 4: aWeTodd folded on the River
Seat 5: JavierSarduy01 folded before Flop
Seat 6: CagnusMarlsen (button) folded before Flop
Seat 7: bweee81 (small blind) folded on the River

CoinPoker Hand #296435222: Hold'em No Limit (0.01/0.02 ) 2025/09/14 01:29:05 GMT
Table 'NL ₮2 V' 7-max Seat #7 is the button
Seat 1: D3ATHANG3L (0.78 in chips)
Seat 3: kanococo (2.29 in chips)
Seat 5: Mark72751 (2.00 in chips)
Seat 6: Ballbag (0.78 in chips)
Seat 7: tu2tu (3.16 in chips)
D3ATHANG3L: posts small blind 0.01
kanococo: posts big blind 0.02
*** HOLE CARDS ***
Dealt to kanococo [5c 4h]
Mark72751: folds
Ballbag: folds
tu2tu: raises 3.16 and is all-in
D3ATHANG3L: folds
kanococo: folds
tu2tu collected 3.19 from pot
tu2tu: doesn't show hand
*** SUMMARY ***
Total pot 3.19 | Rake 0.00
Board [ ]
Game ended: 2025/09/14 01:29:31 GMT
Seat 1: D3ATHANG3L (small blind) folded before Flop
Seat 3: kanococo (big blind) folded before Flop
Seat 5: Mark72751 folded before Flop (didn't bet)
Seat 6: Ballbag folded before Flop (didn't bet)
Seat 7: tu2tu (button) collected (3.19)

CoinPoker Hand #296435226: Tournament #1369441, ₮0.20 Sat to ₮2 Mini Rumble PKO, 4 Seats GTD Hold'em No Limit (75/150 ante 19 play) 2025/09/14 01:29:08 GMT
Table '4' 7-max Seat #7 is the button
Seat 1: Rappture (18970 in chips)
Seat 2: BlueYoko (6999 in chips)
Seat 3: kanococo (4140 in chips)
Seat 4: aWeTodd (2074 in chips)
Seat 5: JavierSarduy01 (4981 in chips)
Rappture: posts the ante 19
BlueYoko: posts the ante 19
kanococo: posts the ante 19
aWeTodd: posts the ante 19
JavierSarduy01: posts the ante 19
Rappture: posts small blind 75
BlueYoko: posts big blind 150
*** HOLE CARDS ***
Dealt to kanococo [3d 3c]
kanococo: raises 300 to 450
aWeTodd: folds
JavierSarduy01: folds
Rappture: folds
BlueYoko: folds
kanococo collected 770 from pot
kanococo: doesn't show hand
*** SUMMARY ***
Total pot 770 | Rake 0
Board [ ]
Game ended: 2025/09/14 01:29:32 GMT
Seat 1: Rappture (small blind) folded before Flop
Seat 2: BlueYoko (big blind) folded before Flop
Seat 3: kanococo collected (770)
Seat 4: aWeTodd folded before Flop
Seat 5: JavierSarduy01 folded before Flop

CoinPoker Hand #296435298: Hold'em No Limit (0.01/0.02 ) 2025/09/14 01:29:33 GMT
Table 'NL ₮2 V' 7-max Seat #1 is the button
Seat 1: D3ATHANG3L (0.77 in chips)
Seat 2: FrankGrimes (2.00 in chips)
Seat 3: kanococo (2.27 in chips)
Seat 4: onelove1999 (2.00 in chips)
Seat 5: Mark72751 (2.00 in chips)
Seat 6: Ballbag (0.78 in chips)
Seat 7: tu2tu (3.19 in chips)
kanococo: posts small blind 0.01
onelove1999: posts big blind 0.02
FrankGrimes: posts big blind 0.02
*** HOLE CARDS ***
Dealt to kanococo [8d Js]
Mark72751: folds
Ballbag: folds
tu2tu: folds
D3ATHANG3L: folds
FrankGrimes: checks
kanococo: raises 0.06 to 0.08
onelove1999: folds
FrankGrimes: calls 0.06
*** FLOP *** [Jh Ah 2h]
FrankGrimes: checks
kanococo: bets 0.12
FrankGrimes: folds
Uncalled bet (0.12) returned to kanococo
kanococo collected 0.17 from pot
kanococo: doesn't show hand
*** SUMMARY ***
Total pot 0.18 | Rake 0.01
Board [ Jh Ah 2h ]
Game ended: 2025/09/14 01:30:20 GMT
Seat 1: D3ATHANG3L (button) folded before Flop (didn't bet)
Seat 2: FrankGrimes folded on the Flop
Seat 3: kanococo (small blind) collected (0.17)
Seat 4: onelove1999 (big blind) folded before Flop
Seat 5: Mark72751 folded before Flop (didn't bet)
Seat 6: Ballbag folded before Flop (didn't bet)
Seat 7: tu2tu folded before Flop (didn't bet)

CoinPoker Hand #296435278: Tournament #1369441, ₮0.20 Sat to ₮2 Mini Rumble PKO, 4 Seats GTD Hold'em No Limit (75/150 ante 19 play) 2025/09/14 01:29:33 GMT
Table '4' 7-max Seat #1 is the button
Seat 1: Rappture (18876 in chips)
Seat 2: BlueYoko (6830 in chips)
Seat 3: kanococo (4441 in chips)
Seat 4: aWeTodd (2055 in chips)
Seat 5: JavierSarduy01 (4962 in chips)
Rappture: posts the ante 19
BlueYoko: posts the ante 19
kanococo: posts the ante 19
aWeTodd: posts the ante 19
JavierSarduy01: posts the ante 19
BlueYoko: posts small blind 75
kanococo: posts big blind 150
*** HOLE CARDS ***
Dealt to kanococo [Qc Th]
aWeTodd: calls 150
JavierSarduy01: raises 300 to 450
Rappture: calls 450
BlueYoko: folds
kanococo: calls 300
aWeTodd: calls 300
*** FLOP *** [Kc 7d As]
kanococo: checks
aWeTodd: checks
JavierSarduy01: bets 750
Rappture: folds
kanococo: calls 750
aWeTodd: folds
*** TURN *** [Kc 7d As] [2h]
kanococo: checks
JavierSarduy01: bets 1500
kanococo: folds
Uncalled bet (1500) returned to JavierSarduy01
JavierSarduy01 collected 3470 from pot
JavierSarduy01: doesn't show hand
*** SUMMARY ***
Total pot 3470 | Rake 0
Board [ Kc 7d As 2h ]
Game ended: 2025/09/14 01:30:50 GMT
Seat 1: Rappture (button) folded on the Flop
Seat 2: BlueYoko (small blind) folded before Flop
Seat 3: kanococo (big blind) folded on the Turn
Seat 4: aWeTodd folded on the Flop
Seat 5: JavierSarduy01 collected (3470)

CoinPoker Hand #296435437: Hold'em No Limit (0.01/0.02 ) 2025/09/14 01:30:22 GMT
Table 'NL ₮2 V' 7-max Seat #3 is the button
Seat 1: D3ATHANG3L (0.77 in chips)
Seat 2: FrankGrimes (1.92 in chips)
Seat 3: kanococo (2.36 in chips)
Seat 4: onelove1999 (1.98 in chips)
Seat 5: Mark72751 (2.00 in chips)
Seat 6: Ballbag (0.78 in chips)
Seat 7: tu2tu (3.19 in chips)
onelove1999: posts small blind 0.01
Mark72751: posts big blind 0.02
*** HOLE CARDS ***
Dealt to kanococo [2s Kc]
Ballbag: folds
tu2tu: folds
D3ATHANG3L: folds
FrankGrimes: folds
kanococo: raises 0.06 to 0.08
onelove1999: folds
Mark72751: raises 0.16 to 0.24
kanococo: folds
Mark72751 collected 0.33 from pot
Mark72751: doesn't show hand
*** SUMMARY ***
Total pot 0.33 | Rake 0.00
Board [ ]
Game ended: 2025/09/14 01:31:01 GMT
Seat 1: D3ATHANG3L folded before Flop (didn't bet)
Seat 2: FrankGrimes folded before Flop (didn't bet)
Seat 3: kanococo (button) folded before Flop
Seat 4: onelove1999 (small blind) folded before Flop
Seat 5: Mark72751 (big blind) collected (0.33)
Seat 6: Ballbag folded before Flop (didn't bet)
Seat 7: tu2tu folded before Flop (didn't bet)

CoinPoker Hand #296435564: Tournament #1369441, ₮0.20 Sat to ₮2 Mini Rumble PKO, 4 Seats GTD Hold'em No Limit (100/200 ante 25 play) 2025/09/14 01:30:56 GMT
Table '4' 7-max Seat #2 is the button
Seat 1: Rappture (18407 in chips)
Seat 2: BlueYoko (6736 in chips)
Seat 3: kanococo (3222 in chips)
Seat 4: aWeTodd (1586 in chips)
Seat 5: JavierSarduy01 (7213 in chips)
Seat 6: Jonathanbluffs (9106 in chips)
Seat 7: PointClickShove (8568 in chips)
Rappture: posts the ante 25
BlueYoko: posts the ante 25
kanococo: posts the ante 25
aWeTodd: posts the ante 25
JavierSarduy01: posts the ante 25
Jonathanbluffs: posts the ante 25
PointClickShove: posts the ante 25
kanococo: posts small blind 100
aWeTodd: posts big blind 200
*** HOLE CARDS ***
Dealt to kanococo [Td 3h]
JavierSarduy01: folds
Jonathanbluffs: folds
PointClickShove: raises 200 to 400
Rappture: folds
BlueYoko: folds
kanococo has timed out
kanococo activated time-bank (28 seconds)
kanococo: raises 600 to 1000
aWeTodd has timed out
aWeTodd: folds
PointClickShove: calls 600
*** FLOP *** [Ac 6s 3s]
kanococo: checks
PointClickShove: bets 7543 and is all-in
kanococo: folds
Uncalled bet (7543) returned to PointClickShove
PointClickShove collected 2375 from pot
PointClickShove: doesn't show hand
*** SUMMARY ***
Total pot 2375 | Rake 0
Board [ Ac 6s 3s ]
Game ended: 2025/09/14 01:31:47 GMT
Seat 1: Rappture folded before Flop
Seat 2: BlueYoko (button) folded before Flop
Seat 3: kanococo (small blind) folded on the Flop
Seat 4: aWeTodd (big blind) folded before Flop
Seat 5: JavierSarduy01 folded before Flop
Seat 6: Jonathanbluffs folded before Flop
Seat 7: PointClickShove collected (2375)

CoinPoker Hand #296435602: Hold'em No Limit (0.01/0.02 ) 2025/09/14 01:31:04 GMT
Table 'NL ₮2 V' 7-max Seat #4 is the button
Seat 1: D3ATHANG3L (0.77 in chips)
Seat 2: FrankGrimes (1.92 in chips)
Seat 3: kanococo (2.28 in chips)
Seat 4: onelove1999 (1.99 in chips)
Seat 5: Mark72751 (2.09 in chips)
Seat 6: Ballbag (0.78 in chips)
Seat 7: tu2tu (3.19 in chips)
Mark72751: posts small blind 0.01
Ballbag: posts big blind 0.02
*** HOLE CARDS ***
Dealt to kanococo [Ad 4s]
tu2tu: folds
D3ATHANG3L: calls 0.02
FrankGrimes: folds
kanococo: folds
onelove1999: folds
Mark72751: folds
Ballbag: raises 0.05 to 0.07
D3ATHANG3L: calls 0.05
*** FLOP *** [7c Qs 9c]
Ballbag: bets 0.07
D3ATHANG3L: calls 0.07
*** TURN *** [7c Qs 9c] [8s]
Ballbag: bets 0.28
D3ATHANG3L: calls 0.28
*** RIVER *** [7c Qs 9c 8s] [Jc]
Ballbag: checks
D3ATHANG3L: bets 0.35 and is all-in
Ballbag: calls 0.35
*** SHOW DOWN ***
D3ATHANG3L: shows [Ac 5c] (a flush, Ace high)
Ballbag: shows [Ah Qc] (a pair of Queens)
D3ATHANG3L collected 1.47 from pot
*** SUMMARY ***
Total pot 1.55 | Rake 0.08
Board [ 7c Qs 9c 8s Jc ]
Game ended: 2025/09/14 01:32:35 GMT
Seat 1: D3ATHANG3L showed [Ac 5c] and won (1.47) with a flush, Ace high
Seat 2: FrankGrimes folded before Flop (didn't bet)
Seat 3: kanococo folded before Flop (didn't bet)
Seat 4: onelove1999 (button) folded before Flop (didn't bet)
Seat 5: Mark72751 (small blind) folded before Flop
Seat 6: Ballbag (big blind) showed [Ah Qc]
Seat 7: tu2tu folded before Flop (didn't bet)

CoinPoker Hand #296435676: Tournament #1369441, ₮0.20 Sat to ₮2 Mini Rumble PKO, 4 Seats GTD Hold'em No Limit (100/200 ante 25 play) 2025/09/14 01:31:48 GMT
Table '4' 7-max Seat #3 is the button
Seat 1: Rappture (18382 in chips)
Seat 2: BlueYoko (6711 in chips)
Seat 3: kanococo (2197 in chips)
Seat 4: aWeTodd (1361 in chips)
Seat 5: JavierSarduy01 (7188 in chips)
Seat 6: Jonathanbluffs (9081 in chips)
Seat 7: PointClickShove (9918 in chips)
Rappture: posts the ante 25
BlueYoko: posts the ante 25
kanococo: posts the ante 25
aWeTodd: posts the ante 25
JavierSarduy01: posts the ante 25
Jonathanbluffs: posts the ante 25
PointClickShove: posts the ante 25
aWeTodd: posts small blind 100
JavierSarduy01: posts big blind 200
*** HOLE CARDS ***
Dealt to kanococo [3d 9h]
Jonathanbluffs: folds
PointClickShove: folds
Rappture: folds
BlueYoko: folds
kanococo: folds
aWeTodd: calls 100
JavierSarduy01: raises 6963 and is all-in
aWeTodd: calls 1136 and is all-in
Uncalled bet (5827) returned to JavierSarduy01
*** FLOP *** [4c 6s Ad]
*** TURN *** [4c 6s Ad] [5s]
*** RIVER *** [4c 6s Ad 5s] [Qs]
*** SHOW DOWN ***
JavierSarduy01: shows [5d Ah] (two pairs, Aces and Fives)
aWeTodd: shows [Qd 6d] (two pairs, Queens and Sixes)
JavierSarduy01 collected 2847 from pot
*** SUMMARY ***
Total pot 2847 | Rake 0
Board [ 4c 6s Ad 5s Qs ]
Game ended: 2025/09/14 01:32:25 GMT
Seat 1: Rappture folded before Flop
Seat 2: BlueYoko folded before Flop
Seat 3: kanococo (button) folded before Flop
Seat 4: aWeTodd (small blind) showed [Qd 6d]
Seat 5: JavierSarduy01 (big blind) showed [5d Ah] and won (2847) with two pairs, Aces and Fives
Seat 6: Jonathanbluffs folded before Flop
Seat 7: PointClickShove folded before Flop

CoinPoker Hand #296435765: Tournament #1369441, ₮0.20 Sat to ₮2 Mini Rumble PKO, 4 Seats GTD Hold'em No Limit (100/200 ante 25 play) 2025/09/14 01:32:26 GMT
Table '4' 7-max Seat #4 is the button
Seat 1: Rappture (18357 in chips)
Seat 2: BlueYoko (6686 in chips)
Seat 3: kanococo (2172 in chips)
Seat 5: JavierSarduy01 (8674 in chips)
Seat 6: Jonathanbluffs (9056 in chips)
Seat 7: PointClickShove (9893 in chips)
Rappture: posts the ante 25
BlueYoko: posts the ante 25
kanococo: posts the ante 25
JavierSarduy01: posts the ante 25
Jonathanbluffs: posts the ante 25
PointClickShove: posts the ante 25
JavierSarduy01: posts small blind 100
Jonathanbluffs: posts big blind 200
*** HOLE CARDS ***
Dealt to kanococo [5c 2c]
PointClickShove: folds
Rappture: folds
BlueYoko: folds
kanococo: folds
JavierSarduy01: raises 200 to 400
Jonathanbluffs: calls 200
*** FLOP *** [Th 8h Ac]
JavierSarduy01: checks
Jonathanbluffs: checks
*** TURN *** [Th 8h Ac] [Ad]
JavierSarduy01: bets 200
Jonathanbluffs: calls 200
*** RIVER *** [Th 8h Ac Ad] [5s]
JavierSarduy01: checks
Jonathanbluffs: checks
*** SHOW DOWN ***
JavierSarduy01: shows [2d 8d] (two pairs, Aces and Eights)
Jonathanbluffs: mucks hand
JavierSarduy01 collected 1350 from pot
*** SUMMARY ***
Total pot 1350 | Rake 0
Board [ Th 8h Ac Ad 5s ]
Game ended: 2025/09/14 01:33:07 GMT
Seat 1: Rappture folded before Flop
Seat 2: BlueYoko folded before Flop
Seat 3: kanococo folded before Flop
Seat 5: JavierSarduy01 (small blind) showed [2d 8d] and won (1350) with two pairs, Aces and Eights
Seat 6: Jonathanbluffs (big blind) mucked
Seat 7: PointClickShove folded before Flop

CoinPoker Hand #296435882: Hold'em No Limit (0.01/0.02 ) 2025/09/14 01:32:44 GMT
Table 'NL ₮2 V' 7-max Seat #5 is the button
Seat 2: FrankGrimes (1.92 in chips)
Seat 3: kanococo (2.28 in chips)
Seat 4: onelove1999 (2.00 in chips)
Seat 5: Mark72751 (2.08 in chips)
Seat 6: Ballbag (0.80 in chips)
Seat 7: tu2tu (3.19 in chips)
Ballbag: posts small blind 0.01
tu2tu: posts big blind 0.02
*** HOLE CARDS ***
Dealt to kanococo [8h Ad]
FrankGrimes: folds
kanococo has timed out
kanococo activated time-bank (55 seconds)
kanococo: raises 0.06 to 0.08
onelove1999: folds
Mark72751: folds
Ballbag: folds
tu2tu: folds
kanococo collected 0.11 from pot
kanococo: doesn't show hand
*** SUMMARY ***
Total pot 0.11 | Rake 0.00
Board [ ]
Game ended: 2025/09/14 01:33:23 GMT
Seat 2: FrankGrimes folded before Flop (didn't bet)
Seat 3: kanococo collected (0.11)
Seat 4: onelove1999 folded before Flop (didn't bet)
Seat 5: Mark72751 (button) folded before Flop (didn't bet)
Seat 6: Ballbag (small blind) folded before Flop
Seat 7: tu2tu (big blind) folded before Flop

CoinPoker Hand #296435906: Tournament #1369441, ₮0.20 Sat to ₮2 Mini Rumble PKO, 4 Seats GTD Hold'em No Limit (100/200 ante 25 play) 2025/09/14 01:33:08 GMT
Table '4' 7-max Seat #5 is the button
Seat 1: Rappture (18332 in chips)
Seat 2: BlueYoko (6661 in chips)
Seat 3: kanococo (2147 in chips)
Seat 5: JavierSarduy01 (9399 in chips)
Seat 6: Jonathanbluffs (8431 in chips)
Seat 7: PointClickShove (9868 in chips)
Rappture: posts the ante 25
BlueYoko: posts the ante 25
kanococo: posts the ante 25
JavierSarduy01: posts the ante 25
Jonathanbluffs: posts the ante 25
PointClickShove: posts the ante 25
Jonathanbluffs: posts small blind 100
PointClickShove: posts big blind 200
*** HOLE CARDS ***
Dealt to kanococo [Ts 4c]
Rappture: raises 240 to 440
BlueYoko: folds
kanococo: folds
JavierSarduy01: folds
Jonathanbluffs: calls 340
PointClickShove: folds
*** FLOP *** [Jc Jd Jh]
Jonathanbluffs: checks
Rappture: bets 467
Jonathanbluffs: folds
Uncalled bet (467) returned to Rappture
Rappture collected 1230 from pot
Rappture: doesn't show hand
*** SUMMARY ***
Total pot 1230 | Rake 0
Board [ Jc Jd Jh ]
Game ended: 2025/09/14 01:33:49 GMT
Seat 1: Rappture collected (1230)
Seat 2: BlueYoko folded before Flop
Seat 3: kanococo folded before Flop
Seat 5: JavierSarduy01 (button) folded before Flop
Seat 6: Jonathanbluffs (small blind) folded on the Flop
Seat 7: PointClickShove (big blind) folded before Flop

CoinPoker Hand #296436016: Hold'em No Limit (0.01/0.02 ) 2025/09/14 01:33:25 GMT
Table 'NL ₮2 V' 7-max Seat #6 is the button
Seat 1: DarGeo (2.00 in chips)
Seat 2: FrankGrimes (1.92 in chips)
Seat 3: kanococo (2.31 in chips)
Seat 4: onelove1999 (2.00 in chips)
Seat 5: Mark72751 (2.08 in chips)
Seat 6: Ballbag (0.79 in chips)
Seat 7: tu2tu (3.17 in chips)
tu2tu: posts small blind 0.01
DarGeo: posts big blind 0.02
*** HOLE CARDS ***
Dealt to kanococo [5d 7h]
FrankGrimes has timed out
FrankGrimes activated time-bank (60 seconds)
FrankGrimes: calls 0.02
kanococo: folds
onelove1999: folds
Mark72751: folds
Ballbag: folds
tu2tu: raises 3.16 and is all-in
DarGeo: folds
FrankGrimes: folds
tu2tu collected 3.21 from pot
tu2tu: doesn't show hand
*** SUMMARY ***
Total pot 3.21 | Rake 0.00
Board [ ]
Game ended: 2025/09/14 01:34:13 GMT
Seat 1: DarGeo (big blind) folded before Flop
Seat 2: FrankGrimes folded before Flop
Seat 3: kanococo folded before Flop (didn't bet)
Seat 4: onelove1999 folded before Flop (didn't bet)
Seat 5: Mark72751 folded before Flop (didn't bet)
Seat 6: Ballbag (button) folded before Flop (didn't bet)
Seat 7: tu2tu (small blind) collected (3.21)

CoinPoker Hand #296436008: Tournament #1369441, ₮0.20 Sat to ₮2 Mini Rumble PKO, 4 Seats GTD Hold'em No Limit (100/200 ante 25 play) 2025/09/14 01:33:50 GMT
Table '4' 7-max Seat #6 is the button
Seat 1: Rappture (19097 in chips)
Seat 2: BlueYoko (6636 in chips)
Seat 3: kanococo (2122 in chips)
Seat 5: JavierSarduy01 (9374 in chips)
Seat 6: Jonathanbluffs (7966 in chips)
Seat 7: PointClickShove (9643 in chips)
Rappture: posts the ante 25
BlueYoko: posts the ante 25
kanococo: posts the ante 25
JavierSarduy01: posts the ante 25
Jonathanbluffs: posts the ante 25
PointClickShove: posts the ante 25
PointClickShove: posts small blind 100
Rappture: posts big blind 200
*** HOLE CARDS ***
Dealt to kanococo [Jh Qs]
BlueYoko: folds
kanococo: raises 2097 and is all-in
JavierSarduy01: folds
Jonathanbluffs: folds
PointClickShove has timed out
PointClickShove activated time-bank (21 seconds)
PointClickShove: folds
Rappture: folds
kanococo collected 2547 from pot
kanococo: doesn't show hand
*** SUMMARY ***
Total pot 2547 | Rake 0
Board [ ]
Game ended: 2025/09/14 01:34:18 GMT
Seat 1: Rappture (big blind) folded before Flop
Seat 2: BlueYoko folded before Flop
Seat 3: kanococo collected (2547)
Seat 5: JavierSarduy01 folded before Flop
Seat 6: Jonathanbluffs (button) folded before Flop
Seat 7: PointClickShove (small blind) folded before Flop

CoinPoker Hand #296436220: Hold'em No Limit (0.01/0.02 ) 2025/09/14 01:34:15 GMT
Table 'NL ₮2 V' 7-max Seat #7 is the button
Seat 1: DarGeo (1.98 in chips)
Seat 2: FrankGrimes (1.90 in chips)
Seat 3: kanococo (2.31 in chips)
Seat 4: onelove1999 (2.00 in chips)
Seat 5: Mark72751 (2.08 in chips)
Seat 6: Ballbag (0.79 in chips)
Seat 7: tu2tu (3.21 in chips)
DarGeo: posts small blind 0.01
FrankGrimes: posts big blind 0.02
*** HOLE CARDS ***
Dealt to kanococo [Kd Jd]
kanococo: raises 0.06 to 0.08
onelove1999: folds
Mark72751: folds
Ballbag: raises 0.19 to 0.27
tu2tu: folds
DarGeo: folds
FrankGrimes: folds
kanococo: calls 0.19
*** FLOP *** [3s 9s 9d]
kanococo: checks
Ballbag: bets 0.27
kanococo has timed out
kanococo activated time-bank (53 seconds)
kanococo: raises 0.27 to 0.54
Ballbag: calls 0.25 and is all-in
Uncalled bet (0.02) returned to kanococo
*** TURN *** [3s 9s 9d] [4c]
*** RIVER *** [3s 9s 9d 4c] [4d]
*** SHOW DOWN ***
kanococo: shows [Kd Jd] (two pairs, Nines and Fours)
Ballbag: shows [Ah Ad] (two pairs, Aces and Nines)
Ballbag collected 1.53 from pot
*** SUMMARY ***
Total pot 1.61 | Rake 0.08
Board [ 3s 9s 9d 4c 4d ]
Game ended: 2025/09/14 01:35:18 GMT
Seat 1: DarGeo (small blind) folded before Flop
Seat 2: FrankGrimes (big blind) folded before Flop
Seat 3: kanococo showed [Kd Jd]
Seat 4: onelove1999 folded before Flop (didn't bet)
Seat 5: Mark72751 folded before Flop (didn't bet)
Seat 6: Ballbag showed [Ah Ad] and won (1.53) with two pairs, Aces and Nines
Seat 7: tu2tu (button) folded before Flop (didn't bet)

CoinPoker Hand #296436116: Tournament #1369441, ₮0.20 Sat to ₮2 Mini Rumble PKO, 4 Seats GTD Hold'em No Limit (100/200 ante 25 play) 2025/09/14 01:34:19 GMT
Table '4' 7-max Seat #7 is the button
Seat 1: Rappture (18872 in chips)
Seat 2: BlueYoko (6611 in chips)
Seat 3: kanococo (2547 in chips)
Seat 5: JavierSarduy01 (9349 in chips)
Seat 6: Jonathanbluffs (7941 in chips)
Seat 7: PointClickShove (9518 in chips)
Rappture: posts the ante 25
BlueYoko: posts the ante 25
kanococo: posts the ante 25
JavierSarduy01: posts the ante 25
Jonathanbluffs: posts the ante 25
PointClickShove: posts the ante 25
Rappture: posts small blind 100
BlueYoko: posts big blind 200
*** HOLE CARDS ***
Dealt to kanococo [8s 8d]
kanococo: raises 2522 and is all-in
JavierSarduy01: folds
Jonathanbluffs: calls 2522
PointClickShove: folds
Rappture: folds
BlueYoko: raises 6386 and is all-in
Jonathanbluffs: calls 4064
*** FLOP *** [9s 5h 8h]
*** TURN *** [9s 5h 8h] [2d]
*** RIVER *** [9s 5h 8h 2d] [Th]
*** SHOW DOWN ***
BlueYoko: shows [9h 9d] (three of kind, Nines)
Jonathanbluffs: shows [5c Ac] (a pair of Fives)
BlueYoko collected 8128 from side-pot 1
kanococo: shows [8s 8d] (three of kind, Eights)
BlueYoko collected 7816 from pot
*** SUMMARY ***
Total pot 15944 | Rake 0
Board [ 9s 5h 8h 2d Th ]
Game ended: 2025/09/14 01:34:56 GMT
Seat 1: Rappture (small blind) folded before Flop
Seat 2: BlueYoko (big blind) showed [9h 9d] and won (15944) with three of kind, Nines
Seat 3: kanococo showed [8s 8d]
Seat 5: JavierSarduy01 folded before Flop
Seat 6: Jonathanbluffs showed [5c Ac]
Seat 7: PointClickShove (button) folded before Flop

CoinPoker Hand #296436434: Hold'em No Limit (0.01/0.02 ) 2025/09/14 01:35:20 GMT
Table 'NL ₮2 V' 7-max Seat #1 is the button
Seat 1: DarGeo (1.99 in chips)
Seat 2: FrankGrimes (1.88 in chips)
Seat 3: kanococo (1.52 in chips)
Seat 4: onelove1999 (2.00 in chips)
Seat 5: Mark72751 (2.08 in chips)
Seat 6: Ballbag (1.53 in chips)
Seat 7: tu2tu (3.21 in chips)
FrankGrimes: posts small blind 0.01
kanococo: posts big blind 0.02
*** HOLE CARDS ***
Dealt to kanococo [8d 8c]
onelove1999: folds
Mark72751: folds
Ballbag: folds
tu2tu: folds
DarGeo: raises 0.03 to 0.05
FrankGrimes: folds
kanococo: raises 0.05 to 0.10
DarGeo has timed out
DarGeo activated time-bank (60 seconds)
DarGeo: raises 0.20 to 0.30
kanococo: calls 0.20
*** FLOP *** [5d 2s 3c]
kanococo: checks
DarGeo: checks
*** TURN *** [5d 2s 3c] [Ah]
kanococo: bets 0.32
DarGeo: calls 0.32
*** RIVER *** [5d 2s 3c Ah] [Qh]
kanococo: bets 0.90 and is all-in
DarGeo: calls 0.90
*** SHOW DOWN ***
kanococo: shows [8d 8c] (a pair of Eights)
DarGeo: shows [Kh Ac] (a pair of Aces)
DarGeo collected 2.90 from pot
*** SUMMARY ***
Total pot 3.05 | Rake 0.15
Board [ 5d 2s 3c Ah Qh ]
Game ended: 2025/09/14 01:37:08 GMT
Seat 1: DarGeo (button) showed [Kh Ac] and won (2.90) with a pair of Aces
Seat 2: FrankGrimes (small blind) folded before Flop
Seat 3: kanococo (big blind) showed [8d 8c]
Seat 4: onelove1999 folded before Flop (didn't bet)
Seat 5: Mark72751 folded before Flop (didn't bet)
Seat 6: Ballbag folded before Flop (didn't bet)
Seat 7: tu2tu folded before Flop (didn't bet)

CoinPoker Hand #296797232: Tournament #1369803, Bankroll Starter Freeroll, 5 x ₮1 tickets Hold'em No Limit (100/200 ante 25 play) 2025/09/14 18:40:30 GMT
Table '43' 7-max Seat #1 is the button
Seat 1: Kccable8 (15132 in chips)
Seat 2: Dzomi123 (5000 in chips)
Seat 3: Frenaldinho (5000 in chips)
Seat 5: kanococo (5000 in chips)
Seat 7: Zenby (5000 in chips)
Kccable8: posts the ante 25
Dzomi123: posts the ante 25
Frenaldinho: posts the ante 25
kanococo: posts the ante 25
Zenby: posts the ante 25
Dzomi123: posts small blind 100
Frenaldinho: posts big blind 200
*** HOLE CARDS ***
Dealt to kanococo [4d 2s]
saidafrente has reconnected
kanococo: folds
Zenby: folds
Kccable8: raises 200 to 400
Frenaldinho is disconnected
Dzomi123 has timed out
Dzomi123: folds
Frenaldinho has timed out wile being disconnected
Frenaldinho activated time-bank (30 seconds)
Frenaldinho has reconnected
Frenaldinho: calls 200
*** FLOP *** [4c 9s 5c]
Frenaldinho: bets 512
Kccable8: raises 512 to 1024
Frenaldinho: calls 512
*** TURN *** [4c 9s 5c] [5h]
Frenaldinho: bets 600
Kccable8: calls 600
*** RIVER *** [4c 9s 5c 5h] [Kc]
Frenaldinho: checks
Kccable8: checks
*** SHOW DOWN ***
Frenaldinho: shows [9h 7d] (two pairs, Nines and Fives)
Kccable8: mucks hand
Frenaldinho collected 4273 from pot
*** SUMMARY ***
Total pot 4273 | Rake 0
Board [ 4c 9s 5c 5h Kc ]
Game ended: 2025/09/14 18:41:36 GMT
Seat 1: Kccable8 (button) mucked
Seat 2: Dzomi123 (small blind) folded before Flop
Seat 3: Frenaldinho (big blind) showed [9h 7d] and won (4273) with two pairs, Nines and Fives
Seat 5: kanococo folded before Flop
Seat 7: Zenby folded before Flop

CoinPoker Hand #296798070: Tournament #1369803, Bankroll Starter Freeroll, 5 x ₮1 tickets Hold'em No Limit (100/200 ante 25 play) 2025/09/14 18:41:37 GMT
Table '43' 7-max Seat #2 is the button
Seat 2: Dzomi123 (4875 in chips)
Seat 3: Frenaldinho (7224 in chips)
Seat 4: Ferd0ws (4630 in chips)
Seat 5: kanococo (4975 in chips)
Seat 6: saidafrente (5000 in chips)
Seat 7: Zenby (4975 in chips)
Dzomi123: posts the ante 25
Frenaldinho: posts the ante 25
Ferd0ws: posts the ante 25
kanococo: posts the ante 25
saidafrente: posts the ante 25
Zenby: posts the ante 25
Frenaldinho: posts small blind 100
Ferd0ws: posts big blind 200
*** HOLE CARDS ***
Dealt to kanococo [Ac 5d]
kanococo: raises 600 to 800
saidafrente: folds
Zenby: folds
Dzomi123: calls 800
Frenaldinho: calls 700
Ferd0ws: folds
*** FLOP *** [3h 3s 5c]
Frenaldinho: bets 600
kanococo: calls 600
Dzomi123: folds
*** TURN *** [3h 3s 5c] [9h]
Frenaldinho: bets 600
kanococo: raises 800 to 1400
Frenaldinho: calls 800
*** RIVER *** [3h 3s 5c 9h] [6c]
Frenaldinho: checks
kanococo: checks
*** SHOW DOWN ***
Frenaldinho: shows [5s 2c] (two pairs, Fives and Threes)
kanococo: shows [Ac 5d] (two pairs, Fives and Threes)
kanococo collected 6750 from pot
*** SUMMARY ***
Total pot 6750 | Rake 0
Board [ 3h 3s 5c 9h 6c ]
Game ended: 2025/09/14 18:42:26 GMT
Seat 2: Dzomi123 (button) folded on the Flop
Seat 3: Frenaldinho (small blind) showed [5s 2c]
Seat 4: Ferd0ws (big blind) folded before Flop
Seat 5: kanococo showed [Ac 5d] and won (6750) with two pairs, Fives and Threes
Seat 6: saidafrente folded before Flop
Seat 7: Zenby folded before Flop

CoinPoker Hand #296798931: Tournament #1369803, Bankroll Starter Freeroll, 5 x ₮1 tickets Hold'em No Limit (120/240 ante 30 play) 2025/09/14 18:42:31 GMT
Table '43' 7-max Seat #3 is the button
Seat 1: icestorm2508 (15642 in chips)
Seat 2: Dzomi123 (4050 in chips)
Seat 3: Frenaldinho (4399 in chips)
Seat 4: Ferd0ws (4405 in chips)
Seat 5: kanococo (8900 in chips)
Seat 6: saidafrente (4975 in chips)
Seat 7: Zenby (4950 in chips)
icestorm2508: posts the ante 30
Dzomi123: posts the ante 30
Frenaldinho: posts the ante 30
Ferd0ws: posts the ante 30
kanococo: posts the ante 30
saidafrente: posts the ante 30
Zenby: posts the ante 30
Ferd0ws: posts small blind 120
kanococo: posts big blind 240
*** HOLE CARDS ***
Dealt to kanococo [3c 9h]
saidafrente: folds
Zenby: folds
icestorm2508: folds
Dzomi123: raises 480 to 720
Frenaldinho is disconnected
Frenaldinho has timed out wile being disconnected
Frenaldinho activated time-bank (25 seconds)
Frenaldinho has timed out wile being disconnected
Frenaldinho: folds
Ferd0ws: raises 4255 and is all-in
kanococo: folds
Dzomi123: calls 3300 and is all-in
Uncalled bet (355) returned to Ferd0ws
*** FLOP *** [Jd 4s 7d]
*** TURN *** [Jd 4s 7d] [Kd]
*** RIVER *** [Jd 4s 7d Kd] [6c]
*** SHOW DOWN ***
Ferd0ws: shows [Tc Ks] (a pair of Kings)
Dzomi123: shows [6h 7h] (two pairs, Sevens and Sixes)
Dzomi123 collected 8490 from pot
*** SUMMARY ***
Total pot 8490 | Rake 0
Board [ Jd 4s 7d Kd 6c ]
Game ended: 2025/09/14 18:43:42 GMT
Seat 1: icestorm2508 folded before Flop
Seat 2: Dzomi123 showed [6h 7h] and won (8490) with two pairs, Sevens and Sixes
Seat 3: Frenaldinho (button) folded before Flop
Seat 4: Ferd0ws (small blind) showed [Tc Ks]
Seat 5: kanococo (big blind) folded before Flop
Seat 6: saidafrente folded before Flop
Seat 7: Zenby folded before Flop

CoinPoker Hand #296799954: Tournament #1369803, Bankroll Starter Freeroll, 5 x ₮1 tickets Hold'em No Limit (120/240 ante 30 play) 2025/09/14 18:43:43 GMT
Table '43' 7-max Seat #4 is the button
Seat 1: icestorm2508 (15612 in chips)
Seat 2: Dzomi123 (8490 in chips)
Seat 3: Frenaldinho (4369 in chips) is sitting out
Seat 4: Ferd0ws (355 in chips)
Seat 5: kanococo (8630 in chips)
Seat 6: saidafrente (4945 in chips)
Seat 7: Zenby (4920 in chips)
icestorm2508: posts the ante 30
Dzomi123: posts the ante 30
Frenaldinho: posts the ante 30
Ferd0ws: posts the ante 30
kanococo: posts the ante 30
saidafrente: posts the ante 30
Zenby: posts the ante 30
kanococo: posts small blind 120
saidafrente: posts big blind 240
*** HOLE CARDS ***
Dealt to kanococo [5c Kd]
Zenby has timed out
Zenby activated time-bank (30 seconds)
Zenby: folds
icestorm2508: folds
Dzomi123: folds
Frenaldinho: folds
Ferd0ws: raises 325 and is all-in
kanococo: raises 395 to 720
saidafrente: raises 4675 and is all-in
kanococo: folds
Uncalled bet (4195) returned to saidafrente
*** FLOP *** [Ac Td 3d]
*** TURN *** [Ac Td 3d] [5s]
*** RIVER *** [Ac Td 3d 5s] [3s]
*** SHOW DOWN ***
saidafrente: shows [Jd 7d] (a pair of Threes)
saidafrente collected 790 from side-pot 1
Ferd0ws: shows [Kc As] (two pairs, Aces and Threes)
Ferd0ws collected 1185 from pot
*** SUMMARY ***
Total pot 1975 | Rake 0
Board [ Ac Td 3d 5s 3s ]
Game ended: 2025/09/14 18:44:35 GMT
Seat 1: icestorm2508 folded before Flop
Seat 2: Dzomi123 folded before Flop
Seat 3: Frenaldinho folded before Flop
Seat 4: Ferd0ws (button) showed [Kc As] and won (1185) with two pairs, Aces and Threes
Seat 5: kanococo (small blind) folded before Flop
Seat 6: saidafrente (big blind) showed [Jd 7d] and won (790) with a pair of Threes
Seat 7: Zenby folded before Flop

CoinPoker Hand #296800690: Tournament #1369803, Bankroll Starter Freeroll, 5 x ₮1 tickets Hold'em No Limit (120/240 ante 30 play) 2025/09/14 18:44:36 GMT
Table '43' 7-max Seat #5 is the button
Seat 1: icestorm2508 (15582 in chips)
Seat 2: Dzomi123 (8460 in chips)
Seat 3: Frenaldinho (4339 in chips) is sitting out
Seat 5: kanococo (7880 in chips)
Seat 6: saidafrente (4985 in chips)
Seat 7: Zenby (4890 in chips)
icestorm2508: posts the ante 30
Dzomi123: posts the ante 30
Frenaldinho: posts the ante 30
kanococo: posts the ante 30
saidafrente: posts the ante 30
Zenby: posts the ante 30
saidafrente: posts small blind 120
Zenby: posts big blind 240
*** HOLE CARDS ***
Dealt to kanococo [6s 2d]
icestorm2508 has timed out
icestorm2508 activated time-bank (29 seconds)
icestorm2508: folds
Dzomi123 has timed out
Dzomi123: folds
Frenaldinho: folds
kanococo: folds
saidafrente: raises 4835 and is all-in
Zenby: folds
saidafrente collected 5375 from pot
saidafrente: doesn't show hand
*** SUMMARY ***
Total pot 5375 | Rake 0
Board [ ]
Game ended: 2025/09/14 18:45:22 GMT
Seat 1: icestorm2508 folded before Flop
Seat 2: Dzomi123 folded before Flop
Seat 3: Frenaldinho folded before Flop
Seat 5: kanococo (button) folded before Flop
Seat 6: saidafrente (small blind) collected (5375)
Seat 7: Zenby (big blind) folded before Flop

CoinPoker Hand #296801403: Tournament #1369803, Bankroll Starter Freeroll, 5 x ₮1 tickets Hold'em No Limit (140/280 ante 35 play) 2025/09/14 18:45:27 GMT
Table '43' 7-max Seat #6 is the button
Seat 1: icestorm2508 (15552 in chips)
Seat 2: Dzomi123 (8430 in chips)
Seat 3: Frenaldinho (4309 in chips) is sitting out
Seat 4: sporkhunter (9880 in chips)
Seat 5: kanococo (7850 in chips)
Seat 6: saidafrente (5375 in chips)
Seat 7: Zenby (4620 in chips)
icestorm2508: posts the ante 35
Dzomi123: posts the ante 35
Frenaldinho: posts the ante 35
sporkhunter: posts the ante 35
kanococo: posts the ante 35
saidafrente: posts the ante 35
Zenby: posts the ante 35
Zenby: posts small blind 140
icestorm2508: posts big blind 280
*** HOLE CARDS ***
Dealt to kanococo [Ac 6h]
Dzomi123 has timed out
Dzomi123: folds
Frenaldinho: folds
sporkhunter: raises 280 to 560
kanococo: folds
saidafrente: folds
Zenby: calls 420
icestorm2508 has timed out
icestorm2508 activated time-bank (25 seconds)
icestorm2508: calls 280
*** FLOP *** [3s Jc 6s]
Zenby: checks
icestorm2508 has timed out
icestorm2508 activated time-bank (23 seconds)
icestorm2508: checks
sporkhunter: checks
*** TURN *** [3s Jc 6s] [8h]
Zenby: checks
icestorm2508: checks
sporkhunter: checks
*** RIVER *** [3s Jc 6s 8h] [Td]
Zenby: checks
icestorm2508 has timed out
icestorm2508 activated time-bank (17 seconds)
icestorm2508: checks
sporkhunter: checks
*** SHOW DOWN ***
Zenby: shows [2s 2d] (a pair of Twos)
icestorm2508: shows [3c Kh] (a pair of Threes)
sporkhunter: shows [Ad Tc] (a pair of Tens)
sporkhunter collected 1925 from pot
Frenaldinho has reconnected
*** SUMMARY ***
Total pot 1925 | Rake 0
Board [ 3s Jc 6s 8h Td ]
Game ended: 2025/09/14 18:47:18 GMT
Seat 1: icestorm2508 (big blind) showed [3c Kh]
Seat 2: Dzomi123 folded before Flop
Seat 3: Frenaldinho folded before Flop
Seat 4: sporkhunter showed [Ad Tc] and won (1925) with a pair of Tens
Seat 5: kanococo folded before Flop
Seat 6: saidafrente (button) folded before Flop
Seat 7: Zenby (small blind) showed [2s 2d]

CoinPoker Hand #296802970: Tournament #1369803, Bankroll Starter Freeroll, 5 x ₮1 tickets Hold'em No Limit (140/280 ante 35 play) 2025/09/14 18:47:19 GMT
Table '43' 7-max Seat #7 is the button
Seat 1: icestorm2508 (14957 in chips)
Seat 2: Dzomi123 (8395 in chips) is sitting out
Seat 3: Frenaldinho (4274 in chips)
Seat 4: sporkhunter (11210 in chips) is sitting out
Seat 5: kanococo (7815 in chips)
Seat 6: saidafrente (5340 in chips)
Seat 7: Zenby (4025 in chips)
icestorm2508: posts the ante 35
Dzomi123: posts the ante 35
Frenaldinho: posts the ante 35
sporkhunter: posts the ante 35
kanococo: posts the ante 35
saidafrente: posts the ante 35
Zenby: posts the ante 35
icestorm2508: posts small blind 140
Dzomi123: posts big blind 280
*** HOLE CARDS ***
Dealt to kanococo [2c Ad]
Frenaldinho: calls 280
sporkhunter: folds
kanococo: raises 560 to 840
saidafrente: folds
Zenby: folds
icestorm2508: folds
Dzomi123: folds
Frenaldinho: calls 560
*** FLOP *** [Ks 3h Jh]
Frenaldinho: checks
kanococo: checks
*** TURN *** [Ks 3h Jh] [3s]
Frenaldinho: bets 840
kanococo: folds
Uncalled bet (840) returned to Frenaldinho
Frenaldinho collected 2345 from pot
Frenaldinho: doesn't show hand
*** SUMMARY ***
Total pot 2345 | Rake 0
Board [ Ks 3h Jh 3s ]
Game ended: 2025/09/14 18:48:06 GMT
Seat 1: icestorm2508 (small blind) folded before Flop
Seat 2: Dzomi123 (big blind) folded before Flop
Seat 3: Frenaldinho collected (2345)
Seat 4: sporkhunter folded before Flop
Seat 5: kanococo folded on the Turn
Seat 6: saidafrente folded before Flop
Seat 7: Zenby (button) folded before Flop

CoinPoker Hand #296803595: Tournament #1369803, Bankroll Starter Freeroll, 5 x ₮1 tickets Hold'em No Limit (160/320 ante 40 play) 2025/09/14 18:48:11 GMT
Table '43' 7-max Seat #1 is the button
Seat 1: icestorm2508 (14782 in chips)
Seat 2: Dzomi123 (8080 in chips) is sitting out
Seat 3: Frenaldinho (5744 in chips)
Seat 4: sporkhunter (11175 in chips)
Seat 5: kanococo (6940 in chips)
Seat 6: saidafrente (5305 in chips)
Seat 7: Zenby (3990 in chips)
icestorm2508: posts the ante 40
Dzomi123: posts the ante 40
Frenaldinho: posts the ante 40
sporkhunter: posts the ante 40
kanococo: posts the ante 40
saidafrente: posts the ante 40
Zenby: posts the ante 40
Dzomi123: posts small blind 160
Frenaldinho: posts big blind 320
*** HOLE CARDS ***
Dealt to kanococo [4s 3d]
sporkhunter: folds
kanococo: folds
saidafrente: folds
Zenby: folds
icestorm2508: folds
Dzomi123: folds
Frenaldinho collected 760 from pot
Frenaldinho: doesn't show hand
*** SUMMARY ***
Total pot 760 | Rake 0
Board [ ]
Game ended: 2025/09/14 18:48:34 GMT
Seat 1: icestorm2508 (button) folded before Flop
Seat 2: Dzomi123 (small blind) folded before Flop
Seat 3: Frenaldinho (big blind) collected (760)
Seat 4: sporkhunter folded before Flop
Seat 5: kanococo folded before Flop
Seat 6: saidafrente folded before Flop
Seat 7: Zenby folded before Flop

CoinPoker Hand #296803857: Tournament #1369803, Bankroll Starter Freeroll, 5 x ₮1 tickets Hold'em No Limit (160/320 ante 40 play) 2025/09/14 18:48:35 GMT
Table '43' 7-max Seat #2 is the button
Seat 1: icestorm2508 (14742 in chips)
Seat 2: Dzomi123 (7880 in chips) is sitting out
Seat 3: Frenaldinho (6144 in chips)
Seat 4: sporkhunter (11135 in chips)
Seat 5: kanococo (6900 in chips)
Seat 6: saidafrente (5265 in chips)
Seat 7: Zenby (3950 in chips)
icestorm2508: posts the ante 40
Dzomi123: posts the ante 40
Frenaldinho: posts the ante 40
sporkhunter: posts the ante 40
kanococo: posts the ante 40
saidafrente: posts the ante 40
Zenby: posts the ante 40
Frenaldinho: posts small blind 160
sporkhunter: posts big blind 320
*** HOLE CARDS ***
Dealt to kanococo [Js 8h]
kanococo: folds
saidafrente: folds
Zenby: raises 1080 to 1400
icestorm2508: raises 1400 to 2800
Dzomi123: folds
Frenaldinho: folds
sporkhunter: folds
Zenby: raises 2510 and is all-in
icestorm2508: calls 1110
*** FLOP *** [6h Jd 7c]
*** TURN *** [6h Jd 7c] [5c]
*** RIVER *** [6h Jd 7c 5c] [5s]
*** SHOW DOWN ***
Zenby: shows [Qh Qd] (two pairs, Queens and Fives)
icestorm2508: shows [Ah Ac] (two pairs, Aces and Fives)
icestorm2508 collected 8580 from pot
*** SUMMARY ***
Total pot 8580 | Rake 0
Board [ 6h Jd 7c 5c 5s ]
Game ended: 2025/09/14 18:49:15 GMT
Seat 1: icestorm2508 showed [Ah Ac] and won (8580) with two pairs, Aces and Fives
Seat 2: Dzomi123 (button) folded before Flop
Seat 3: Frenaldinho (small blind) folded before Flop
Seat 4: sporkhunter (big blind) folded before Flop
Seat 5: kanococo folded before Flop
Seat 6: saidafrente folded before Flop
Seat 7: Zenby showed [Qh Qd]

CoinPoker Hand #296804534: Tournament #1369803, Bankroll Starter Freeroll, 5 x ₮1 tickets Hold'em No Limit (160/320 ante 40 play) 2025/09/14 18:49:16 GMT
Table '43' 7-max Seat #3 is the button
Seat 1: icestorm2508 (19372 in chips)
Seat 2: Dzomi123 (7840 in chips) is sitting out
Seat 3: Frenaldinho (5944 in chips)
Seat 4: sporkhunter (10775 in chips)
Seat 5: kanococo (6860 in chips)
Seat 6: saidafrente (5225 in chips)
icestorm2508: posts the ante 40
Dzomi123: posts the ante 40
Frenaldinho: posts the ante 40
sporkhunter: posts the ante 40
kanococo: posts the ante 40
saidafrente: posts the ante 40
sporkhunter: posts small blind 160
kanococo: posts big blind 320
*** HOLE CARDS ***
Dealt to kanococo [5d 3d]
saidafrente: folds
icestorm2508: folds
Dzomi123: folds
Frenaldinho: calls 320
sporkhunter: calls 160
kanococo: raises 960 to 1280
Frenaldinho: calls 960
sporkhunter: calls 960
*** FLOP *** [2s 9c Jc]
sporkhunter: checks
kanococo: checks
Frenaldinho: bets 960
sporkhunter: folds
kanococo: folds
Uncalled bet (960) returned to Frenaldinho
Frenaldinho collected 4080 from pot
Frenaldinho: doesn't show hand
*** SUMMARY ***
Total pot 4080 | Rake 0
Board [ 2s 9c Jc ]
Game ended: 2025/09/14 18:50:12 GMT
Seat 1: icestorm2508 folded before Flop
Seat 2: Dzomi123 folded before Flop
Seat 3: Frenaldinho (button) collected (4080)
Seat 4: sporkhunter (small blind) folded on the Flop
Seat 5: kanococo (big blind) folded on the Flop
Seat 6: saidafrente folded before Flop

CoinPoker Hand #296805093: Tournament #1369803, Bankroll Starter Freeroll, 5 x ₮1 tickets Hold'em No Limit (160/320 ante 40 play) 2025/09/14 18:50:13 GMT
Table '43' 7-max Seat #4 is the button
Seat 1: icestorm2508 (19332 in chips)
Seat 2: Dzomi123 (7800 in chips)
Seat 3: Frenaldinho (8704 in chips)
Seat 4: sporkhunter (9455 in chips)
Seat 5: kanococo (5540 in chips)
Seat 6: saidafrente (5185 in chips)
Seat 7: b0red2 (22125 in chips)
icestorm2508: posts the ante 40
Dzomi123: posts the ante 40
Frenaldinho: posts the ante 40
sporkhunter: posts the ante 40
kanococo: posts the ante 40
saidafrente: posts the ante 40
b0red2: posts the ante 40
kanococo: posts small blind 160
saidafrente: posts big blind 320
*** HOLE CARDS ***
Dealt to kanococo [As 8d]
b0red2: folds
icestorm2508: raises 19292 and is all-in
Dzomi123: calls 7760 and is all-in
Frenaldinho has timed out
Frenaldinho: folds
sporkhunter: folds
kanococo: folds
saidafrente has timed out
saidafrente activated time-bank (30 seconds)
saidafrente: folds
Uncalled bet (11532) returned to icestorm2508
*** FLOP *** [Kh 4c 2d]
Frenaldinho is disconnected
*** TURN *** [Kh 4c 2d] [2h]
*** RIVER *** [Kh 4c 2d 2h] [Js]
*** SHOW DOWN ***
icestorm2508: shows [9c 9s] (two pairs, Nines and Twos)
Dzomi123: shows [8h 9h] (a pair of Twos)
icestorm2508 collected 16280 from pot
*** SUMMARY ***
Total pot 16280 | Rake 0
Board [ Kh 4c 2d 2h Js ]
Game ended: 2025/09/14 18:51:09 GMT
Seat 1: icestorm2508 showed [9c 9s] and won (16280) with two pairs, Nines and Twos
Seat 2: Dzomi123 showed [8h 9h]
Seat 3: Frenaldinho folded before Flop
Seat 4: sporkhunter (button) folded before Flop
Seat 5: kanococo (small blind) folded before Flop
Seat 6: saidafrente (big blind) folded before Flop
Seat 7: b0red2 folded before Flop

CoinPoker Hand #296805931: Tournament #1369803, Bankroll Starter Freeroll, 5 x ₮1 tickets Hold'em No Limit (200/400 ante 50 play) 2025/09/14 18:51:15 GMT
Table '43' 7-max Seat #5 is the button
Seat 1: icestorm2508 (27812 in chips)
Seat 3: Frenaldinho (8664 in chips)
Seat 4: sporkhunter (9415 in chips)
Seat 5: kanococo (5340 in chips)
Seat 6: saidafrente (4825 in chips)
Seat 7: b0red2 (22085 in chips)
icestorm2508: posts the ante 50
Frenaldinho: posts the ante 50
sporkhunter: posts the ante 50
kanococo: posts the ante 50
saidafrente: posts the ante 50
b0red2: posts the ante 50
saidafrente: posts small blind 200
b0red2: posts big blind 400
Frenaldinho has reconnected
*** HOLE CARDS ***
Dealt to kanococo [7d 2s]
icestorm2508: raises 400 to 800
Frenaldinho: calls 800
sporkhunter: folds
kanococo has timed out
kanococo activated time-bank (30 seconds)
kanococo: folds
saidafrente: folds
b0red2: folds
*** FLOP *** [9s 2d 5h]
icestorm2508: checks
Frenaldinho: bets 800
icestorm2508: folds
Uncalled bet (800) returned to Frenaldinho
Frenaldinho collected 2500 from pot
Frenaldinho: doesn't show hand
*** SUMMARY ***
Total pot 2500 | Rake 0
Board [ 9s 2d 5h ]
Game ended: 2025/09/14 18:52:17 GMT
Seat 1: icestorm2508 folded on the Flop
Seat 3: Frenaldinho collected (2500)
Seat 4: sporkhunter folded before Flop
Seat 5: kanococo (button) folded before Flop
Seat 6: saidafrente (small blind) folded before Flop
Seat 7: b0red2 (big blind) folded before Flop

CoinPoker Hand #296806823: Tournament #1369803, Bankroll Starter Freeroll, 5 x ₮1 tickets Hold'em No Limit (200/400 ante 50 play) 2025/09/14 18:52:18 GMT
Table '43' 7-max Seat #6 is the button
Seat 1: icestorm2508 (26962 in chips)
Seat 2: Midle (4093 in chips) is sitting out
Seat 3: Frenaldinho (10314 in chips)
Seat 4: sporkhunter (9365 in chips)
Seat 5: kanococo (5290 in chips)
Seat 6: saidafrente (4575 in chips)
Seat 7: b0red2 (21635 in chips)
icestorm2508: posts the ante 50
Midle: posts the ante 50
Frenaldinho: posts the ante 50
sporkhunter: posts the ante 50
kanococo: posts the ante 50
saidafrente: posts the ante 50
b0red2: posts the ante 50
b0red2: posts small blind 200
icestorm2508: posts big blind 400
*** HOLE CARDS ***
Dealt to kanococo [7h Ts]
Midle: folds
Frenaldinho: raises 400 to 800
sporkhunter: folds
kanococo: raises 1200 to 2000
saidafrente has timed out
saidafrente activated time-bank (29 seconds)
saidafrente: folds
b0red2: folds
icestorm2508: raises 26512 and is all-in
Frenaldinho: folds
kanococo: folds
icestorm2508 collected 30262 from pot
icestorm2508: doesn't show hand
*** SUMMARY ***
Total pot 30262 | Rake 0
Board [ ]
Game ended: 2025/09/14 18:53:04 GMT
Seat 1: icestorm2508 (big blind) collected (30262)
Seat 2: Midle folded before Flop
Seat 3: Frenaldinho folded before Flop
Seat 4: sporkhunter folded before Flop
Seat 5: kanococo folded before Flop
Seat 6: saidafrente (button) folded before Flop
Seat 7: b0red2 (small blind) folded before Flop

CoinPoker Hand #296807367: Tournament #1369803, Bankroll Starter Freeroll, 5 x ₮1 tickets Hold'em No Limit (200/400 ante 50 play) 2025/09/14 18:53:05 GMT
Table '43' 7-max Seat #7 is the button
Seat 1: icestorm2508 (30262 in chips)
Seat 2: Midle (4043 in chips) is sitting out
Seat 3: Frenaldinho (9464 in chips)
Seat 4: sporkhunter (9315 in chips)
Seat 5: kanococo (3240 in chips)
Seat 6: saidafrente (4525 in chips)
Seat 7: b0red2 (21385 in chips)
icestorm2508: posts the ante 50
Midle: posts the ante 50
Frenaldinho: posts the ante 50
sporkhunter: posts the ante 50
kanococo: posts the ante 50
saidafrente: posts the ante 50
b0red2: posts the ante 50
icestorm2508: posts small blind 200
Midle: posts big blind 400
*** HOLE CARDS ***
Dealt to kanococo [Kc 9h]
Frenaldinho: calls 400
sporkhunter: folds
kanococo: raises 3190 and is all-in
saidafrente: folds
b0red2: raises 3190 to 6380
icestorm2508: folds
Midle: folds
Frenaldinho: calls 5980
*** FLOP *** [2c As Qs]
Frenaldinho: checks
b0red2: bets 400
Frenaldinho: calls 400
*** TURN *** [2c As Qs] [Th]
Frenaldinho: checks
b0red2: bets 400
Frenaldinho: calls 400
*** RIVER *** [2c As Qs Th] [4h]
Frenaldinho: bets 1600
b0red2: raises 1600 to 3200
Frenaldinho: calls 634 and is all-in
Uncalled bet (966) returned to b0red2
*** SHOW DOWN ***
b0red2: shows [Ah Kh] (a pair of Aces)
Frenaldinho: shows [Qc Jc] (a pair of Queens)
b0red2 collected 12448 from side-pot 1
kanococo: shows [Kc 9h] (Ace high)
b0red2 collected 10520 from pot
*** SUMMARY ***
Total pot 22968 | Rake 0
Board [ 2c As Qs Th 4h ]
Game ended: 2025/09/14 18:54:07 GMT
Seat 1: icestorm2508 (small blind) folded before Flop
Seat 2: Midle (big blind) folded before Flop
Seat 3: Frenaldinho showed [Qc Jc]
Seat 4: sporkhunter folded before Flop
Seat 5: kanococo showed [Kc 9h]
Seat 6: saidafrente folded before Flop
Seat 7: b0red2 (button) showed [Ah Kh] and won (22968) with a pair of Aces

CoinPoker Hand #296808349: Hold'em No Limit (0.01/0.02 ) 2025/09/14 18:54:53 GMT
Table 'NL ₮2 IX' 7-max Seat #6 is the button
Seat 1: Band82 (1.92 in chips)
Seat 2: Bonesaw (2.10 in chips)
Seat 3: crispzilla (4.75 in chips)
Seat 4: Holy1 (1.52 in chips)
Seat 5: kanococo (2.00 in chips)
Seat 6: nikolajev85 (0.92 in chips)
Seat 7: MokiMoki (0.70 in chips)
MokiMoki: posts small blind 0.01
Band82: posts big blind 0.02
kanococo: posts big blind 0.02
*** HOLE CARDS ***
Dealt to kanococo [Ac 5d]
Bonesaw: folds
crispzilla: folds
Holy1: folds
kanococo: raises 0.06 to 0.08
Holy1 said, "петушара , zilla , you from ?"
nikolajev85: calls 0.08
MokiMoki: folds
Band82: calls 0.06
*** FLOP *** [7c 5c 6d]
Band82: bets 1.84 and is all-in
kanococo: folds
nikolajev85: calls 0.84 and is all-in
Uncalled bet (1.00) returned to Band82
*** TURN *** [7c 5c 6d] [Ts]
*** RIVER *** [7c 5c 6d Ts] [6c]
*** SHOW DOWN ***
Band82: shows [8c 9c] (a straight flush, Nine high)
nikolajev85: shows [9d 8d] (a straight, Ten high)
Band82 collected 1.83 from pot
*** SUMMARY ***
Total pot 1.93 | Rake 0.10
Board [ 7c 5c 6d Ts 6c ]
Game ended: 2025/09/14 18:55:41 GMT
Seat 1: Band82 (big blind) showed [8c 9c] and won (1.83) with a straight flush, Nine high
Seat 2: Bonesaw folded before Flop (didn't bet)
Seat 3: crispzilla folded before Flop (didn't bet)
Seat 4: Holy1 folded before Flop (didn't bet)
Seat 5: kanococo folded on the Flop
Seat 6: nikolajev85 (button) showed [9d 8d]
Seat 7: MokiMoki (small blind) folded before Flop

CoinPoker Hand #296808961: Hold'em No Limit (0.01/0.02 ) 2025/09/14 18:55:45 GMT
Table 'NL ₮2 IX' 7-max Seat #7 is the button
Seat 1: Band82 (2.83 in chips)
Seat 2: Bonesaw (2.10 in chips)
Seat 3: crispzilla (4.75 in chips)
Seat 4: Holy1 (1.52 in chips)
Seat 5: kanococo (1.92 in chips)
Seat 6: nikolajev85 (2.00 in chips)
Seat 7: MokiMoki (0.69 in chips)
Band82: posts small blind 0.01
Bonesaw: posts big blind 0.02
*** HOLE CARDS ***
Dealt to kanococo [2h Ks]
crispzilla: folds
Holy1: folds
kanococo: raises 0.06 to 0.08
nikolajev85: folds
MokiMoki: raises 0.69 and is all-in
Band82 has timed out
Band82 activated time-bank (60 seconds)
Band82: folds
Bonesaw: folds
kanococo: folds
MokiMoki collected 0.80 from pot
MokiMoki: doesn't show hand
*** SUMMARY ***
Total pot 0.80 | Rake 0.00
Board [ ]
Game ended: 2025/09/14 18:56:45 GMT
Seat 1: Band82 (small blind) folded before Flop
Seat 2: Bonesaw (big blind) folded before Flop
Seat 3: crispzilla folded before Flop (didn't bet)
Seat 4: Holy1 folded before Flop (didn't bet)
Seat 5: kanococo folded before Flop
Seat 6: nikolajev85 folded before Flop (didn't bet)
Seat 7: MokiMoki (button) collected (0.80)

CoinPoker Hand #296809565: Hold'em No Limit (0.01/0.02 ) 2025/09/14 18:56:47 GMT
Table 'NL ₮2 IX' 7-max Seat #1 is the button
Seat 1: Band82 (2.82 in chips)
Seat 2: Bonesaw (2.08 in chips)
Seat 3: crispzilla (4.75 in chips)
Seat 4: Holy1 (1.52 in chips)
Seat 5: kanococo (1.84 in chips)
Seat 6: nikolajev85 (2.00 in chips)
Seat 7: MokiMoki (0.80 in chips)
Bonesaw: posts small blind 0.01
crispzilla: posts big blind 0.02
*** HOLE CARDS ***
Dealt to kanococo [As 6s]
Holy1: raises 0.03 to 0.05
kanococo: folds
nikolajev85: folds
MokiMoki: folds
Band82: folds
Bonesaw: calls 0.04
crispzilla: folds
*** FLOP *** [Jh 8d 8c]
Bonesaw: checks
Holy1: bets 0.05
Bonesaw: folds
Uncalled bet (0.05) returned to Holy1
Holy1 collected 0.11 from pot
Holy1: doesn't show hand
*** SUMMARY ***
Total pot 0.12 | Rake 0.01
Board [ Jh 8d 8c ]
Game ended: 2025/09/14 18:57:28 GMT
Seat 1: Band82 (button) folded before Flop (didn't bet)
Seat 2: Bonesaw (small blind) folded on the Flop
Seat 3: crispzilla (big blind) folded before Flop
Seat 4: Holy1 collected (0.11)
Seat 5: kanococo folded before Flop (didn't bet)
Seat 6: nikolajev85 folded before Flop (didn't bet)
Seat 7: MokiMoki folded before Flop (didn't bet)

CoinPoker Hand #296809701: Hold'em No Limit (0.01/0.02 ) 2025/09/14 18:57:30 GMT
Table 'NL ₮2 IX' 7-max Seat #2 is the button
Seat 1: Band82 (2.82 in chips)
Seat 2: Bonesaw (2.03 in chips)
Seat 3: crispzilla (4.73 in chips)
Seat 4: Holy1 (1.58 in chips)
Seat 5: kanococo (1.84 in chips)
Seat 6: nikolajev85 (2.00 in chips)
Seat 7: MokiMoki (0.80 in chips)
crispzilla: posts small blind 0.01
Holy1: posts big blind 0.02
*** HOLE CARDS ***
Dealt to kanococo [Qd Qh]
kanococo: calls 0.02
nikolajev85: folds
MokiMoki: folds
Band82: folds
Bonesaw: folds
crispzilla: folds
Holy1: checks
*** FLOP *** [Ad 8s Qc]
Holy1: bets 0.02
kanococo: raises 0.08 to 0.10
Holy1: calls 0.08
*** TURN *** [Ad 8s Qc] [Td]
Holy1: bets 0.16
kanococo: raises 0.32 to 0.48
Holy1: raises 1.30 and is all-in
kanococo: calls 0.98
*** RIVER *** [Ad 8s Qc Td] [Tc]
*** SHOW DOWN ***
Holy1: shows [Ts Qs] (a full house, Tens over Queens)
kanococo: shows [Qd Qh] (a full house, Queens over Tens)
kanococo collected 3.01 from pot
*** SUMMARY ***
Total pot 3.17 | Rake 0.16
Board [ Ad 8s Qc Td Tc ]
Game ended: 2025/09/14 18:58:37 GMT
Seat 1: Band82 folded before Flop (didn't bet)
Seat 2: Bonesaw (button) folded before Flop (didn't bet)
Seat 3: crispzilla (small blind) folded before Flop
Seat 4: Holy1 (big blind) showed [Ts Qs]
Seat 5: kanococo showed [Qd Qh] and won (3.01) with a full house, Queens over Tens
Seat 6: nikolajev85 folded before Flop (didn't bet)
Seat 7: MokiMoki folded before Flop (didn't bet)

CoinPoker Hand #296809845: Hold'em No Limit (0.01/0.02 ) 2025/09/14 18:58:41 GMT
Table 'NL ₮2 IX' 7-max Seat #3 is the button
Seat 1: Band82 (2.82 in chips)
Seat 2: Bonesaw (2.03 in chips)
Seat 3: crispzilla (4.72 in chips)
Seat 5: kanococo (3.27 in chips)
Seat 6: nikolajev85 (2.00 in chips)
Seat 7: MokiMoki (0.80 in chips)
kanococo: posts big blind 0.02
*** HOLE CARDS ***
Dealt to kanococo [6h 3d]
nikolajev85: folds
MokiMoki: folds
Band82 has timed out
Band82 activated time-bank (50 seconds)
Band82: folds
Bonesaw: folds
crispzilla: folds
kanococo collected 0.02 from pot
kanococo: doesn't show hand
*** SUMMARY ***
Total pot 0.02 | Rake 0.00
Board [ ]
Game ended: 2025/09/14 18:59:07 GMT
Seat 1: Band82 folded before Flop (didn't bet)
Seat 2: Bonesaw folded before Flop (didn't bet)
Seat 3: crispzilla (button) folded before Flop (didn't bet)
Seat 5: kanococo (big blind) collected (0.02)
Seat 6: nikolajev85 folded before Flop (didn't bet)
Seat 7: MokiMoki folded before Flop (didn't bet)

CoinPoker Hand #296809924: Hold'em No Limit (0.01/0.02 ) 2025/09/14 18:59:09 GMT
Table 'NL ₮2 IX' 7-max Seat #4 is the button
Seat 1: Band82 (2.82 in chips)
Seat 2: Bonesaw (2.03 in chips)
Seat 3: crispzilla (4.72 in chips)
Seat 5: kanococo (3.27 in chips)
Seat 6: nikolajev85 (2.00 in chips)
Seat 7: MokiMoki (0.80 in chips)
kanococo: posts small blind 0.01
nikolajev85: posts big blind 0.02
*** HOLE CARDS ***
Dealt to kanococo [6c 7s]
MokiMoki: folds
Band82 has timed out
Band82 activated time-bank (48 seconds)
Band82: folds
Bonesaw: folds
crispzilla: raises 0.05 to 0.07
kanococo: calls 0.06
nikolajev85: calls 0.05
*** FLOP *** [9c Js Kd]
kanococo: checks
nikolajev85: checks
crispzilla: bets 0.20
kanococo: folds
nikolajev85: calls 0.20
*** TURN *** [9c Js Kd] [4s]
nikolajev85: checks
crispzilla: bets 0.58
nikolajev85: calls 0.58
*** RIVER *** [9c Js Kd 4s] [Qh]
nikolajev85: checks
crispzilla: checks
*** SHOW DOWN ***
nikolajev85: shows [3d Ks] (a pair of Kings)
crispzilla: shows [Jc Kc] (two pairs, Kings and Jacks)
crispzilla collected 1.68 from pot
*** SUMMARY ***
Total pot 1.77 | Rake 0.09
Board [ 9c Js Kd 4s Qh ]
Game ended: 2025/09/14 19:00:25 GMT
Seat 1: Band82 folded before Flop (didn't bet)
Seat 2: Bonesaw folded before Flop (didn't bet)
Seat 3: crispzilla showed [Jc Kc] and won (1.68) with two pairs, Kings and Jacks
Seat 5: kanococo (small blind) folded on the Flop
Seat 6: nikolajev85 (big blind) showed [3d Ks]
Seat 7: MokiMoki folded before Flop (didn't bet)

CoinPoker Hand #296810136: Hold'em No Limit (0.01/0.02 ) 2025/09/14 19:00:28 GMT
Table 'NL ₮2 IX' 7-max Seat #5 is the button
Seat 1: Band82 (2.82 in chips)
Seat 2: Bonesaw (2.03 in chips) is sitting out
Seat 3: crispzilla (5.55 in chips)
Seat 5: kanococo (3.20 in chips)
Seat 6: nikolajev85 (1.15 in chips)
Seat 7: MokiMoki (0.80 in chips)
nikolajev85: posts small blind 0.01
MokiMoki: posts big blind 0.02
*** HOLE CARDS ***
Dealt to kanococo [2s Qc]
Band82: folds
crispzilla: folds
kanococo: raises 0.06 to 0.08
nikolajev85: folds
MokiMoki: calls 0.06
*** FLOP *** [4s 7d 3s]
MokiMoki: bets 0.08
kanococo: calls 0.08
*** TURN *** [4s 7d 3s] [Ks]
MokiMoki: bets 0.10
kanococo has timed out
kanococo activated time-bank (60 seconds)
kanococo: folds
Uncalled bet (0.10) returned to MokiMoki
MokiMoki collected 0.31 from pot
MokiMoki: doesn't show hand
*** SUMMARY ***
Total pot 0.33 | Rake 0.02
Board [ 4s 7d 3s Ks ]
Game ended: 2025/09/14 19:01:54 GMT
Seat 1: Band82 folded before Flop (didn't bet)
Seat 2: Bonesaw folded before Flop (didn't bet)
Seat 3: crispzilla folded before Flop (didn't bet)
Seat 5: kanococo (button) folded on the Turn
Seat 6: nikolajev85 (small blind) folded before Flop
Seat 7: MokiMoki (big blind) collected (0.31)

CoinPoker Hand #296810462: Hold'em No Limit (0.01/0.02 ) 2025/09/14 19:01:56 GMT
Table 'NL ₮2 IX' 7-max Seat #6 is the button
Seat 1: Band82 (2.82 in chips)
Seat 2: Bonesaw (2.03 in chips) is sitting out
Seat 3: crispzilla (5.55 in chips)
Seat 5: kanococo (3.04 in chips)
Seat 6: nikolajev85 (1.14 in chips)
Seat 7: MokiMoki (0.95 in chips)
MokiMoki: posts small blind 0.01
Band82: posts big blind 0.02
*** HOLE CARDS ***
Dealt to kanococo [Tc 4c]
crispzilla: raises 0.04 to 0.06
kanococo: folds
nikolajev85: folds
MokiMoki: calls 0.05
Band82: folds
*** FLOP *** [9h 2h 5s]
MokiMoki: checks
crispzilla: bets 0.06
MokiMoki: calls 0.06
*** TURN *** [9h 2h 5s] [Jd]
MokiMoki: checks
crispzilla: bets 0.12
MokiMoki: calls 0.12
*** RIVER *** [9h 2h 5s Jd] [3d]
MokiMoki: checks
crispzilla: checks
*** SHOW DOWN ***
MokiMoki: shows [Ad 9s] (a pair of Nines)
crispzilla: mucks hand
MokiMoki collected 0.47 from pot
*** SUMMARY ***
Total pot 0.50 | Rake 0.03
Board [ 9h 2h 5s Jd 3d ]
Game ended: 2025/09/14 19:02:50 GMT
Seat 1: Band82 (big blind) folded before Flop
Seat 2: Bonesaw folded before Flop (didn't bet)
Seat 3: crispzilla mucked
Seat 5: kanococo folded before Flop (didn't bet)
Seat 6: nikolajev85 (button) folded before Flop (didn't bet)
Seat 7: MokiMoki (small blind) showed [Ad 9s] and won (0.47) with a pair of Nines

CoinPoker Hand #296810865: Hold'em No Limit (0.01/0.02 ) 2025/09/14 19:02:52 GMT
Table 'NL ₮2 IX' 7-max Seat #7 is the button
Seat 1: Band82 (2.80 in chips)
Seat 2: Bonesaw (2.03 in chips)
Seat 3: crispzilla (5.31 in chips)
Seat 5: kanococo (3.04 in chips)
Seat 6: nikolajev85 (1.14 in chips)
Seat 7: MokiMoki (1.18 in chips)
Band82: posts small blind 0.01
Bonesaw: posts big blind 0.02
*** HOLE CARDS ***
Dealt to kanococo [Qc 4c]
crispzilla: folds
kanococo has timed out
kanococo activated time-bank (53 seconds)
kanococo: folds
nikolajev85: folds
MokiMoki: folds
Band82: raises 0.04 to 0.06
Bonesaw: folds
Band82 collected 0.08 from pot
Band82: doesn't show hand
*** SUMMARY ***
Total pot 0.08 | Rake 0.00
Board [ ]
Game ended: 2025/09/14 19:03:35 GMT
Seat 1: Band82 (small blind) collected (0.08)
Seat 2: Bonesaw (big blind) folded before Flop
Seat 3: crispzilla folded before Flop (didn't bet)
Seat 5: kanococo folded before Flop (didn't bet)
Seat 6: nikolajev85 folded before Flop (didn't bet)
Seat 7: MokiMoki (button) folded before Flop (didn't bet)

CoinPoker Hand #296811475: Hold'em No Limit (0.01/0.02 ) 2025/09/14 19:03:37 GMT
Table 'NL ₮2 IX' 7-max Seat #1 is the button
Seat 1: Band82 (2.82 in chips)
Seat 2: Bonesaw (2.01 in chips)
Seat 3: crispzilla (5.31 in chips)
Seat 4: ironheart (2.00 in chips) out of hand
Seat 5: kanococo (3.04 in chips)
Seat 6: nikolajev85 (1.14 in chips)
Seat 7: MokiMoki (1.18 in chips)
Bonesaw: posts small blind 0.01
crispzilla: posts big blind 0.02
*** HOLE CARDS ***
Dealt to kanococo [6c 5s]
kanococo: folds
nikolajev85: raises 0.02 to 0.04
MokiMoki: folds
Band82: folds
Bonesaw: raises 0.20 to 0.24
crispzilla: folds
nikolajev85: folds
Bonesaw collected 0.30 from pot
Bonesaw: doesn't show hand
*** SUMMARY ***
Total pot 0.30 | Rake 0.00
Board [ ]
Game ended: 2025/09/14 19:04:11 GMT
Seat 1: Band82 (button) folded before Flop (didn't bet)
Seat 2: Bonesaw (small blind) collected (0.30)
Seat 3: crispzilla (big blind) folded before Flop
Seat 4: ironheart folded before Flop (didn't bet)
Seat 5: kanococo folded before Flop (didn't bet)
Seat 6: nikolajev85 folded before Flop
Seat 7: MokiMoki folded before Flop (didn't bet)

CoinPoker Hand #296811907: Hold'em No Limit (0.01/0.02 ) 2025/09/14 19:04:13 GMT
Table 'NL ₮2 IX' 7-max Seat #2 is the button
Seat 1: Band82 (2.82 in chips)
Seat 2: Bonesaw (2.07 in chips)
Seat 3: crispzilla (5.29 in chips)
Seat 4: ironheart (2.00 in chips)
Seat 5: kanococo (3.04 in chips)
Seat 6: nikolajev85 (1.10 in chips)
Seat 7: MokiMoki (1.18 in chips)
crispzilla: posts small blind 0.01
ironheart: posts big blind 0.02
*** HOLE CARDS ***
Dealt to kanococo [Ah 5d]
kanococo: raises 0.02 to 0.04
Band82 is disconnected
nikolajev85: folds
MokiMoki: folds
Band82 has timed out wile being disconnected
Band82 activated time-bank (45 seconds)
Band82 has timed out wile being disconnected
Band82: folds
Bonesaw: calls 0.04
crispzilla: calls 0.03
ironheart: folds
*** FLOP *** [5h 3h 8d]
crispzilla: checks
kanococo: bets 0.04
Bonesaw: raises 0.10 to 0.14
crispzilla: raises 0.14 to 0.28
kanococo: folds
Bonesaw: raises 1.89 and is all-in
crispzilla: folds
Uncalled bet (1.75) returned to Bonesaw
Bonesaw collected 0.73 from pot
Bonesaw: doesn't show hand
*** SUMMARY ***
Total pot 0.74 | Rake 0.01
Board [ 5h 3h 8d ]
Game ended: 2025/09/14 19:07:17 GMT
Seat 1: Band82 folded before Flop (didn't bet)
Seat 2: Bonesaw (button) collected (0.73)
Seat 3: crispzilla (small blind) folded on the Flop
Seat 4: ironheart (big blind) folded before Flop
Seat 5: kanococo folded on the Flop
Seat 6: nikolajev85 folded before Flop (didn't bet)
Seat 7: MokiMoki folded before Flop (didn't bet)

CoinPoker Hand #296814055: Hold'em No Limit (0.01/0.02 ) 2025/09/14 19:07:19 GMT
Table 'NL ₮2 IX' 7-max Seat #3 is the button
Seat 1: Band82 (2.82 in chips) is sitting out
Seat 2: Bonesaw (2.48 in chips)
Seat 3: crispzilla (4.97 in chips)
Seat 4: ironheart (2.00 in chips)
Seat 5: kanococo (2.96 in chips)
Seat 6: nikolajev85 (1.10 in chips)
Seat 7: MokiMoki (1.18 in chips)
ironheart: posts small blind 0.01
kanococo: posts big blind 0.02
*** HOLE CARDS ***
Dealt to kanococo [7d 9h]
nikolajev85: folds
MokiMoki: folds
Bonesaw: folds
crispzilla: folds
ironheart: folds
kanococo collected 0.03 from pot
kanococo: doesn't show hand
*** SUMMARY ***
Total pot 0.03 | Rake 0.00
Board [ ]
Game ended: 2025/09/14 19:07:38 GMT
Seat 1: Band82 folded before Flop (didn't bet)
Seat 2: Bonesaw folded before Flop (didn't bet)
Seat 3: crispzilla (button) folded before Flop (didn't bet)
Seat 4: ironheart (small blind) folded before Flop
Seat 5: kanococo (big blind) collected (0.03)
Seat 6: nikolajev85 folded before Flop (didn't bet)
Seat 7: MokiMoki folded before Flop (didn't bet)

CoinPoker Hand #296814388: Hold'em No Limit (0.01/0.02 ) 2025/09/14 19:07:40 GMT
Table 'NL ₮2 IX' 7-max Seat #4 is the button
Seat 1: Band82 (2.82 in chips) is sitting out
Seat 2: Bonesaw (2.48 in chips)
Seat 3: crispzilla (4.97 in chips)
Seat 4: ironheart (2.00 in chips)
Seat 5: kanococo (2.97 in chips)
Seat 6: nikolajev85 (1.10 in chips)
Seat 7: MokiMoki (1.18 in chips)
kanococo: posts small blind 0.01
nikolajev85: posts big blind 0.02
*** HOLE CARDS ***
Dealt to kanococo [8h 9s]
MokiMoki: folds
Bonesaw: folds
crispzilla: folds
ironheart: raises 0.04 to 0.06
kanococo: calls 0.05
nikolajev85: calls 0.04
*** FLOP *** [4c 9c 3c]
kanococo: bets 0.12
nikolajev85: folds
ironheart: folds
Uncalled bet (0.12) returned to kanococo
kanococo collected 0.17 from pot
kanococo: doesn't show hand
*** SUMMARY ***
Total pot 0.18 | Rake 0.01
Board [ 4c 9c 3c ]
Game ended: 2025/09/14 19:08:19 GMT
Seat 1: Band82 folded before Flop (didn't bet)
Seat 2: Bonesaw folded before Flop (didn't bet)
Seat 3: crispzilla folded before Flop (didn't bet)
Seat 4: ironheart (button) folded on the Flop
Seat 5: kanococo (small blind) collected (0.17)
Seat 6: nikolajev85 (big blind) folded on the Flop
Seat 7: MokiMoki folded before Flop (didn't bet)

CoinPoker Hand #296814852: Hold'em No Limit (0.01/0.02 ) 2025/09/14 19:08:21 GMT
Table 'NL ₮2 IX' 7-max Seat #5 is the button
Seat 1: Band82 (2.82 in chips) is sitting out
Seat 2: Bonesaw (2.48 in chips)
Seat 3: crispzilla (4.97 in chips)
Seat 4: ironheart (2.00 in chips)
Seat 5: kanococo (3.08 in chips)
Seat 6: nikolajev85 (1.04 in chips)
Seat 7: MokiMoki (1.18 in chips)
nikolajev85: posts small blind 0.01
MokiMoki: posts big blind 0.02
*** HOLE CARDS ***
Dealt to kanococo [3d As]
Bonesaw: folds
crispzilla: folds
ironheart: folds
kanococo: raises 0.06 to 0.08
nikolajev85: folds
MokiMoki: folds
kanococo collected 0.11 from pot
kanococo: doesn't show hand
*** SUMMARY ***
Total pot 0.11 | Rake 0.00
Board [ ]
Game ended: 2025/09/14 19:08:43 GMT
Seat 1: Band82 folded before Flop (didn't bet)
Seat 2: Bonesaw folded before Flop (didn't bet)
Seat 3: crispzilla folded before Flop (didn't bet)
Seat 4: ironheart folded before Flop (didn't bet)
Seat 5: kanococo (button) collected (0.11)
Seat 6: nikolajev85 (small blind) folded before Flop
Seat 7: MokiMoki (big blind) folded before Flop

CoinPoker Hand #296815422: Hold'em No Limit (0.01/0.02 ) 2025/09/14 19:08:45 GMT
Table 'NL ₮2 IX' 7-max Seat #6 is the button
Seat 1: Band82 (2.82 in chips) is sitting out
Seat 2: Bonesaw (2.48 in chips)
Seat 3: crispzilla (4.97 in chips)
Seat 4: ironheart (2.00 in chips)
Seat 5: kanococo (3.11 in chips)
Seat 6: nikolajev85 (1.03 in chips)
Seat 7: MokiMoki (1.16 in chips)
MokiMoki: posts small blind 0.01
Bonesaw: posts big blind 0.02
*** HOLE CARDS ***
Dealt to kanococo [8c Ts]
crispzilla: folds
ironheart: folds
kanococo: folds
nikolajev85: folds
MokiMoki: folds
Bonesaw collected 0.03 from pot
Bonesaw has timed out
Bonesaw: doesn't show hand
*** SUMMARY ***
Total pot 0.03 | Rake 0.00
Board [ ]
Game ended: 2025/09/14 19:09:12 GMT
Seat 1: Band82 folded before Flop (didn't bet)
Seat 2: Bonesaw (big blind) collected (0.03)
Seat 3: crispzilla folded before Flop (didn't bet)
Seat 4: ironheart folded before Flop (didn't bet)
Seat 5: kanococo folded before Flop (didn't bet)
Seat 6: nikolajev85 (button) folded before Flop (didn't bet)
Seat 7: MokiMoki (small blind) folded before Flop

CoinPoker Hand #296815660: Hold'em No Limit (0.01/0.02 ) 2025/09/14 19:09:14 GMT
Table 'NL ₮2 IX' 7-max Seat #7 is the button
Seat 1: Band82 (2.82 in chips) is sitting out
Seat 2: Bonesaw (2.49 in chips)
Seat 3: crispzilla (4.97 in chips)
Seat 4: ironheart (2.00 in chips)
Seat 5: kanococo (3.11 in chips)
Seat 6: nikolajev85 (1.03 in chips)
Seat 7: MokiMoki (1.15 in chips)
Bonesaw: posts small blind 0.01
crispzilla: posts big blind 0.02
*** HOLE CARDS ***
Dealt to kanococo [8c Ad]
ironheart: folds
kanococo: folds
nikolajev85: raises 0.02 to 0.04
MokiMoki: folds
Bonesaw: folds
crispzilla: folds
nikolajev85 collected 0.07 from pot
nikolajev85: doesn't show hand
*** SUMMARY ***
Total pot 0.07 | Rake 0.00
Board [ ]
Game ended: 2025/09/14 19:09:38 GMT
Seat 1: Band82 folded before Flop (didn't bet)
Seat 2: Bonesaw (small blind) folded before Flop
Seat 3: crispzilla (big blind) folded before Flop
Seat 4: ironheart folded before Flop (didn't bet)
Seat 5: kanococo folded before Flop (didn't bet)
Seat 6: nikolajev85 collected (0.07)
Seat 7: MokiMoki (button) folded before Flop (didn't bet)

CoinPoker Hand #296816002: Hold'em No Limit (0.01/0.02 ) 2025/09/14 19:09:41 GMT
Table 'NL ₮2 IX' 7-max Seat #2 is the button
Seat 1: Band82 (2.82 in chips) is sitting out
Seat 2: Bonesaw (2.48 in chips)
Seat 3: crispzilla (4.95 in chips)
Seat 4: ironheart (2.00 in chips)
Seat 5: kanococo (3.11 in chips)
Seat 6: nikolajev85 (1.06 in chips)
Seat 7: MokiMoki (1.15 in chips)
crispzilla: posts small blind 0.01
ironheart: posts big blind 0.02
*** HOLE CARDS ***
Dealt to kanococo [5d 8c]
kanococo: folds
nikolajev85: raises 0.02 to 0.04
MokiMoki: folds
Bonesaw: raises 0.12 to 0.16
crispzilla: folds
ironheart: folds
nikolajev85: calls 0.12
*** FLOP *** [9s 4d 6d]
nikolajev85: checks
Bonesaw: bets 0.16
nikolajev85: calls 0.16
*** TURN *** [9s 4d 6d] [2c]
nikolajev85: checks
Bonesaw: checks
*** RIVER *** [9s 4d 6d 2c] [6s]
nikolajev85: bets 0.32
Bonesaw: folds
Uncalled bet (0.32) returned to nikolajev85
nikolajev85 collected 0.64 from pot
nikolajev85: doesn't show hand
*** SUMMARY ***
Total pot 0.67 | Rake 0.03
Board [ 9s 4d 6d 2c 6s ]
Game ended: 2025/09/14 19:10:30 GMT
Seat 1: Band82 folded before Flop (didn't bet)
Seat 2: Bonesaw (button) folded on the River
Seat 3: crispzilla (small blind) folded before Flop
Seat 4: ironheart (big blind) folded before Flop
Seat 5: kanococo folded before Flop (didn't bet)
Seat 6: nikolajev85 collected (0.64)
Seat 7: MokiMoki folded before Flop (didn't bet)

CoinPoker Hand #296816703: Hold'em No Limit (0.01/0.02 ) 2025/09/14 19:10:32 GMT
Table 'NL ₮2 IX' 7-max Seat #3 is the button
Seat 1: Band82 (2.82 in chips) is sitting out
Seat 2: Bonesaw (2.16 in chips)
Seat 3: crispzilla (4.94 in chips)
Seat 4: ironheart (1.98 in chips)
Seat 5: kanococo (3.11 in chips)
Seat 6: nikolajev85 (1.38 in chips)
Seat 7: MokiMoki (1.15 in chips) is sitting out
ironheart: posts small blind 0.01
kanococo: posts big blind 0.02
*** HOLE CARDS ***
Dealt to kanococo [4s Ks]
nikolajev85: raises 0.02 to 0.04
Bonesaw: folds
crispzilla: calls 0.04
ironheart: folds
kanococo: raises 0.04 to 0.08
nikolajev85: calls 0.04
crispzilla has timed out
crispzilla activated time-bank (57 seconds)
crispzilla: folds
*** FLOP *** [Jd 6h Ac]
kanococo: bets 0.12
nikolajev85: folds
Uncalled bet (0.12) returned to kanococo
kanococo collected 0.20 from pot
kanococo: doesn't show hand
*** SUMMARY ***
Total pot 0.21 | Rake 0.01
Board [ Jd 6h Ac ]
Game ended: 2025/09/14 19:11:21 GMT
Seat 1: Band82 folded before Flop (didn't bet)
Seat 2: Bonesaw folded before Flop (didn't bet)
Seat 3: crispzilla (button) folded before Flop
Seat 4: ironheart (small blind) folded before Flop
Seat 5: kanococo (big blind) collected (0.20)
Seat 6: nikolajev85 folded on the Flop
Seat 7: MokiMoki folded before Flop (didn't bet)

CoinPoker Hand #296817333: Hold'em No Limit (0.01/0.02 ) 2025/09/14 19:11:23 GMT
Table 'NL ₮2 IX' 7-max Seat #4 is the button
Seat 1: Band82 (2.82 in chips) is sitting out
Seat 2: Bonesaw (2.16 in chips)
Seat 3: crispzilla (4.90 in chips)
Seat 4: ironheart (1.99 in chips)
Seat 5: kanococo (3.23 in chips)
Seat 6: nikolajev85 (1.30 in chips)
Seat 7: MokiMoki (1.15 in chips) is sitting out
kanococo: posts small blind 0.01
nikolajev85: posts big blind 0.02
*** HOLE CARDS ***
Dealt to kanococo [Ac 7c]
Bonesaw: folds
crispzilla: folds
ironheart: folds
kanococo: raises 0.08 to 0.10
nikolajev85: raises 0.25 to 0.35
kanococo: calls 0.25
*** FLOP *** [8c 2c 5h]
kanococo: checks
nikolajev85: bets 0.33
kanococo: calls 0.33
*** TURN *** [8c 2c 5h] [Kh]
kanococo: checks
nikolajev85: bets 0.62 and is all-in
kanococo has timed out
kanococo activated time-bank (45 seconds)
kanococo: folds
Uncalled bet (0.62) returned to nikolajev85
nikolajev85 collected 1.29 from pot
nikolajev85: doesn't show hand
*** SUMMARY ***
Total pot 1.36 | Rake 0.07
Board [ 8c 2c 5h Kh ]
Game ended: 2025/09/14 19:13:04 GMT
Seat 1: Band82 folded before Flop (didn't bet)
Seat 2: Bonesaw folded before Flop (didn't bet)
Seat 3: crispzilla folded before Flop (didn't bet)
Seat 4: ironheart (button) folded before Flop (didn't bet)
Seat 5: kanococo (small blind) folded on the Turn
Seat 6: nikolajev85 (big blind) collected (1.29)
Seat 7: MokiMoki folded before Flop (didn't bet)

CoinPoker Hand #296818554: Hold'em No Limit (0.01/0.02 ) 2025/09/14 19:13:06 GMT
Table 'NL ₮2 IX' 7-max Seat #5 is the button
Seat 1: Band82 (2.82 in chips) is sitting out
Seat 2: Bonesaw (2.16 in chips)
Seat 3: crispzilla (4.90 in chips)
Seat 4: ironheart (2.00 in chips)
Seat 5: kanococo (2.55 in chips)
Seat 6: nikolajev85 (1.91 in chips)
nikolajev85: posts small blind 0.01
Bonesaw: posts big blind 0.02
*** HOLE CARDS ***
Dealt to kanococo [Ks 8d]
crispzilla: folds
ironheart: folds
kanococo: raises 0.08 to 0.10
nikolajev85: folds
Bonesaw: folds
kanococo collected 0.13 from pot
kanococo: doesn't show hand
*** SUMMARY ***
Total pot 0.13 | Rake 0.00
Board [ ]
Game ended: 2025/09/14 19:13:26 GMT
Seat 1: Band82 folded before Flop (didn't bet)
Seat 2: Bonesaw (big blind) folded before Flop
Seat 3: crispzilla folded before Flop (didn't bet)
Seat 4: ironheart folded before Flop (didn't bet)
Seat 5: kanococo (button) collected (0.13)
Seat 6: nikolajev85 (small blind) folded before Flop

CoinPoker Hand #296818761: Hold'em No Limit (0.01/0.02 ) 2025/09/14 19:13:28 GMT
Table 'NL ₮2 IX' 7-max Seat #6 is the button
Seat 1: Band82 (2.82 in chips) is sitting out
Seat 2: Bonesaw (2.14 in chips)
Seat 3: crispzilla (4.90 in chips)
Seat 4: ironheart (2.00 in chips)
Seat 5: kanococo (2.58 in chips)
Seat 6: nikolajev85 (1.90 in chips)
Bonesaw: posts small blind 0.01
crispzilla: posts big blind 0.02
*** HOLE CARDS ***
Dealt to kanococo [Th 8h]
ironheart: folds
kanococo: folds
nikolajev85: folds
Bonesaw: folds
crispzilla collected 0.03 from pot
crispzilla: doesn't show hand
*** SUMMARY ***
Total pot 0.03 | Rake 0.00
Board [ ]
Game ended: 2025/09/14 19:13:43 GMT
Seat 1: Band82 folded before Flop (didn't bet)
Seat 2: Bonesaw (small blind) folded before Flop
Seat 3: crispzilla (big blind) collected (0.03)
Seat 4: ironheart folded before Flop (didn't bet)
Seat 5: kanococo folded before Flop (didn't bet)
Seat 6: nikolajev85 (button) folded before Flop (didn't bet)

CoinPoker Hand #296818895: Hold'em No Limit (0.01/0.02 ) 2025/09/14 19:13:45 GMT
Table 'NL ₮2 IX' 7-max Seat #2 is the button
Seat 1: Band82 (2.82 in chips) is sitting out
Seat 2: Bonesaw (2.13 in chips)
Seat 3: crispzilla (4.91 in chips)
Seat 4: ironheart (2.00 in chips)
Seat 5: kanococo (2.58 in chips)
Seat 6: nikolajev85 (1.90 in chips)
crispzilla: posts small blind 0.01
ironheart: posts big blind 0.02
*** HOLE CARDS ***
Dealt to kanococo [9s 3s]
kanococo: folds
nikolajev85: raises 0.02 to 0.04
Bonesaw: folds
crispzilla: folds
ironheart: folds
nikolajev85 collected 0.07 from pot
nikolajev85: doesn't show hand
*** SUMMARY ***
Total pot 0.07 | Rake 0.00
Board [ ]
Game ended: 2025/09/14 19:14:15 GMT
Seat 1: Band82 folded before Flop (didn't bet)
Seat 2: Bonesaw (button) folded before Flop (didn't bet)
Seat 3: crispzilla (small blind) folded before Flop
Seat 4: ironheart (big blind) folded before Flop
Seat 5: kanococo folded before Flop (didn't bet)
Seat 6: nikolajev85 collected (0.07)

CoinPoker Hand #296819460: Hold'em No Limit (0.01/0.02 ) 2025/09/14 19:14:17 GMT
Table 'NL ₮2 IX' 7-max Seat #3 is the button
Seat 1: Band82 (2.82 in chips) is sitting out
Seat 2: Bonesaw (2.13 in chips)
Seat 3: crispzilla (4.90 in chips)
Seat 4: ironheart (2.00 in chips)
Seat 5: kanococo (2.58 in chips)
Seat 6: nikolajev85 (1.93 in chips)
ironheart: posts small blind 0.01
kanococo: posts big blind 0.02
*** HOLE CARDS ***
Dealt to kanococo [2h Tc]
nikolajev85: folds
Bonesaw: folds
crispzilla: folds
ironheart: folds
kanococo collected 0.03 from pot
kanococo: doesn't show hand
*** SUMMARY ***
Total pot 0.03 | Rake 0.00
Board [ ]
Game ended: 2025/09/14 19:14:30 GMT
Seat 1: Band82 folded before Flop (didn't bet)
Seat 2: Bonesaw folded before Flop (didn't bet)
Seat 3: crispzilla (button) folded before Flop (didn't bet)
Seat 4: ironheart (small blind) folded before Flop
Seat 5: kanococo (big blind) collected (0.03)
Seat 6: nikolajev85 folded before Flop (didn't bet)

CoinPoker Hand #296819634: Hold'em No Limit (0.01/0.02 ) 2025/09/14 19:14:33 GMT
Table 'NL ₮2 IX' 7-max Seat #4 is the button
Seat 1: Band82 (2.82 in chips) is sitting out
Seat 2: Bonesaw (2.13 in chips)
Seat 3: crispzilla (4.90 in chips)
Seat 4: ironheart (2.00 in chips)
Seat 5: kanococo (2.59 in chips)
Seat 6: nikolajev85 (1.93 in chips)
kanococo: posts small blind 0.01
nikolajev85: posts big blind 0.02
*** HOLE CARDS ***
Dealt to kanococo [7c 9d]
Bonesaw: folds
crispzilla: raises 0.04 to 0.06
ironheart: folds
kanococo has timed out
kanococo activated time-bank (32 seconds)
kanococo: folds
nikolajev85: calls 0.04
*** FLOP *** [6d 8d Jh]
nikolajev85: checks
crispzilla: checks
*** TURN *** [6d 8d Jh] [Jd]
nikolajev85: checks
crispzilla: checks
*** RIVER *** [6d 8d Jh Jd] [4s]
nikolajev85: checks
crispzilla: checks
*** SHOW DOWN ***
nikolajev85: shows [9c 3h] (a pair of Jacks)
crispzilla: shows [Ac 9s] (a pair of Jacks)
crispzilla collected 0.12 from pot
*** SUMMARY ***
Total pot 0.13 | Rake 0.01
Board [ 6d 8d Jh Jd 4s ]
Game ended: 2025/09/14 19:16:00 GMT
Seat 1: Band82 folded before Flop (didn't bet)
Seat 2: Bonesaw folded before Flop (didn't bet)
Seat 3: crispzilla showed [Ac 9s] and won (0.12) with a pair of Jacks
Seat 4: ironheart (button) folded before Flop (didn't bet)
Seat 5: kanococo (small blind) folded before Flop
Seat 6: nikolajev85 (big blind) showed [9c 3h]

CoinPoker Hand #296820982: Hold'em No Limit (0.01/0.02 ) 2025/09/14 19:16:02 GMT
Table 'NL ₮2 IX' 7-max Seat #5 is the button
Seat 1: Band82 (2.82 in chips) is sitting out
Seat 2: Bonesaw (2.13 in chips)
Seat 3: crispzilla (4.96 in chips)
Seat 4: ironheart (2.00 in chips)
Seat 5: kanococo (2.58 in chips)
Seat 6: nikolajev85 (1.87 in chips)
nikolajev85: posts small blind 0.01
Bonesaw: posts big blind 0.02
*** HOLE CARDS ***
Dealt to kanococo [8h 9d]
crispzilla: folds
ironheart: raises 0.03 to 0.05
kanococo: calls 0.05
nikolajev85: folds
Bonesaw: folds
*** FLOP *** [9c Kc 4d]
ironheart: bets 0.06
kanococo: calls 0.06
*** TURN *** [9c Kc 4d] [3d]
ironheart: bets 0.12
kanococo: calls 0.12
*** RIVER *** [9c Kc 4d 3d] [Jc]
ironheart: checks
kanococo: bets 0.26
ironheart: calls 0.26
*** SHOW DOWN ***
kanococo: shows [8h 9d] (a pair of Nines)
ironheart: shows [Qd Qh] (a pair of Queens)
ironheart collected 0.96 from pot
*** SUMMARY ***
Total pot 1.01 | Rake 0.05
Board [ 9c Kc 4d 3d Jc ]
Game ended: 2025/09/14 19:17:25 GMT
Seat 1: Band82 folded before Flop (didn't bet)
Seat 2: Bonesaw (big blind) folded before Flop
Seat 3: crispzilla folded before Flop (didn't bet)
Seat 4: ironheart showed [Qd Qh] and won (0.96) with a pair of Queens
Seat 5: kanococo (button) showed [8h 9d]
Seat 6: nikolajev85 (small blind) folded before Flop

CoinPoker Hand #296821767: Hold'em No Limit (0.01/0.02 ) 2025/09/14 19:17:27 GMT
Table 'NL ₮2 IX' 7-max Seat #6 is the button
Seat 2: Bonesaw (2.11 in chips)
Seat 3: crispzilla (4.96 in chips)
Seat 4: ironheart (2.47 in chips)
Seat 5: kanococo (2.09 in chips)
Seat 6: nikolajev85 (1.86 in chips)
Seat 7: Neba91 (2.00 in chips)
Bonesaw: posts small blind 0.01
crispzilla: posts big blind 0.02
Neba91: posts big blind 0.02
*** HOLE CARDS ***
Dealt to kanococo [7s 2s]
ironheart has timed out
ironheart activated time-bank (60 seconds)
ironheart: raises 0.07 to 0.09
kanococo: folds
nikolajev85: folds
Neba91: folds
Bonesaw: folds
crispzilla: folds
ironheart collected 0.14 from pot
ironheart: doesn't show hand
*** SUMMARY ***
Total pot 0.14 | Rake 0.00
Board [ ]
Game ended: 2025/09/14 19:18:00 GMT
Seat 2: Bonesaw (small blind) folded before Flop
Seat 3: crispzilla (big blind) folded before Flop
Seat 4: ironheart collected (0.14)
Seat 5: kanococo folded before Flop (didn't bet)
Seat 6: nikolajev85 (button) folded before Flop (didn't bet)
Seat 7: Neba91 folded before Flop

CoinPoker Hand #296893408: Hold'em No Limit (0.01/0.02 ) 2025/09/14 21:14:51 GMT
Table 'NL ₮2 II' 7-max Seat #7 is the button
Seat 2: sh4rkw1s3 (5.04 in chips)
Seat 3: GannibalElectro (2.37 in chips)
Seat 4: Mibrisk (5.09 in chips)
Seat 5: kanococo (2.00 in chips)
Seat 6: Dmitryp (0.45 in chips)
Seat 7: XBSNP (1.92 in chips)
sh4rkw1s3: posts small blind 0.01
GannibalElectro: posts big blind 0.02
kanococo: posts big blind 0.02
*** HOLE CARDS ***
Dealt to kanococo [5h 2h]
Mibrisk: folds
kanococo: checks
Dmitryp: folds
XBSNP: folds
sh4rkw1s3: calls 0.01
GannibalElectro: checks
*** FLOP *** [Jc Qd Jd]
sh4rkw1s3: checks
GannibalElectro: checks
kanococo: checks
*** TURN *** [Jc Qd Jd] [9c]
sh4rkw1s3: checks
GannibalElectro: checks
kanococo: bets 0.03
sh4rkw1s3: folds
GannibalElectro: folds
Uncalled bet (0.03) returned to kanococo
kanococo collected 0.06 from pot
kanococo: doesn't show hand
*** SUMMARY ***
Total pot 0.06 | Rake 0.00
Board [ Jc Qd Jd 9c ]
Game ended: 2025/09/14 21:15:45 GMT
Seat 2: sh4rkw1s3 (small blind) folded on the Turn
Seat 3: GannibalElectro (big blind) folded on the Turn
Seat 4: Mibrisk folded before Flop (didn't bet)
Seat 5: kanococo collected (0.06)
Seat 6: Dmitryp folded before Flop (didn't bet)
Seat 7: XBSNP (button) folded before Flop (didn't bet)

CoinPoker Hand #296894030: Hold'em No Limit (0.01/0.02 ) 2025/09/14 21:15:47 GMT
Table 'NL ₮2 II' 7-max Seat #2 is the button
Seat 1: KiMiPhantom (0.80 in chips)
Seat 2: sh4rkw1s3 (5.02 in chips)
Seat 3: GannibalElectro (2.35 in chips)
Seat 4: Mibrisk (5.09 in chips)
Seat 5: kanococo (2.04 in chips)
Seat 6: Dmitryp (0.45 in chips)
Seat 7: XBSNP (1.92 in chips)
GannibalElectro: posts small blind 0.01
Mibrisk: posts big blind 0.02
KiMiPhantom: posts big blind 0.02
*** HOLE CARDS ***
Dealt to kanococo [As 5d]
kanococo: folds
Dmitryp: calls 0.02
XBSNP: folds
KiMiPhantom has timed out
KiMiPhantom activated time-bank (60 seconds)
KiMiPhantom: checks
sh4rkw1s3: folds
GannibalElectro: folds
Mibrisk: checks
*** FLOP *** [Th Js 5s]
Mibrisk: checks
Dmitryp: bets 0.02
KiMiPhantom: calls 0.02
Mibrisk: calls 0.02
*** TURN *** [Th Js 5s] [Kd]
Mibrisk: checks
Dmitryp: checks
KiMiPhantom: checks
*** RIVER *** [Th Js 5s Kd] [3h]
Mibrisk: checks
Dmitryp: checks
KiMiPhantom: checks
*** SHOW DOWN ***
Mibrisk: shows [3s 7s] (a pair of Threes)
Dmitryp: shows [8s Ts] (a pair of Tens)
KiMiPhantom: mucks hand
Dmitryp collected 0.12 from pot
*** SUMMARY ***
Total pot 0.13 | Rake 0.01
Board [ Th Js 5s Kd 3h ]
Game ended: 2025/09/14 21:17:31 GMT
Seat 1: KiMiPhantom mucked
Seat 2: sh4rkw1s3 (button) folded before Flop (didn't bet)
Seat 3: GannibalElectro (small blind) folded before Flop
Seat 4: Mibrisk (big blind) showed [3s 7s]
Seat 5: kanococo folded before Flop (didn't bet)
Seat 6: Dmitryp showed [8s Ts] and won (0.12) with a pair of Tens
Seat 7: XBSNP folded before Flop (didn't bet)

CoinPoker Hand #296894991: Hold'em No Limit (0.01/0.02 ) 2025/09/14 21:17:33 GMT
Table 'NL ₮2 II' 7-max Seat #3 is the button
Seat 1: KiMiPhantom (0.76 in chips)
Seat 2: sh4rkw1s3 (5.02 in chips)
Seat 3: GannibalElectro (2.34 in chips)
Seat 4: Mibrisk (5.05 in chips)
Seat 5: kanococo (2.04 in chips)
Seat 6: Dmitryp (0.53 in chips)
Seat 7: XBSNP (1.92 in chips)
Mibrisk: posts small blind 0.01
kanococo: posts big blind 0.02
*** HOLE CARDS ***
Dealt to kanococo [Tc 2h]
Dmitryp: folds
XBSNP: folds
KiMiPhantom: folds
sh4rkw1s3: folds
GannibalElectro: folds
Mibrisk: folds
kanococo collected 0.03 from pot
kanococo: doesn't show hand
*** SUMMARY ***
Total pot 0.03 | Rake 0.00
Board [ ]
Game ended: 2025/09/14 21:17:59 GMT
Seat 1: KiMiPhantom folded before Flop (didn't bet)
Seat 2: sh4rkw1s3 folded before Flop (didn't bet)
Seat 3: GannibalElectro (button) folded before Flop (didn't bet)
Seat 4: Mibrisk (small blind) folded before Flop
Seat 5: kanococo (big blind) collected (0.03)
Seat 6: Dmitryp folded before Flop (didn't bet)
Seat 7: XBSNP folded before Flop (didn't bet)

CoinPoker Hand #296895155: Hold'em No Limit (0.01/0.02 ) 2025/09/14 21:18:01 GMT
Table 'NL ₮2 II' 7-max Seat #4 is the button
Seat 1: KiMiPhantom (0.76 in chips)
Seat 2: sh4rkw1s3 (5.02 in chips)
Seat 3: GannibalElectro (2.34 in chips)
Seat 4: Mibrisk (5.04 in chips)
Seat 5: kanococo (2.05 in chips)
Seat 6: Dmitryp (0.53 in chips)
Seat 7: XBSNP (1.92 in chips)
kanococo: posts small blind 0.01
Dmitryp: posts big blind 0.02
*** HOLE CARDS ***
Dealt to kanococo [Jh Kh]
XBSNP: raises 0.02 to 0.04
KiMiPhantom: folds
sh4rkw1s3: folds
GannibalElectro: folds
Mibrisk: folds
kanococo: raises 0.04 to 0.08
Dmitryp: folds
XBSNP: calls 0.04
*** FLOP *** [9h Ah Td]
kanococo: bets 0.08
XBSNP: calls 0.08
*** TURN *** [9h Ah Td] [2c]
kanococo: checks
XBSNP: checks
*** RIVER *** [9h Ah Td 2c] [Qh]
kanococo: bets 1.89 and is all-in
XBSNP has timed out
XBSNP activated time-bank (1 seconds)
XBSNP has timed out
XBSNP: folds
Uncalled bet (1.89) returned to kanococo
kanococo collected 0.32 from pot
kanococo: doesn't show hand
*** SUMMARY ***
Total pot 0.34 | Rake 0.02
Board [ 9h Ah Td 2c Qh ]
Game ended: 2025/09/14 21:19:29 GMT
Seat 1: KiMiPhantom folded before Flop (didn't bet)
Seat 2: sh4rkw1s3 folded before Flop (didn't bet)
Seat 3: GannibalElectro folded before Flop (didn't bet)
Seat 4: Mibrisk (button) folded before Flop (didn't bet)
Seat 5: kanococo (small blind) collected (0.32)
Seat 6: Dmitryp (big blind) folded before Flop
Seat 7: XBSNP folded on the River

CoinPoker Hand #296895951: Hold'em No Limit (0.01/0.02 ) 2025/09/14 21:19:31 GMT
Table 'NL ₮2 II' 7-max Seat #5 is the button
Seat 1: KiMiPhantom (0.76 in chips)
Seat 2: sh4rkw1s3 (5.02 in chips)
Seat 3: GannibalElectro (2.34 in chips)
Seat 4: Mibrisk (5.04 in chips)
Seat 5: kanococo (2.21 in chips)
Seat 6: Dmitryp (0.51 in chips)
Seat 7: XBSNP (1.76 in chips)
Dmitryp: posts small blind 0.01
XBSNP: posts big blind 0.02
*** HOLE CARDS ***
Dealt to kanococo [Jh 9d]
KiMiPhantom: folds
sh4rkw1s3: folds
GannibalElectro: folds
Mibrisk: folds
kanococo: raises 0.04 to 0.06
Dmitryp: folds
XBSNP: calls 0.04
*** FLOP *** [8h 3h Ks]
XBSNP: checks
kanococo: checks
*** TURN *** [8h 3h Ks] [5h]
XBSNP: bets 0.06
kanococo: calls 0.06
*** RIVER *** [8h 3h Ks 5h] [6c]
XBSNP: bets 0.08
kanococo: folds
Uncalled bet (0.08) returned to XBSNP
XBSNP collected 0.24 from pot
XBSNP: doesn't show hand
*** SUMMARY ***
Total pot 0.25 | Rake 0.01
Board [ 8h 3h Ks 5h 6c ]
Game ended: 2025/09/14 21:21:09 GMT
Seat 1: KiMiPhantom folded before Flop (didn't bet)
Seat 2: sh4rkw1s3 folded before Flop (didn't bet)
Seat 3: GannibalElectro folded before Flop (didn't bet)
Seat 4: Mibrisk folded before Flop (didn't bet)
Seat 5: kanococo (button) folded on the River
Seat 6: Dmitryp (small blind) folded before Flop
Seat 7: XBSNP (big blind) collected (0.24)

CoinPoker Hand #296897030: Hold'em No Limit (0.01/0.02 ) 2025/09/14 21:21:11 GMT
Table 'NL ₮2 II' 7-max Seat #6 is the button
Seat 1: KiMiPhantom (0.76 in chips)
Seat 2: sh4rkw1s3 (5.02 in chips)
Seat 3: GannibalElectro (2.34 in chips)
Seat 4: Mibrisk (5.04 in chips)
Seat 5: kanococo (2.09 in chips)
Seat 6: Dmitryp (0.50 in chips)
Seat 7: XBSNP (1.88 in chips)
XBSNP: posts small blind 0.01
KiMiPhantom: posts big blind 0.02
*** HOLE CARDS ***
Dealt to kanococo [Kd Ad]
sh4rkw1s3: folds
GannibalElectro: folds
Mibrisk: folds
kanococo: raises 0.04 to 0.06
Dmitryp: folds
XBSNP: folds
KiMiPhantom: folds
kanococo collected 0.09 from pot
kanococo: doesn't show hand
*** SUMMARY ***
Total pot 0.09 | Rake 0.00
Board [ ]
Game ended: 2025/09/14 21:21:38 GMT
Seat 1: KiMiPhantom (big blind) folded before Flop
Seat 2: sh4rkw1s3 folded before Flop (didn't bet)
Seat 3: GannibalElectro folded before Flop (didn't bet)
Seat 4: Mibrisk folded before Flop (didn't bet)
Seat 5: kanococo collected (0.09)
Seat 6: Dmitryp (button) folded before Flop (didn't bet)
Seat 7: XBSNP (small blind) folded before Flop

CoinPoker Hand #296897350: Hold'em No Limit (0.01/0.02 ) 2025/09/14 21:21:40 GMT
Table 'NL ₮2 II' 7-max Seat #7 is the button
Seat 1: KiMiPhantom (0.74 in chips)
Seat 2: sh4rkw1s3 (5.02 in chips)
Seat 3: GannibalElectro (2.34 in chips)
Seat 4: Mibrisk (5.04 in chips)
Seat 5: kanococo (2.12 in chips)
Seat 6: Dmitryp (0.50 in chips)
Seat 7: XBSNP (1.87 in chips)
KiMiPhantom: posts small blind 0.01
sh4rkw1s3: posts big blind 0.02
*** HOLE CARDS ***
Dealt to kanococo [Jh Kh]
GannibalElectro: folds
Mibrisk: folds
kanococo: raises 0.08 to 0.10
Dmitryp: calls 0.10
XBSNP: calls 0.10
KiMiPhantom has timed out
KiMiPhantom activated time-bank (38 seconds)
KiMiPhantom: folds
sh4rkw1s3: folds
*** FLOP *** [4c 6s 3c]
kanococo: checks
Dmitryp: checks
XBSNP: checks
*** TURN *** [4c 6s 3c] [8c]
kanococo: bets 0.15
Dmitryp: folds
XBSNP has timed out
XBSNP: folds
Uncalled bet (0.15) returned to kanococo
kanococo collected 0.31 from pot
kanococo: doesn't show hand
*** SUMMARY ***
Total pot 0.33 | Rake 0.02
Board [ 4c 6s 3c 8c ]
Game ended: 2025/09/14 21:23:14 GMT
Seat 1: KiMiPhantom (small blind) folded before Flop
Seat 2: sh4rkw1s3 (big blind) folded before Flop
Seat 3: GannibalElectro folded before Flop (didn't bet)
Seat 4: Mibrisk folded before Flop (didn't bet)
Seat 5: kanococo collected (0.31)
Seat 6: Dmitryp folded on the Turn
Seat 7: XBSNP (button) folded on the Turn

CoinPoker Hand #296898106: Hold'em No Limit (0.01/0.02 ) 2025/09/14 21:23:16 GMT
Table 'NL ₮2 II' 7-max Seat #1 is the button
Seat 1: KiMiPhantom (0.73 in chips)
Seat 2: sh4rkw1s3 (5.00 in chips)
Seat 3: GannibalElectro (2.34 in chips)
Seat 4: Mibrisk (5.04 in chips)
Seat 5: kanococo (2.33 in chips)
Seat 6: Dmitryp (0.40 in chips)
Seat 7: XBSNP (1.77 in chips)
sh4rkw1s3: posts small blind 0.01
GannibalElectro: posts big blind 0.02
*** HOLE CARDS ***
Dealt to kanococo [7d 8c]
Mibrisk: folds
kanococo: folds
Dmitryp: folds
XBSNP: folds
KiMiPhantom: raises 0.02 to 0.04
sh4rkw1s3: folds
GannibalElectro: raises 0.10 to 0.14
KiMiPhantom: folds
GannibalElectro collected 0.19 from pot
GannibalElectro: doesn't show hand
*** SUMMARY ***
Total pot 0.19 | Rake 0.00
Board [ ]
Game ended: 2025/09/14 21:23:44 GMT
Seat 1: KiMiPhantom (button) folded before Flop
Seat 2: sh4rkw1s3 (small blind) folded before Flop
Seat 3: GannibalElectro (big blind) collected (0.19)
Seat 4: Mibrisk folded before Flop (didn't bet)
Seat 5: kanococo folded before Flop (didn't bet)
Seat 6: Dmitryp folded before Flop (didn't bet)
Seat 7: XBSNP folded before Flop (didn't bet)

